COUNTY_ID,COUNTY_NAME,ADMIN_DATE,PERSONVAX,CUMPERSONVAX,PCTCUMPVAX
00000,GEORGIA,2020-12-12,11,11,0
00000,GEORGIA,2020-12-13,7,18,0
00000,GEORGIA,2020-12-14,22,40,0
00000,GEORGIA,2020-12-15,174,214,0
00000,GEORGIA,2020-12-16,712,926,0
00000,GEORGIA,2020-12-17,2354,3280,0
00000,GEORGIA,2020-12-18,6364,9644,0.1
00000,GEORGIA,2020-12-19,4171,13815,0.1
00000,GEORGIA,2020-12-20,3209,17024,0.2
00000,GEORGIA,2020-12-21,6251,23275,0.2
00000,GEORGIA,2020-12-22,11175,34450,0.3
00000,GEORGIA,2020-12-23,14508,48958,0.5
00000,GEORGIA,2020-12-24,3763,52721,0.5
00000,GEORGIA,2020-12-25,107,52828,0.5
00000,GEORGIA,2020-12-26,1849,54677,0.5
00000,GEORGIA,2020-12-27,1729,56406,0.5
00000,GEORGIA,2020-12-28,15307,71713,0.7
00000,GEORGIA,2020-12-29,16756,88469,0.9
00000,GEORGIA,2020-12-30,16504,104973,1
00000,GEORGIA,2020-12-31,8285,113258,1.1
00000,GEORGIA,2021-01-01,3056,116314,1.1
00000,GEORGIA,2021-01-02,2104,118418,1.1
00000,GEORGIA,2021-01-03,2913,121331,1.2
00000,GEORGIA,2021-01-04,15107,136438,1.3
00000,GEORGIA,2021-01-05,16754,153192,1.5
00000,GEORGIA,2021-01-06,17310,170502,1.6
00000,GEORGIA,2021-01-07,17010,187512,1.8
00000,GEORGIA,2021-01-08,17406,204918,2
00000,GEORGIA,2021-01-09,6461,211379,2
00000,GEORGIA,2021-01-10,3621,215000,2.1
00000,GEORGIA,2021-01-11,27749,242749,2.3
00000,GEORGIA,2021-01-12,33136,275885,2.7
00000,GEORGIA,2021-01-13,40990,316875,3
00000,GEORGIA,2021-01-14,45466,362341,3.5
00000,GEORGIA,2021-01-15,38910,401251,3.9
00000,GEORGIA,2021-01-16,21728,422979,4.1
00000,GEORGIA,2021-01-17,8090,431069,4.1
00000,GEORGIA,2021-01-18,36400,467469,4.5
00000,GEORGIA,2021-01-19,43882,511351,4.9
00000,GEORGIA,2021-01-20,46448,557799,5.4
00000,GEORGIA,2021-01-21,44644,602443,5.8
00000,GEORGIA,2021-01-22,37410,639853,6.2
00000,GEORGIA,2021-01-23,12632,652485,6.3
00000,GEORGIA,2021-01-24,4538,657023,6.3
00000,GEORGIA,2021-01-25,29423,686446,6.6
00000,GEORGIA,2021-01-26,30643,717089,6.9
00000,GEORGIA,2021-01-27,35426,752515,7.2
00000,GEORGIA,2021-01-28,41781,794296,7.6
00000,GEORGIA,2021-01-29,36279,830575,8
00000,GEORGIA,2021-01-30,11060,841635,8.1
00000,GEORGIA,2021-01-31,2850,844485,8.1
00000,GEORGIA,2021-02-01,23742,868227,8.3
00000,GEORGIA,2021-02-02,24554,892781,8.6
00000,GEORGIA,2021-02-03,25840,918621,8.8
00000,GEORGIA,2021-02-04,29176,947797,9.1
00000,GEORGIA,2021-02-05,21291,969088,9.3
00000,GEORGIA,2021-02-06,7134,976222,9.4
00000,GEORGIA,2021-02-07,2151,978373,9.4
00000,GEORGIA,2021-02-08,17506,995879,9.6
00000,GEORGIA,2021-02-09,20510,1016389,9.8
00000,GEORGIA,2021-02-10,19959,1036348,10
00000,GEORGIA,2021-02-11,19983,1056331,10.2
00000,GEORGIA,2021-02-12,17252,1073583,10.3
00000,GEORGIA,2021-02-13,9917,1083500,10.4
00000,GEORGIA,2021-02-14,3491,1086991,10.4
00000,GEORGIA,2021-02-15,17171,1104162,10.6
00000,GEORGIA,2021-02-16,19010,1123172,10.8
00000,GEORGIA,2021-02-17,23062,1146234,11
00000,GEORGIA,2021-02-18,18394,1164628,11.2
00000,GEORGIA,2021-02-19,16540,1181168,11.4
00000,GEORGIA,2021-02-20,5930,1187098,11.4
00000,GEORGIA,2021-02-21,2111,1189209,11.4
00000,GEORGIA,2021-02-22,12952,1202161,11.6
00000,GEORGIA,2021-02-23,21383,1223544,11.8
00000,GEORGIA,2021-02-24,23221,1246765,12
00000,GEORGIA,2021-02-25,24483,1271248,12.2
00000,GEORGIA,2021-02-26,24343,1295591,12.5
00000,GEORGIA,2021-02-27,10392,1305983,12.6
00000,GEORGIA,2021-02-28,6520,1312503,12.6
00000,GEORGIA,2021-03-01,24960,1337463,12.9
00000,GEORGIA,2021-03-02,27919,1365382,13.1
00000,GEORGIA,2021-03-03,31174,1396556,13.4
00000,GEORGIA,2021-03-04,30486,1427042,13.7
00000,GEORGIA,2021-03-05,31545,1458587,14
00000,GEORGIA,2021-03-06,11633,1470220,14.1
00000,GEORGIA,2021-03-07,8242,1478462,14.2
00000,GEORGIA,2021-03-08,42274,1520736,14.6
00000,GEORGIA,2021-03-09,45559,1566295,15.1
00000,GEORGIA,2021-03-10,53373,1619668,15.6
00000,GEORGIA,2021-03-11,55660,1675328,16.1
00000,GEORGIA,2021-03-12,55564,1730892,16.6
00000,GEORGIA,2021-03-13,26415,1757307,16.9
00000,GEORGIA,2021-03-14,11960,1769267,17
00000,GEORGIA,2021-03-15,53378,1822645,17.5
00000,GEORGIA,2021-03-16,64494,1887139,18.1
00000,GEORGIA,2021-03-17,67678,1954817,18.8
00000,GEORGIA,2021-03-18,57849,2012666,19.3
00000,GEORGIA,2021-03-19,67765,2080431,20
00000,GEORGIA,2021-03-20,26617,2107048,20.3
00000,GEORGIA,2021-03-21,14491,2121539,20.4
00000,GEORGIA,2021-03-22,57788,2179327,20.9
00000,GEORGIA,2021-03-23,63238,2242565,21.6
00000,GEORGIA,2021-03-24,71063,2313628,22.2
00000,GEORGIA,2021-03-25,82320,2395948,23
00000,GEORGIA,2021-03-26,70654,2466602,23.7
00000,GEORGIA,2021-03-27,35203,2501805,24
00000,GEORGIA,2021-03-28,16186,2517991,24.2
00000,GEORGIA,2021-03-29,59065,2577056,24.8
00000,GEORGIA,2021-03-30,81995,2659051,25.6
00000,GEORGIA,2021-03-31,82822,2741873,26.4
00000,GEORGIA,2021-04-01,77940,2819813,27.1
00000,GEORGIA,2021-04-02,57116,2876929,27.7
00000,GEORGIA,2021-04-03,24054,2900983,27.9
00000,GEORGIA,2021-04-04,11783,2912766,28
00000,GEORGIA,2021-04-05,48989,2961755,28.5
00000,GEORGIA,2021-04-06,65022,3026777,29.1
00000,GEORGIA,2021-04-07,65007,3091784,29.7
00000,GEORGIA,2021-04-08,62529,3154313,30.3
00000,GEORGIA,2021-04-09,60390,3214703,30.9
00000,GEORGIA,2021-04-10,36911,3251614,31.3
00000,GEORGIA,2021-04-11,12909,3264523,31.4
00000,GEORGIA,2021-04-12,36608,3301131,31.7
00000,GEORGIA,2021-04-13,41601,3342732,32.1
00000,GEORGIA,2021-04-14,36459,3379191,32.5
00000,GEORGIA,2021-04-15,34655,3413846,32.8
00000,GEORGIA,2021-04-16,31998,3445844,33.1
00000,GEORGIA,2021-04-17,14483,3460327,33.3
00000,GEORGIA,2021-04-18,9596,3469923,33.4
00000,GEORGIA,2021-04-19,24273,3494196,33.6
00000,GEORGIA,2021-04-20,31714,3525910,33.9
00000,GEORGIA,2021-04-21,30462,3556372,34.2
00000,GEORGIA,2021-04-22,28872,3585244,34.5
00000,GEORGIA,2021-04-23,28268,3613512,34.7
00000,GEORGIA,2021-04-24,13858,3627370,34.9
00000,GEORGIA,2021-04-25,7112,3634482,34.9
00000,GEORGIA,2021-04-26,20539,3655021,35.1
00000,GEORGIA,2021-04-27,24207,3679228,35.4
00000,GEORGIA,2021-04-28,27054,3706282,35.6
00000,GEORGIA,2021-04-29,24299,3730581,35.9
00000,GEORGIA,2021-04-30,27799,3758380,36.1
00000,GEORGIA,2021-05-01,15780,3774160,36.3
00000,GEORGIA,2021-05-02,7341,3781501,36.3
00000,GEORGIA,2021-05-03,15470,3796971,36.5
00000,GEORGIA,2021-05-04,21161,3818132,36.7
00000,GEORGIA,2021-05-05,20412,3838544,36.9
00000,GEORGIA,2021-05-06,18968,3857512,37.1
00000,GEORGIA,2021-05-07,20523,3878035,37.3
00000,GEORGIA,2021-05-08,12202,3890237,37.4
00000,GEORGIA,2021-05-09,4646,3894883,37.4
00000,GEORGIA,2021-05-10,11705,3906588,37.5
00000,GEORGIA,2021-05-11,18828,3925416,37.7
00000,GEORGIA,2021-05-12,19875,3945291,37.9
00000,GEORGIA,2021-05-13,20429,3965720,38.1
00000,GEORGIA,2021-05-14,24866,3990586,38.4
00000,GEORGIA,2021-05-15,21397,4011983,38.6
00000,GEORGIA,2021-05-16,11981,4023964,38.7
00000,GEORGIA,2021-05-17,22662,4046626,38.9
00000,GEORGIA,2021-05-18,24302,4070928,39.1
00000,GEORGIA,2021-05-19,23242,4094170,39.4
00000,GEORGIA,2021-05-20,19870,4114040,39.5
00000,GEORGIA,2021-05-21,20549,4134589,39.7
00000,GEORGIA,2021-05-22,16933,4151522,39.9
00000,GEORGIA,2021-05-23,8159,4159681,40
00000,GEORGIA,2021-05-24,14789,4174470,40.1
00000,GEORGIA,2021-05-25,15034,4189504,40.3
00000,GEORGIA,2021-05-26,15523,4205027,40.4
00000,GEORGIA,2021-05-27,14644,4219671,40.6
00000,GEORGIA,2021-05-28,13904,4233575,40.7
00000,GEORGIA,2021-05-29,8317,4241892,40.8
00000,GEORGIA,2021-05-30,5394,4247286,40.8
00000,GEORGIA,2021-05-31,1853,4249139,40.8
00000,GEORGIA,2021-06-01,13946,4263085,41
00000,GEORGIA,2021-06-02,13780,4276865,41.1
00000,GEORGIA,2021-06-03,12524,4289389,41.2
00000,GEORGIA,2021-06-04,13431,4302820,41.4
00000,GEORGIA,2021-06-05,9670,4312490,41.5
00000,GEORGIA,2021-06-06,5816,4318306,41.5
00000,GEORGIA,2021-06-07,10557,4328863,41.6
00000,GEORGIA,2021-06-08,10735,4339598,41.7
00000,GEORGIA,2021-06-09,10084,4349682,41.8
00000,GEORGIA,2021-06-10,11196,4360878,41.9
00000,GEORGIA,2021-06-11,10751,4371629,42
00000,GEORGIA,2021-06-12,7542,4379171,42.1
00000,GEORGIA,2021-06-13,2877,4382048,42.1
00000,GEORGIA,2021-06-14,8760,4390808,42.2
00000,GEORGIA,2021-06-15,9061,4399869,42.3
00000,GEORGIA,2021-06-16,8812,4408681,42.4
00000,GEORGIA,2021-06-17,9097,4417778,42.5
00000,GEORGIA,2021-06-18,9853,4427631,42.6
00000,GEORGIA,2021-06-19,6081,4433712,42.6
00000,GEORGIA,2021-06-20,3267,4436979,42.6
00000,GEORGIA,2021-06-21,8111,4445090,42.7
00000,GEORGIA,2021-06-22,8711,4453801,42.8
00000,GEORGIA,2021-06-23,9136,4462937,42.9
00000,GEORGIA,2021-06-24,8097,4471034,43
00000,GEORGIA,2021-06-25,9405,4480439,43.1
00000,GEORGIA,2021-06-26,6304,4486743,43.1
00000,GEORGIA,2021-06-27,3885,4490628,43.2
00000,GEORGIA,2021-06-28,7291,4497919,43.2
00000,GEORGIA,2021-06-29,7861,4505780,43.3
00000,GEORGIA,2021-06-30,8129,4513909,43.4
00000,GEORGIA,2021-07-01,7522,4521431,43.5
00000,GEORGIA,2021-07-02,8448,4529879,43.5
00000,GEORGIA,2021-07-03,5233,4535112,43.6
00000,GEORGIA,2021-07-04,551,4535663,43.6
00000,GEORGIA,2021-07-05,6035,4541698,43.7
00000,GEORGIA,2021-07-06,7323,4549021,43.7
00000,GEORGIA,2021-07-07,7435,4556456,43.8
00000,GEORGIA,2021-07-08,7616,4564072,43.9
00000,GEORGIA,2021-07-09,9005,4573077,44
00000,GEORGIA,2021-07-10,6529,4579606,44
00000,GEORGIA,2021-07-11,3981,4583587,44.1
00000,GEORGIA,2021-07-12,7506,4591093,44.1
00000,GEORGIA,2021-07-13,7912,4599005,44.2
00000,GEORGIA,2021-07-14,8113,4607118,44.3
00000,GEORGIA,2021-07-15,8818,4615936,44.4
00000,GEORGIA,2021-07-16,9918,4625854,44.5
00000,GEORGIA,2021-07-17,7143,4632997,44.5
00000,GEORGIA,2021-07-18,4882,4637879,44.6
00000,GEORGIA,2021-07-19,10592,4648471,44.7
00000,GEORGIA,2021-07-20,11551,4660022,44.8
00000,GEORGIA,2021-07-21,12738,4672760,44.9
00000,GEORGIA,2021-07-22,13713,4686473,45
00000,GEORGIA,2021-07-23,16329,4702802,45.2
00000,GEORGIA,2021-07-24,12293,4715095,45.3
00000,GEORGIA,2021-07-25,7674,4722769,45.4
00000,GEORGIA,2021-07-26,15388,4738157,45.5
00000,GEORGIA,2021-07-27,17244,4755401,45.7
00000,GEORGIA,2021-07-28,18395,4773796,45.9
00000,GEORGIA,2021-07-29,18645,4792441,46.1
00000,GEORGIA,2021-07-30,21360,4813801,46.3
00000,GEORGIA,2021-07-31,13732,4827533,46.4
00000,GEORGIA,2021-08-01,9230,4836763,46.5
00000,GEORGIA,2021-08-02,18482,4855245,46.7
00000,GEORGIA,2021-08-03,19685,4874930,46.9
00000,GEORGIA,2021-08-04,20275,4895205,47.1
00000,GEORGIA,2021-08-05,19988,4915193,47.2
00000,GEORGIA,2021-08-06,23393,4938586,47.5
00000,GEORGIA,2021-08-07,15586,4954172,47.6
00000,GEORGIA,2021-08-08,10261,4964433,47.7
00000,GEORGIA,2021-08-09,18888,4983321,47.9
00000,GEORGIA,2021-08-10,21778,5005099,48.1
00000,GEORGIA,2021-08-11,19971,5025070,48.3
00000,GEORGIA,2021-08-12,20758,5045828,48.5
00000,GEORGIA,2021-08-13,24128,5069956,48.7
00000,GEORGIA,2021-08-14,15458,5085414,48.9
00000,GEORGIA,2021-08-15,8733,5094147,49
00000,GEORGIA,2021-08-16,17976,5112123,49.1
00000,GEORGIA,2021-08-17,20042,5132165,49.3
00000,GEORGIA,2021-08-18,19539,5151704,49.5
00000,GEORGIA,2021-08-19,19363,5171067,49.7
00000,GEORGIA,2021-08-20,22117,5193184,49.9
00000,GEORGIA,2021-08-21,13205,5206389,50
00000,GEORGIA,2021-08-22,8139,5214528,50.1
00000,GEORGIA,2021-08-23,16692,5231220,50.3
00000,GEORGIA,2021-08-24,17954,5249174,50.5
00000,GEORGIA,2021-08-25,18057,5267231,50.6
00000,GEORGIA,2021-08-26,19603,5286834,50.8
00000,GEORGIA,2021-08-27,20654,5307488,51
00000,GEORGIA,2021-08-28,14435,5321923,51.2
00000,GEORGIA,2021-08-29,7875,5329798,51.2
00000,GEORGIA,2021-08-30,15976,5345774,51.4
00000,GEORGIA,2021-08-31,16487,5362261,51.5
00000,GEORGIA,2021-09-01,16980,5379241,51.7
00000,GEORGIA,2021-09-02,16669,5395910,51.9
00000,GEORGIA,2021-09-03,20066,5415976,52.1
00000,GEORGIA,2021-09-04,10560,5426536,52.2
00000,GEORGIA,2021-09-05,7554,5434090,52.2
00000,GEORGIA,2021-09-06,2879,5436969,52.3
00000,GEORGIA,2021-09-07,13332,5450301,52.4
00000,GEORGIA,2021-09-08,14596,5464897,52.5
00000,GEORGIA,2021-09-09,15007,5479904,52.7
00000,GEORGIA,2021-09-10,17238,5497142,52.8
00000,GEORGIA,2021-09-11,10081,5507223,52.9
00000,GEORGIA,2021-09-12,6527,5513750,53
00000,GEORGIA,2021-09-13,12638,5526388,53.1
00000,GEORGIA,2021-09-14,12158,5538546,53.2
00000,GEORGIA,2021-09-15,11102,5549648,53.3
00000,GEORGIA,2021-09-16,10631,5560279,53.4
00000,GEORGIA,2021-09-17,12260,5572539,53.6
00000,GEORGIA,2021-09-18,8029,5580568,53.6
00000,GEORGIA,2021-09-19,4584,5585152,53.7
00000,GEORGIA,2021-09-20,8966,5594118,53.8
00000,GEORGIA,2021-09-21,8807,5602925,53.9
00000,GEORGIA,2021-09-22,8379,5611304,53.9
00000,GEORGIA,2021-09-23,7828,5619132,54
00000,GEORGIA,2021-09-24,8867,5627999,54.1
00000,GEORGIA,2021-09-25,5539,5633538,54.1
00000,GEORGIA,2021-09-26,3348,5636886,54.2
00000,GEORGIA,2021-09-27,6359,5643245,54.2
00000,GEORGIA,2021-09-28,7088,5650333,54.3
00000,GEORGIA,2021-09-29,6877,5657210,54.4
00000,GEORGIA,2021-09-30,6771,5663981,54.4
00000,GEORGIA,2021-10-01,7730,5671711,54.5
00000,GEORGIA,2021-10-02,4368,5676079,54.6
00000,GEORGIA,2021-10-03,2481,5678560,54.6
00000,GEORGIA,2021-10-04,3928,5682488,54.6
00000,GEORGIA,2021-10-05,3784,5686272,54.7
00000,GEORGIA,2021-10-06,4930,5691202,54.7
00000,GEORGIA,2021-10-07,2668,5693870,54.7
00000,GEORGIA,2021-10-08,1,5693871,54.7
13001,Appling County,2020-12-16,1,1,0
13001,Appling County,2020-12-18,2,3,0
13001,Appling County,2020-12-21,2,5,0
13001,Appling County,2020-12-22,3,8,0
13001,Appling County,2020-12-23,9,17,0.1
13001,Appling County,2020-12-24,11,28,0.2
13001,Appling County,2020-12-26,2,30,0.2
13001,Appling County,2020-12-28,11,41,0.2
13001,Appling County,2020-12-29,13,54,0.3
13001,Appling County,2020-12-30,16,70,0.4
13001,Appling County,2020-12-31,2,72,0.4
13001,Appling County,2021-01-01,2,74,0.4
13001,Appling County,2021-01-02,1,75,0.4
13001,Appling County,2021-01-04,8,83,0.5
13001,Appling County,2021-01-05,15,98,0.5
13001,Appling County,2021-01-06,23,121,0.7
13001,Appling County,2021-01-07,8,129,0.7
13001,Appling County,2021-01-08,19,148,0.8
13001,Appling County,2021-01-09,2,150,0.8
13001,Appling County,2021-01-10,43,193,1
13001,Appling County,2021-01-11,76,269,1.5
13001,Appling County,2021-01-12,41,310,1.7
13001,Appling County,2021-01-13,140,450,2.4
13001,Appling County,2021-01-14,69,519,2.8
13001,Appling County,2021-01-15,55,574,3.1
13001,Appling County,2021-01-16,3,577,3.1
13001,Appling County,2021-01-17,1,578,3.1
13001,Appling County,2021-01-18,94,672,3.6
13001,Appling County,2021-01-19,50,722,3.9
13001,Appling County,2021-01-20,94,816,4.4
13001,Appling County,2021-01-21,51,867,4.7
13001,Appling County,2021-01-22,47,914,5
13001,Appling County,2021-01-23,28,942,5.1
13001,Appling County,2021-01-24,1,943,5.1
13001,Appling County,2021-01-25,75,1018,5.5
13001,Appling County,2021-01-26,20,1038,5.6
13001,Appling County,2021-01-27,73,1111,6
13001,Appling County,2021-01-28,15,1126,6.1
13001,Appling County,2021-01-29,6,1132,6.1
13001,Appling County,2021-01-30,5,1137,6.2
13001,Appling County,2021-01-31,1,1138,6.2
13001,Appling County,2021-02-01,77,1215,6.6
13001,Appling County,2021-02-02,76,1291,7
13001,Appling County,2021-02-03,73,1364,7.4
13001,Appling County,2021-02-04,22,1386,7.5
13001,Appling County,2021-02-05,9,1395,7.6
13001,Appling County,2021-02-06,20,1415,7.7
13001,Appling County,2021-02-08,53,1468,8
13001,Appling County,2021-02-09,43,1511,8.2
13001,Appling County,2021-02-10,62,1573,8.5
13001,Appling County,2021-02-11,25,1598,8.7
13001,Appling County,2021-02-12,23,1621,8.8
13001,Appling County,2021-02-13,6,1627,8.8
13001,Appling County,2021-02-14,6,1633,8.9
13001,Appling County,2021-02-15,71,1704,9.2
13001,Appling County,2021-02-16,39,1743,9.5
13001,Appling County,2021-02-17,36,1779,9.6
13001,Appling County,2021-02-18,16,1795,9.7
13001,Appling County,2021-02-19,7,1802,9.8
13001,Appling County,2021-02-20,19,1821,9.9
13001,Appling County,2021-02-22,32,1853,10
13001,Appling County,2021-02-23,34,1887,10.2
13001,Appling County,2021-02-24,18,1905,10.3
13001,Appling County,2021-02-25,9,1914,10.4
13001,Appling County,2021-02-26,4,1918,10.4
13001,Appling County,2021-02-27,4,1922,10.4
13001,Appling County,2021-02-28,1,1923,10.4
13001,Appling County,2021-03-01,31,1954,10.6
13001,Appling County,2021-03-02,33,1987,10.8
13001,Appling County,2021-03-03,60,2047,11.1
13001,Appling County,2021-03-04,25,2072,11.2
13001,Appling County,2021-03-05,32,2104,11.4
13001,Appling County,2021-03-06,2,2106,11.4
13001,Appling County,2021-03-07,2,2108,11.4
13001,Appling County,2021-03-08,139,2247,12.2
13001,Appling County,2021-03-09,37,2284,12.4
13001,Appling County,2021-03-10,52,2336,12.7
13001,Appling County,2021-03-11,18,2354,12.8
13001,Appling County,2021-03-12,27,2381,12.9
13001,Appling County,2021-03-13,9,2390,13
13001,Appling County,2021-03-14,2,2392,13
13001,Appling County,2021-03-15,83,2475,13.4
13001,Appling County,2021-03-16,93,2568,13.9
13001,Appling County,2021-03-17,108,2676,14.5
13001,Appling County,2021-03-18,17,2693,14.6
13001,Appling County,2021-03-19,41,2734,14.8
13001,Appling County,2021-03-20,2,2736,14.8
13001,Appling County,2021-03-21,5,2741,14.9
13001,Appling County,2021-03-22,64,2805,15.2
13001,Appling County,2021-03-23,57,2862,15.5
13001,Appling County,2021-03-24,80,2942,16
13001,Appling County,2021-03-25,52,2994,16.2
13001,Appling County,2021-03-26,44,3038,16.5
13001,Appling County,2021-03-27,7,3045,16.5
13001,Appling County,2021-03-28,3,3048,16.5
13001,Appling County,2021-03-29,67,3115,16.9
13001,Appling County,2021-03-30,59,3174,17.2
13001,Appling County,2021-03-31,111,3285,17.8
13001,Appling County,2021-04-01,48,3333,18.1
13001,Appling County,2021-04-02,33,3366,18.3
13001,Appling County,2021-04-03,9,3375,18.3
13001,Appling County,2021-04-04,4,3379,18.3
13001,Appling County,2021-04-05,159,3538,19.2
13001,Appling County,2021-04-06,53,3591,19.5
13001,Appling County,2021-04-07,65,3656,19.8
13001,Appling County,2021-04-08,46,3702,20.1
13001,Appling County,2021-04-09,113,3815,20.7
13001,Appling County,2021-04-10,11,3826,20.7
13001,Appling County,2021-04-11,6,3832,20.8
13001,Appling County,2021-04-12,35,3867,21
13001,Appling County,2021-04-13,24,3891,21.1
13001,Appling County,2021-04-14,50,3941,21.4
13001,Appling County,2021-04-15,33,3974,21.6
13001,Appling County,2021-04-16,14,3988,21.6
13001,Appling County,2021-04-17,6,3994,21.7
13001,Appling County,2021-04-18,4,3998,21.7
13001,Appling County,2021-04-19,16,4014,21.8
13001,Appling County,2021-04-20,24,4038,21.9
13001,Appling County,2021-04-21,24,4062,22
13001,Appling County,2021-04-22,17,4079,22.1
13001,Appling County,2021-04-23,17,4096,22.2
13001,Appling County,2021-04-24,1,4097,22.2
13001,Appling County,2021-04-26,7,4104,22.3
13001,Appling County,2021-04-27,12,4116,22.3
13001,Appling County,2021-04-28,38,4154,22.5
13001,Appling County,2021-04-29,19,4173,22.6
13001,Appling County,2021-04-30,34,4207,22.8
13001,Appling County,2021-05-01,10,4217,22.9
13001,Appling County,2021-05-02,15,4232,23
13001,Appling County,2021-05-03,13,4245,23
13001,Appling County,2021-05-04,12,4257,23.1
13001,Appling County,2021-05-05,47,4304,23.3
13001,Appling County,2021-05-06,11,4315,23.4
13001,Appling County,2021-05-07,13,4328,23.5
13001,Appling County,2021-05-08,7,4335,23.5
13001,Appling County,2021-05-09,3,4338,23.5
13001,Appling County,2021-05-10,5,4343,23.6
13001,Appling County,2021-05-11,22,4365,23.7
13001,Appling County,2021-05-12,77,4442,24.1
13001,Appling County,2021-05-13,11,4453,24.1
13001,Appling County,2021-05-14,14,4467,24.2
13001,Appling County,2021-05-15,6,4473,24.3
13001,Appling County,2021-05-16,8,4481,24.3
13001,Appling County,2021-05-17,9,4490,24.3
13001,Appling County,2021-05-18,27,4517,24.5
13001,Appling County,2021-05-19,64,4581,24.8
13001,Appling County,2021-05-20,15,4596,24.9
13001,Appling County,2021-05-21,16,4612,25
13001,Appling County,2021-05-22,4,4616,25
13001,Appling County,2021-05-23,7,4623,25.1
13001,Appling County,2021-05-24,11,4634,25.1
13001,Appling County,2021-05-25,13,4647,25.2
13001,Appling County,2021-05-26,19,4666,25.3
13001,Appling County,2021-05-27,6,4672,25.3
13001,Appling County,2021-05-28,10,4682,25.4
13001,Appling County,2021-05-29,6,4688,25.4
13001,Appling County,2021-05-31,3,4691,25.4
13001,Appling County,2021-06-01,15,4706,25.5
13001,Appling County,2021-06-02,22,4728,25.6
13001,Appling County,2021-06-03,9,4737,25.7
13001,Appling County,2021-06-04,10,4747,25.7
13001,Appling County,2021-06-05,9,4756,25.8
13001,Appling County,2021-06-06,1,4757,25.8
13001,Appling County,2021-06-07,7,4764,25.8
13001,Appling County,2021-06-08,5,4769,25.9
13001,Appling County,2021-06-09,15,4784,25.9
13001,Appling County,2021-06-10,8,4792,26
13001,Appling County,2021-06-11,13,4805,26.1
13001,Appling County,2021-06-12,3,4808,26.1
13001,Appling County,2021-06-13,2,4810,26.1
13001,Appling County,2021-06-14,5,4815,26.1
13001,Appling County,2021-06-15,12,4827,26.2
13001,Appling County,2021-06-16,8,4835,26.2
13001,Appling County,2021-06-17,12,4847,26.3
13001,Appling County,2021-06-18,5,4852,26.3
13001,Appling County,2021-06-19,5,4857,26.3
13001,Appling County,2021-06-20,3,4860,26.4
13001,Appling County,2021-06-21,5,4865,26.4
13001,Appling County,2021-06-22,10,4875,26.4
13001,Appling County,2021-06-23,17,4892,26.5
13001,Appling County,2021-06-24,2,4894,26.5
13001,Appling County,2021-06-25,2,4896,26.6
13001,Appling County,2021-06-26,9,4905,26.6
13001,Appling County,2021-06-27,1,4906,26.6
13001,Appling County,2021-06-28,2,4908,26.6
13001,Appling County,2021-06-29,6,4914,26.6
13001,Appling County,2021-06-30,12,4926,26.7
13001,Appling County,2021-07-01,4,4930,26.7
13001,Appling County,2021-07-02,9,4939,26.8
13001,Appling County,2021-07-03,2,4941,26.8
13001,Appling County,2021-07-04,4,4945,26.8
13001,Appling County,2021-07-05,1,4946,26.8
13001,Appling County,2021-07-06,7,4953,26.9
13001,Appling County,2021-07-07,6,4959,26.9
13001,Appling County,2021-07-08,9,4968,26.9
13001,Appling County,2021-07-09,14,4982,27
13001,Appling County,2021-07-11,2,4984,27
13001,Appling County,2021-07-12,18,5002,27.1
13001,Appling County,2021-07-13,7,5009,27.2
13001,Appling County,2021-07-14,25,5034,27.3
13001,Appling County,2021-07-15,14,5048,27.4
13001,Appling County,2021-07-16,4,5052,27.4
13001,Appling County,2021-07-17,6,5058,27.4
13001,Appling County,2021-07-18,7,5065,27.5
13001,Appling County,2021-07-19,17,5082,27.6
13001,Appling County,2021-07-20,17,5099,27.7
13001,Appling County,2021-07-21,35,5134,27.8
13001,Appling County,2021-07-22,11,5145,27.9
13001,Appling County,2021-07-23,12,5157,28
13001,Appling County,2021-07-24,24,5181,28.1
13001,Appling County,2021-07-25,4,5185,28.1
13001,Appling County,2021-07-26,23,5208,28.2
13001,Appling County,2021-07-27,46,5254,28.5
13001,Appling County,2021-07-28,33,5287,28.7
13001,Appling County,2021-07-29,24,5311,28.8
13001,Appling County,2021-07-30,45,5356,29
13001,Appling County,2021-07-31,13,5369,29.1
13001,Appling County,2021-08-01,9,5378,29.2
13001,Appling County,2021-08-02,26,5404,29.3
13001,Appling County,2021-08-03,26,5430,29.4
13001,Appling County,2021-08-04,32,5462,29.6
13001,Appling County,2021-08-05,42,5504,29.8
13001,Appling County,2021-08-06,58,5562,30.2
13001,Appling County,2021-08-07,18,5580,30.3
13001,Appling County,2021-08-08,4,5584,30.3
13001,Appling County,2021-08-09,47,5631,30.5
13001,Appling County,2021-08-10,65,5696,30.9
13001,Appling County,2021-08-11,38,5734,31.1
13001,Appling County,2021-08-12,45,5779,31.3
13001,Appling County,2021-08-13,45,5824,31.6
13001,Appling County,2021-08-14,33,5857,31.8
13001,Appling County,2021-08-15,5,5862,31.8
13001,Appling County,2021-08-16,27,5889,31.9
13001,Appling County,2021-08-17,46,5935,32.2
13001,Appling County,2021-08-18,31,5966,32.4
13001,Appling County,2021-08-19,22,5988,32.5
13001,Appling County,2021-08-20,45,6033,32.7
13001,Appling County,2021-08-21,21,6054,32.8
13001,Appling County,2021-08-22,6,6060,32.9
13001,Appling County,2021-08-23,46,6106,33.1
13001,Appling County,2021-08-24,50,6156,33.4
13001,Appling County,2021-08-25,19,6175,33.5
13001,Appling County,2021-08-26,55,6230,33.8
13001,Appling County,2021-08-27,53,6283,34.1
13001,Appling County,2021-08-28,20,6303,34.2
13001,Appling County,2021-08-29,4,6307,34.2
13001,Appling County,2021-08-30,23,6330,34.3
13001,Appling County,2021-08-31,37,6367,34.5
13001,Appling County,2021-09-01,20,6387,34.6
13001,Appling County,2021-09-02,39,6426,34.8
13001,Appling County,2021-09-03,50,6476,35.1
13001,Appling County,2021-09-04,14,6490,35.2
13001,Appling County,2021-09-05,8,6498,35.2
13001,Appling County,2021-09-06,7,6505,35.3
13001,Appling County,2021-09-07,26,6531,35.4
13001,Appling County,2021-09-08,18,6549,35.5
13001,Appling County,2021-09-09,16,6565,35.6
13001,Appling County,2021-09-10,50,6615,35.9
13001,Appling County,2021-09-11,25,6640,36
13001,Appling County,2021-09-12,3,6643,36
13001,Appling County,2021-09-13,15,6658,36.1
13001,Appling County,2021-09-14,26,6684,36.2
13001,Appling County,2021-09-15,16,6700,36.3
13001,Appling County,2021-09-16,16,6716,36.4
13001,Appling County,2021-09-17,23,6739,36.5
13001,Appling County,2021-09-18,7,6746,36.6
13001,Appling County,2021-09-19,8,6754,36.6
13001,Appling County,2021-09-20,12,6766,36.7
13001,Appling County,2021-09-21,17,6783,36.8
13001,Appling County,2021-09-22,17,6800,36.9
13001,Appling County,2021-09-23,11,6811,36.9
13001,Appling County,2021-09-24,15,6826,37
13001,Appling County,2021-09-25,1,6827,37
13001,Appling County,2021-09-26,1,6828,37
13001,Appling County,2021-09-27,7,6835,37.1
13001,Appling County,2021-09-28,10,6845,37.1
13001,Appling County,2021-09-29,7,6852,37.2
13001,Appling County,2021-09-30,3,6855,37.2
13001,Appling County,2021-10-01,8,6863,37.2
13001,Appling County,2021-10-02,4,6867,37.2
13001,Appling County,2021-10-03,6,6873,37.3
13001,Appling County,2021-10-04,2,6875,37.3
13001,Appling County,2021-10-05,4,6879,37.3
13001,Appling County,2021-10-06,5,6884,37.3
13001,Appling County,2021-10-07,6,6890,37.4
13003,Atkinson County,2020-12-17,1,1,0
13003,Atkinson County,2020-12-21,1,2,0
13003,Atkinson County,2020-12-22,2,4,0
13003,Atkinson County,2020-12-23,8,12,0.1
13003,Atkinson County,2020-12-24,7,19,0.2
13003,Atkinson County,2020-12-28,8,27,0.3
13003,Atkinson County,2020-12-29,3,30,0.4
13003,Atkinson County,2020-12-30,10,40,0.5
13003,Atkinson County,2020-12-31,3,43,0.5
13003,Atkinson County,2021-01-01,1,44,0.5
13003,Atkinson County,2021-01-04,9,53,0.6
13003,Atkinson County,2021-01-05,3,56,0.7
13003,Atkinson County,2021-01-06,8,64,0.8
13003,Atkinson County,2021-01-07,11,75,0.9
13003,Atkinson County,2021-01-08,24,99,1.2
13003,Atkinson County,2021-01-10,6,105,1.3
13003,Atkinson County,2021-01-11,41,146,1.8
13003,Atkinson County,2021-01-12,45,191,2.3
13003,Atkinson County,2021-01-13,16,207,2.5
13003,Atkinson County,2021-01-14,56,263,3.2
13003,Atkinson County,2021-01-15,26,289,3.5
13003,Atkinson County,2021-01-16,3,292,3.5
13003,Atkinson County,2021-01-17,1,293,3.6
13003,Atkinson County,2021-01-18,23,316,3.8
13003,Atkinson County,2021-01-19,47,363,4.4
13003,Atkinson County,2021-01-20,15,378,4.6
13003,Atkinson County,2021-01-21,48,426,5.2
13003,Atkinson County,2021-01-22,25,451,5.5
13003,Atkinson County,2021-01-23,6,457,5.5
13003,Atkinson County,2021-01-25,16,473,5.7
13003,Atkinson County,2021-01-26,26,499,6.1
13003,Atkinson County,2021-01-27,19,518,6.3
13003,Atkinson County,2021-01-28,44,562,6.8
13003,Atkinson County,2021-01-29,15,577,7
13003,Atkinson County,2021-02-01,7,584,7.1
13003,Atkinson County,2021-02-02,5,589,7.1
13003,Atkinson County,2021-02-03,5,594,7.2
13003,Atkinson County,2021-02-04,5,599,7.3
13003,Atkinson County,2021-02-05,15,614,7.5
13003,Atkinson County,2021-02-06,1,615,7.5
13003,Atkinson County,2021-02-08,4,619,7.5
13003,Atkinson County,2021-02-09,13,632,7.7
13003,Atkinson County,2021-02-10,9,641,7.8
13003,Atkinson County,2021-02-11,3,644,7.8
13003,Atkinson County,2021-02-12,11,655,7.9
13003,Atkinson County,2021-02-15,7,662,8
13003,Atkinson County,2021-02-16,8,670,8.1
13003,Atkinson County,2021-02-17,3,673,8.2
13003,Atkinson County,2021-02-18,10,683,8.3
13003,Atkinson County,2021-02-19,14,697,8.5
13003,Atkinson County,2021-02-20,3,700,8.5
13003,Atkinson County,2021-02-22,6,706,8.6
13003,Atkinson County,2021-02-23,25,731,8.9
13003,Atkinson County,2021-02-24,5,736,8.9
13003,Atkinson County,2021-02-25,14,750,9.1
13003,Atkinson County,2021-02-26,19,769,9.3
13003,Atkinson County,2021-02-28,2,771,9.4
13003,Atkinson County,2021-03-01,6,777,9.4
13003,Atkinson County,2021-03-02,22,799,9.7
13003,Atkinson County,2021-03-03,17,816,9.9
13003,Atkinson County,2021-03-04,11,827,10
13003,Atkinson County,2021-03-05,11,838,10.2
13003,Atkinson County,2021-03-06,1,839,10.2
13003,Atkinson County,2021-03-08,39,878,10.7
13003,Atkinson County,2021-03-09,19,897,10.9
13003,Atkinson County,2021-03-10,14,911,11.1
13003,Atkinson County,2021-03-11,12,923,11.2
13003,Atkinson County,2021-03-12,15,938,11.4
13003,Atkinson County,2021-03-15,10,948,11.5
13003,Atkinson County,2021-03-16,40,988,12
13003,Atkinson County,2021-03-17,20,1008,12.2
13003,Atkinson County,2021-03-18,15,1023,12.4
13003,Atkinson County,2021-03-19,15,1038,12.6
13003,Atkinson County,2021-03-20,38,1076,13.1
13003,Atkinson County,2021-03-22,9,1085,13.2
13003,Atkinson County,2021-03-23,35,1120,13.6
13003,Atkinson County,2021-03-24,11,1131,13.7
13003,Atkinson County,2021-03-25,60,1191,14.5
13003,Atkinson County,2021-03-26,33,1224,14.9
13003,Atkinson County,2021-03-27,6,1230,14.9
13003,Atkinson County,2021-03-28,3,1233,15
13003,Atkinson County,2021-03-29,6,1239,15
13003,Atkinson County,2021-03-30,49,1288,15.6
13003,Atkinson County,2021-03-31,45,1333,16.2
13003,Atkinson County,2021-04-01,31,1364,16.6
13003,Atkinson County,2021-04-02,37,1401,17
13003,Atkinson County,2021-04-03,27,1428,17.3
13003,Atkinson County,2021-04-04,1,1429,17.3
13003,Atkinson County,2021-04-05,4,1433,17.4
13003,Atkinson County,2021-04-06,31,1464,17.8
13003,Atkinson County,2021-04-07,16,1480,18
13003,Atkinson County,2021-04-08,34,1514,18.4
13003,Atkinson County,2021-04-09,11,1525,18.5
13003,Atkinson County,2021-04-10,3,1528,18.5
13003,Atkinson County,2021-04-11,2,1530,18.6
13003,Atkinson County,2021-04-12,6,1536,18.6
13003,Atkinson County,2021-04-13,40,1576,19.1
13003,Atkinson County,2021-04-14,6,1582,19.2
13003,Atkinson County,2021-04-15,18,1600,19.4
13003,Atkinson County,2021-04-16,37,1637,19.9
13003,Atkinson County,2021-04-17,31,1668,20.2
13003,Atkinson County,2021-04-18,1,1669,20.3
13003,Atkinson County,2021-04-19,1,1670,20.3
13003,Atkinson County,2021-04-20,23,1693,20.5
13003,Atkinson County,2021-04-21,7,1700,20.6
13003,Atkinson County,2021-04-22,5,1705,20.7
13003,Atkinson County,2021-04-23,8,1713,20.8
13003,Atkinson County,2021-04-24,1,1714,20.8
13003,Atkinson County,2021-04-25,2,1716,20.8
13003,Atkinson County,2021-04-26,4,1720,20.9
13003,Atkinson County,2021-04-27,25,1745,21.2
13003,Atkinson County,2021-04-28,6,1751,21.3
13003,Atkinson County,2021-04-29,35,1786,21.7
13003,Atkinson County,2021-04-30,9,1795,21.8
13003,Atkinson County,2021-05-01,7,1802,21.9
13003,Atkinson County,2021-05-03,60,1862,22.6
13003,Atkinson County,2021-05-04,18,1880,22.8
13003,Atkinson County,2021-05-05,7,1887,22.9
13003,Atkinson County,2021-05-06,5,1892,23
13003,Atkinson County,2021-05-07,4,1896,23
13003,Atkinson County,2021-05-08,6,1902,23.1
13003,Atkinson County,2021-05-10,1,1903,23.1
13003,Atkinson County,2021-05-11,7,1910,23.2
13003,Atkinson County,2021-05-12,13,1923,23.3
13003,Atkinson County,2021-05-13,4,1927,23.4
13003,Atkinson County,2021-05-14,7,1934,23.5
13003,Atkinson County,2021-05-15,8,1942,23.6
13003,Atkinson County,2021-05-16,1,1943,23.6
13003,Atkinson County,2021-05-17,5,1948,23.6
13003,Atkinson County,2021-05-18,16,1964,23.8
13003,Atkinson County,2021-05-19,12,1976,24
13003,Atkinson County,2021-05-20,6,1982,24.1
13003,Atkinson County,2021-05-21,8,1990,24.2
13003,Atkinson County,2021-05-22,4,1994,24.2
13003,Atkinson County,2021-05-23,1,1995,24.2
13003,Atkinson County,2021-05-24,1,1996,24.2
13003,Atkinson County,2021-05-25,12,2008,24.4
13003,Atkinson County,2021-05-26,7,2015,24.5
13003,Atkinson County,2021-05-27,14,2029,24.6
13003,Atkinson County,2021-05-28,6,2035,24.7
13003,Atkinson County,2021-05-29,4,2039,24.7
13003,Atkinson County,2021-05-31,1,2040,24.8
13003,Atkinson County,2021-06-01,14,2054,24.9
13003,Atkinson County,2021-06-02,8,2062,25
13003,Atkinson County,2021-06-03,3,2065,25.1
13003,Atkinson County,2021-06-04,5,2070,25.1
13003,Atkinson County,2021-06-05,1,2071,25.1
13003,Atkinson County,2021-06-06,1,2072,25.1
13003,Atkinson County,2021-06-07,2,2074,25.2
13003,Atkinson County,2021-06-08,11,2085,25.3
13003,Atkinson County,2021-06-09,2,2087,25.3
13003,Atkinson County,2021-06-10,8,2095,25.4
13003,Atkinson County,2021-06-11,1,2096,25.4
13003,Atkinson County,2021-06-12,2,2098,25.5
13003,Atkinson County,2021-06-14,2,2100,25.5
13003,Atkinson County,2021-06-15,9,2109,25.6
13003,Atkinson County,2021-06-16,5,2114,25.7
13003,Atkinson County,2021-06-17,2,2116,25.7
13003,Atkinson County,2021-06-18,2,2118,25.7
13003,Atkinson County,2021-06-19,1,2119,25.7
13003,Atkinson County,2021-06-21,2,2121,25.7
13003,Atkinson County,2021-06-22,7,2128,25.8
13003,Atkinson County,2021-06-23,5,2133,25.9
13003,Atkinson County,2021-06-24,10,2143,26
13003,Atkinson County,2021-06-25,7,2150,26.1
13003,Atkinson County,2021-06-26,8,2158,26.2
13003,Atkinson County,2021-06-28,8,2166,26.3
13003,Atkinson County,2021-06-29,3,2169,26.3
13003,Atkinson County,2021-06-30,6,2175,26.4
13003,Atkinson County,2021-07-01,8,2183,26.5
13003,Atkinson County,2021-07-02,2,2185,26.5
13003,Atkinson County,2021-07-06,7,2192,26.6
13003,Atkinson County,2021-07-07,8,2200,26.7
13003,Atkinson County,2021-07-08,3,2203,26.7
13003,Atkinson County,2021-07-09,8,2211,26.8
13003,Atkinson County,2021-07-10,1,2212,26.8
13003,Atkinson County,2021-07-12,3,2215,26.9
13003,Atkinson County,2021-07-13,8,2223,27
13003,Atkinson County,2021-07-14,4,2227,27
13003,Atkinson County,2021-07-15,5,2232,27.1
13003,Atkinson County,2021-07-16,14,2246,27.3
13003,Atkinson County,2021-07-19,19,2265,27.5
13003,Atkinson County,2021-07-20,17,2282,27.7
13003,Atkinson County,2021-07-21,7,2289,27.8
13003,Atkinson County,2021-07-22,9,2298,27.9
13003,Atkinson County,2021-07-23,25,2323,28.2
13003,Atkinson County,2021-07-24,14,2337,28.4
13003,Atkinson County,2021-07-25,5,2342,28.4
13003,Atkinson County,2021-07-26,9,2351,28.5
13003,Atkinson County,2021-07-27,23,2374,28.8
13003,Atkinson County,2021-07-28,20,2394,29.1
13003,Atkinson County,2021-07-29,21,2415,29.3
13003,Atkinson County,2021-07-30,34,2449,29.7
13003,Atkinson County,2021-07-31,10,2459,29.8
13003,Atkinson County,2021-08-01,15,2474,30
13003,Atkinson County,2021-08-02,20,2494,30.3
13003,Atkinson County,2021-08-03,33,2527,30.7
13003,Atkinson County,2021-08-04,30,2557,31
13003,Atkinson County,2021-08-05,39,2596,31.5
13003,Atkinson County,2021-08-06,33,2629,31.9
13003,Atkinson County,2021-08-07,8,2637,32
13003,Atkinson County,2021-08-08,2,2639,32
13003,Atkinson County,2021-08-09,18,2657,32.2
13003,Atkinson County,2021-08-10,55,2712,32.9
13003,Atkinson County,2021-08-11,43,2755,33.4
13003,Atkinson County,2021-08-12,35,2790,33.9
13003,Atkinson County,2021-08-13,47,2837,34.4
13003,Atkinson County,2021-08-14,13,2850,34.6
13003,Atkinson County,2021-08-15,6,2856,34.7
13003,Atkinson County,2021-08-16,31,2887,35
13003,Atkinson County,2021-08-17,43,2930,35.6
13003,Atkinson County,2021-08-18,35,2965,36
13003,Atkinson County,2021-08-19,24,2989,36.3
13003,Atkinson County,2021-08-20,35,3024,36.7
13003,Atkinson County,2021-08-21,14,3038,36.9
13003,Atkinson County,2021-08-22,3,3041,36.9
13003,Atkinson County,2021-08-23,16,3057,37.1
13003,Atkinson County,2021-08-24,17,3074,37.3
13003,Atkinson County,2021-08-25,20,3094,37.6
13003,Atkinson County,2021-08-26,21,3115,37.8
13003,Atkinson County,2021-08-27,33,3148,38.2
13003,Atkinson County,2021-08-28,3,3151,38.2
13003,Atkinson County,2021-08-29,12,3163,38.4
13003,Atkinson County,2021-08-30,16,3179,38.6
13003,Atkinson County,2021-08-31,19,3198,38.8
13003,Atkinson County,2021-09-01,11,3209,38.9
13003,Atkinson County,2021-09-02,25,3234,39.3
13003,Atkinson County,2021-09-03,22,3256,39.5
13003,Atkinson County,2021-09-04,5,3261,39.6
13003,Atkinson County,2021-09-05,2,3263,39.6
13003,Atkinson County,2021-09-07,14,3277,39.8
13003,Atkinson County,2021-09-08,10,3287,39.9
13003,Atkinson County,2021-09-09,7,3294,40
13003,Atkinson County,2021-09-10,17,3311,40.2
13003,Atkinson County,2021-09-11,7,3318,40.3
13003,Atkinson County,2021-09-12,1,3319,40.3
13003,Atkinson County,2021-09-13,11,3330,40.4
13003,Atkinson County,2021-09-14,9,3339,40.5
13003,Atkinson County,2021-09-15,10,3349,40.6
13003,Atkinson County,2021-09-16,6,3355,40.7
13003,Atkinson County,2021-09-17,1,3356,40.7
13003,Atkinson County,2021-09-18,6,3362,40.8
13003,Atkinson County,2021-09-20,1,3363,40.8
13003,Atkinson County,2021-09-21,9,3372,40.9
13003,Atkinson County,2021-09-22,5,3377,41
13003,Atkinson County,2021-09-23,3,3380,41
13003,Atkinson County,2021-09-24,10,3390,41.1
13003,Atkinson County,2021-09-25,1,3391,41.2
13003,Atkinson County,2021-09-26,3,3394,41.2
13003,Atkinson County,2021-09-27,4,3398,41.2
13003,Atkinson County,2021-09-28,2,3400,41.3
13003,Atkinson County,2021-09-29,1,3401,41.3
13003,Atkinson County,2021-10-01,8,3409,41.4
13003,Atkinson County,2021-10-04,5,3414,41.4
13003,Atkinson County,2021-10-05,1,3415,41.4
13003,Atkinson County,2021-10-06,3,3418,41.5
13003,Atkinson County,2021-10-07,4,3422,41.5
13005,Bacon County,2020-12-16,1,1,0
13005,Bacon County,2020-12-18,2,3,0
13005,Bacon County,2020-12-19,1,4,0
13005,Bacon County,2020-12-21,1,5,0
13005,Bacon County,2020-12-23,5,10,0.1
13005,Bacon County,2020-12-24,26,36,0.3
13005,Bacon County,2020-12-28,4,40,0.4
13005,Bacon County,2020-12-29,38,78,0.7
13005,Bacon County,2020-12-30,31,109,1
13005,Bacon County,2020-12-31,4,113,1
13005,Bacon County,2021-01-03,1,114,1
13005,Bacon County,2021-01-04,4,118,1.1
13005,Bacon County,2021-01-05,6,124,1.1
13005,Bacon County,2021-01-06,106,230,2.1
13005,Bacon County,2021-01-07,3,233,2.1
13005,Bacon County,2021-01-08,6,239,2.1
13005,Bacon County,2021-01-10,5,244,2.2
13005,Bacon County,2021-01-11,16,260,2.3
13005,Bacon County,2021-01-12,70,330,2.9
13005,Bacon County,2021-01-13,38,368,3.3
13005,Bacon County,2021-01-14,22,390,3.5
13005,Bacon County,2021-01-15,10,400,3.6
13005,Bacon County,2021-01-16,7,407,3.6
13005,Bacon County,2021-01-17,1,408,3.6
13005,Bacon County,2021-01-18,28,436,3.9
13005,Bacon County,2021-01-19,40,476,4.2
13005,Bacon County,2021-01-20,29,505,4.5
13005,Bacon County,2021-01-21,11,516,4.6
13005,Bacon County,2021-01-22,27,543,4.8
13005,Bacon County,2021-01-23,10,553,4.9
13005,Bacon County,2021-01-25,15,568,5.1
13005,Bacon County,2021-01-26,29,597,5.3
13005,Bacon County,2021-01-27,34,631,5.6
13005,Bacon County,2021-01-28,11,642,5.7
13005,Bacon County,2021-01-29,6,648,5.8
13005,Bacon County,2021-01-30,4,652,5.8
13005,Bacon County,2021-02-01,20,672,6
13005,Bacon County,2021-02-02,29,701,6.3
13005,Bacon County,2021-02-03,26,727,6.5
13005,Bacon County,2021-02-04,2,729,6.5
13005,Bacon County,2021-02-05,7,736,6.6
13005,Bacon County,2021-02-06,4,740,6.6
13005,Bacon County,2021-02-08,17,757,6.8
13005,Bacon County,2021-02-09,41,798,7.1
13005,Bacon County,2021-02-10,16,814,7.3
13005,Bacon County,2021-02-11,2,816,7.3
13005,Bacon County,2021-02-12,10,826,7.4
13005,Bacon County,2021-02-13,7,833,7.4
13005,Bacon County,2021-02-14,1,834,7.4
13005,Bacon County,2021-02-15,31,865,7.7
13005,Bacon County,2021-02-16,41,906,8.1
13005,Bacon County,2021-02-17,15,921,8.2
13005,Bacon County,2021-02-18,4,925,8.3
13005,Bacon County,2021-02-19,9,934,8.3
13005,Bacon County,2021-02-20,5,939,8.4
13005,Bacon County,2021-02-22,29,968,8.6
13005,Bacon County,2021-02-23,10,978,8.7
13005,Bacon County,2021-02-24,17,995,8.9
13005,Bacon County,2021-02-25,17,1012,9
13005,Bacon County,2021-02-26,5,1017,9.1
13005,Bacon County,2021-03-01,14,1031,9.2
13005,Bacon County,2021-03-02,25,1056,9.4
13005,Bacon County,2021-03-03,21,1077,9.6
13005,Bacon County,2021-03-04,7,1084,9.7
13005,Bacon County,2021-03-05,15,1099,9.8
13005,Bacon County,2021-03-07,2,1101,9.8
13005,Bacon County,2021-03-08,21,1122,10
13005,Bacon County,2021-03-09,20,1142,10.2
13005,Bacon County,2021-03-10,30,1172,10.5
13005,Bacon County,2021-03-11,11,1183,10.6
13005,Bacon County,2021-03-12,37,1220,10.9
13005,Bacon County,2021-03-13,3,1223,10.9
13005,Bacon County,2021-03-14,8,1231,11
13005,Bacon County,2021-03-15,21,1252,11.2
13005,Bacon County,2021-03-16,54,1306,11.7
13005,Bacon County,2021-03-17,30,1336,11.9
13005,Bacon County,2021-03-18,9,1345,12
13005,Bacon County,2021-03-19,104,1449,12.9
13005,Bacon County,2021-03-20,4,1453,13
13005,Bacon County,2021-03-21,11,1464,13.1
13005,Bacon County,2021-03-22,31,1495,13.3
13005,Bacon County,2021-03-23,55,1550,13.8
13005,Bacon County,2021-03-24,56,1606,14.3
13005,Bacon County,2021-03-25,18,1624,14.5
13005,Bacon County,2021-03-26,42,1666,14.9
13005,Bacon County,2021-03-27,7,1673,14.9
13005,Bacon County,2021-03-29,29,1702,15.2
13005,Bacon County,2021-03-30,41,1743,15.6
13005,Bacon County,2021-03-31,64,1807,16.1
13005,Bacon County,2021-04-01,25,1832,16.4
13005,Bacon County,2021-04-02,35,1867,16.7
13005,Bacon County,2021-04-03,5,1872,16.7
13005,Bacon County,2021-04-05,18,1890,16.9
13005,Bacon County,2021-04-06,20,1910,17.1
13005,Bacon County,2021-04-07,28,1938,17.3
13005,Bacon County,2021-04-08,62,2000,17.9
13005,Bacon County,2021-04-09,23,2023,18.1
13005,Bacon County,2021-04-10,4,2027,18.1
13005,Bacon County,2021-04-11,6,2033,18.2
13005,Bacon County,2021-04-12,17,2050,18.3
13005,Bacon County,2021-04-13,18,2068,18.5
13005,Bacon County,2021-04-14,9,2077,18.5
13005,Bacon County,2021-04-15,4,2081,18.6
13005,Bacon County,2021-04-16,26,2107,18.8
13005,Bacon County,2021-04-17,6,2113,18.9
13005,Bacon County,2021-04-18,1,2114,18.9
13005,Bacon County,2021-04-19,8,2122,18.9
13005,Bacon County,2021-04-20,19,2141,19.1
13005,Bacon County,2021-04-21,14,2155,19.2
13005,Bacon County,2021-04-22,10,2165,19.3
13005,Bacon County,2021-04-23,17,2182,19.5
13005,Bacon County,2021-04-25,1,2183,19.5
13005,Bacon County,2021-04-26,13,2196,19.6
13005,Bacon County,2021-04-27,12,2208,19.7
13005,Bacon County,2021-04-28,16,2224,19.9
13005,Bacon County,2021-04-29,10,2234,19.9
13005,Bacon County,2021-04-30,17,2251,20.1
13005,Bacon County,2021-05-01,2,2253,20.1
13005,Bacon County,2021-05-02,1,2254,20.1
13005,Bacon County,2021-05-03,5,2259,20.2
13005,Bacon County,2021-05-04,7,2266,20.2
13005,Bacon County,2021-05-05,14,2280,20.4
13005,Bacon County,2021-05-06,12,2292,20.5
13005,Bacon County,2021-05-07,18,2310,20.6
13005,Bacon County,2021-05-08,6,2316,20.7
13005,Bacon County,2021-05-09,1,2317,20.7
13005,Bacon County,2021-05-10,4,2321,20.7
13005,Bacon County,2021-05-11,15,2336,20.9
13005,Bacon County,2021-05-12,3,2339,20.9
13005,Bacon County,2021-05-13,7,2346,20.9
13005,Bacon County,2021-05-14,11,2357,21
13005,Bacon County,2021-05-15,1,2358,21.1
13005,Bacon County,2021-05-16,3,2361,21.1
13005,Bacon County,2021-05-17,7,2368,21.1
13005,Bacon County,2021-05-18,9,2377,21.2
13005,Bacon County,2021-05-19,12,2389,21.3
13005,Bacon County,2021-05-20,5,2394,21.4
13005,Bacon County,2021-05-21,9,2403,21.5
13005,Bacon County,2021-05-22,2,2405,21.5
13005,Bacon County,2021-05-24,10,2415,21.6
13005,Bacon County,2021-05-25,6,2421,21.6
13005,Bacon County,2021-05-26,5,2426,21.7
13005,Bacon County,2021-05-27,2,2428,21.7
13005,Bacon County,2021-05-28,6,2434,21.7
13005,Bacon County,2021-05-29,2,2436,21.7
13005,Bacon County,2021-05-30,3,2439,21.8
13005,Bacon County,2021-05-31,2,2441,21.8
13005,Bacon County,2021-06-01,3,2444,21.8
13005,Bacon County,2021-06-02,5,2449,21.9
13005,Bacon County,2021-06-03,2,2451,21.9
13005,Bacon County,2021-06-04,9,2460,22
13005,Bacon County,2021-06-05,1,2461,22
13005,Bacon County,2021-06-07,5,2466,22
13005,Bacon County,2021-06-08,6,2472,22.1
13005,Bacon County,2021-06-09,5,2477,22.1
13005,Bacon County,2021-06-10,73,2550,22.8
13005,Bacon County,2021-06-11,6,2556,22.8
13005,Bacon County,2021-06-12,5,2561,22.9
13005,Bacon County,2021-06-14,2,2563,22.9
13005,Bacon County,2021-06-15,5,2568,22.9
13005,Bacon County,2021-06-16,5,2573,23
13005,Bacon County,2021-06-17,1,2574,23
13005,Bacon County,2021-06-18,10,2584,23.1
13005,Bacon County,2021-06-22,1,2585,23.1
13005,Bacon County,2021-06-23,9,2594,23.2
13005,Bacon County,2021-06-24,4,2598,23.2
13005,Bacon County,2021-06-25,9,2607,23.3
13005,Bacon County,2021-06-26,2,2609,23.3
13005,Bacon County,2021-06-28,3,2612,23.3
13005,Bacon County,2021-06-29,5,2617,23.4
13005,Bacon County,2021-06-30,8,2625,23.4
13005,Bacon County,2021-07-01,7,2632,23.5
13005,Bacon County,2021-07-02,1,2633,23.5
13005,Bacon County,2021-07-05,4,2637,23.5
13005,Bacon County,2021-07-06,6,2643,23.6
13005,Bacon County,2021-07-07,5,2648,23.6
13005,Bacon County,2021-07-08,2,2650,23.7
13005,Bacon County,2021-07-09,3,2653,23.7
13005,Bacon County,2021-07-10,3,2656,23.7
13005,Bacon County,2021-07-11,2,2658,23.7
13005,Bacon County,2021-07-12,2,2660,23.7
13005,Bacon County,2021-07-13,4,2664,23.8
13005,Bacon County,2021-07-14,10,2674,23.9
13005,Bacon County,2021-07-15,5,2679,23.9
13005,Bacon County,2021-07-16,7,2686,24
13005,Bacon County,2021-07-17,4,2690,24
13005,Bacon County,2021-07-19,11,2701,24.1
13005,Bacon County,2021-07-20,8,2709,24.2
13005,Bacon County,2021-07-21,14,2723,24.3
13005,Bacon County,2021-07-22,4,2727,24.3
13005,Bacon County,2021-07-23,10,2737,24.4
13005,Bacon County,2021-07-24,10,2747,24.5
13005,Bacon County,2021-07-26,7,2754,24.6
13005,Bacon County,2021-07-27,22,2776,24.8
13005,Bacon County,2021-07-28,26,2802,25
13005,Bacon County,2021-07-29,12,2814,25.1
13005,Bacon County,2021-07-30,25,2839,25.3
13005,Bacon County,2021-07-31,3,2842,25.4
13005,Bacon County,2021-08-01,6,2848,25.4
13005,Bacon County,2021-08-02,14,2862,25.6
13005,Bacon County,2021-08-03,13,2875,25.7
13005,Bacon County,2021-08-04,21,2896,25.9
13005,Bacon County,2021-08-05,21,2917,26
13005,Bacon County,2021-08-06,53,2970,26.5
13005,Bacon County,2021-08-07,10,2980,26.6
13005,Bacon County,2021-08-08,4,2984,26.6
13005,Bacon County,2021-08-09,25,3009,26.9
13005,Bacon County,2021-08-10,21,3030,27.1
13005,Bacon County,2021-08-11,17,3047,27.2
13005,Bacon County,2021-08-12,14,3061,27.3
13005,Bacon County,2021-08-13,40,3101,27.7
13005,Bacon County,2021-08-14,7,3108,27.7
13005,Bacon County,2021-08-15,2,3110,27.8
13005,Bacon County,2021-08-16,26,3136,28
13005,Bacon County,2021-08-17,19,3155,28.2
13005,Bacon County,2021-08-18,38,3193,28.5
13005,Bacon County,2021-08-19,12,3205,28.6
13005,Bacon County,2021-08-20,34,3239,28.9
13005,Bacon County,2021-08-21,8,3247,29
13005,Bacon County,2021-08-22,1,3248,29
13005,Bacon County,2021-08-23,14,3262,29.1
13005,Bacon County,2021-08-24,11,3273,29.2
13005,Bacon County,2021-08-25,12,3285,29.3
13005,Bacon County,2021-08-26,14,3299,29.5
13005,Bacon County,2021-08-27,12,3311,29.6
13005,Bacon County,2021-08-28,3,3314,29.6
13005,Bacon County,2021-08-29,1,3315,29.6
13005,Bacon County,2021-08-30,9,3324,29.7
13005,Bacon County,2021-08-31,12,3336,29.8
13005,Bacon County,2021-09-01,25,3361,30
13005,Bacon County,2021-09-02,23,3384,30.2
13005,Bacon County,2021-09-03,24,3408,30.4
13005,Bacon County,2021-09-04,3,3411,30.5
13005,Bacon County,2021-09-05,2,3413,30.5
13005,Bacon County,2021-09-06,3,3416,30.5
13005,Bacon County,2021-09-07,12,3428,30.6
13005,Bacon County,2021-09-08,11,3439,30.7
13005,Bacon County,2021-09-09,10,3449,30.8
13005,Bacon County,2021-09-10,23,3472,31
13005,Bacon County,2021-09-11,3,3475,31
13005,Bacon County,2021-09-12,4,3479,31.1
13005,Bacon County,2021-09-13,5,3484,31.1
13005,Bacon County,2021-09-14,15,3499,31.2
13005,Bacon County,2021-09-15,2,3501,31.3
13005,Bacon County,2021-09-16,7,3508,31.3
13005,Bacon County,2021-09-17,19,3527,31.5
13005,Bacon County,2021-09-18,2,3529,31.5
13005,Bacon County,2021-09-20,11,3540,31.6
13005,Bacon County,2021-09-21,2,3542,31.6
13005,Bacon County,2021-09-22,6,3548,31.7
13005,Bacon County,2021-09-23,6,3554,31.7
13005,Bacon County,2021-09-24,9,3563,31.8
13005,Bacon County,2021-09-25,3,3566,31.8
13005,Bacon County,2021-09-27,4,3570,31.9
13005,Bacon County,2021-09-28,3,3573,31.9
13005,Bacon County,2021-09-29,4,3577,31.9
13005,Bacon County,2021-10-01,2,3579,32
13005,Bacon County,2021-10-02,3,3582,32
13005,Bacon County,2021-10-04,6,3588,32
13005,Bacon County,2021-10-05,1,3589,32
13005,Bacon County,2021-10-06,1,3590,32.1
13007,Baker County,2020-12-17,2,2,0.1
13007,Baker County,2020-12-18,1,3,0.1
13007,Baker County,2020-12-20,1,4,0.1
13007,Baker County,2020-12-21,1,5,0.2
13007,Baker County,2020-12-22,3,8,0.3
13007,Baker County,2020-12-23,10,18,0.6
13007,Baker County,2020-12-26,1,19,0.6
13007,Baker County,2020-12-28,9,28,0.9
13007,Baker County,2020-12-29,5,33,1.1
13007,Baker County,2020-12-30,3,36,1.1
13007,Baker County,2021-01-04,1,37,1.2
13007,Baker County,2021-01-05,11,48,1.5
13007,Baker County,2021-01-06,3,51,1.6
13007,Baker County,2021-01-07,3,54,1.7
13007,Baker County,2021-01-08,9,63,2
13007,Baker County,2021-01-11,18,81,2.6
13007,Baker County,2021-01-12,21,102,3.3
13007,Baker County,2021-01-13,27,129,4.1
13007,Baker County,2021-01-14,32,161,5.1
13007,Baker County,2021-01-15,11,172,5.5
13007,Baker County,2021-01-18,34,206,6.6
13007,Baker County,2021-01-19,31,237,7.6
13007,Baker County,2021-01-20,20,257,8.2
13007,Baker County,2021-01-21,35,292,9.3
13007,Baker County,2021-01-22,12,304,9.7
13007,Baker County,2021-01-23,4,308,9.8
13007,Baker County,2021-01-24,1,309,9.9
13007,Baker County,2021-01-25,20,329,10.5
13007,Baker County,2021-01-26,27,356,11.4
13007,Baker County,2021-01-27,24,380,12.1
13007,Baker County,2021-01-28,29,409,13.1
13007,Baker County,2021-01-29,3,412,13.2
13007,Baker County,2021-02-01,15,427,13.6
13007,Baker County,2021-02-02,11,438,14
13007,Baker County,2021-02-03,10,448,14.3
13007,Baker County,2021-02-04,17,465,14.8
13007,Baker County,2021-02-05,6,471,15
13007,Baker County,2021-02-06,1,472,15.1
13007,Baker County,2021-02-08,7,479,15.3
13007,Baker County,2021-02-09,7,486,15.5
13007,Baker County,2021-02-10,1,487,15.5
13007,Baker County,2021-02-11,8,495,15.8
13007,Baker County,2021-02-12,5,500,16
13007,Baker County,2021-02-14,1,501,16
13007,Baker County,2021-02-15,2,503,16.1
13007,Baker County,2021-02-16,5,508,16.2
13007,Baker County,2021-02-17,5,513,16.4
13007,Baker County,2021-02-18,10,523,16.7
13007,Baker County,2021-02-19,3,526,16.8
13007,Baker County,2021-02-22,7,533,17
13007,Baker County,2021-02-23,7,540,17.2
13007,Baker County,2021-02-24,3,543,17.3
13007,Baker County,2021-02-25,8,551,17.6
13007,Baker County,2021-02-26,3,554,17.7
13007,Baker County,2021-02-27,2,556,17.8
13007,Baker County,2021-02-28,2,558,17.8
13007,Baker County,2021-03-01,6,564,18
13007,Baker County,2021-03-02,14,578,18.5
13007,Baker County,2021-03-03,7,585,18.7
13007,Baker County,2021-03-04,8,593,18.9
13007,Baker County,2021-03-05,1,594,19
13007,Baker County,2021-03-08,7,601,19.2
13007,Baker County,2021-03-09,7,608,19.4
13007,Baker County,2021-03-10,13,621,19.8
13007,Baker County,2021-03-11,6,627,20
13007,Baker County,2021-03-12,4,631,20.1
13007,Baker County,2021-03-13,4,635,20.3
13007,Baker County,2021-03-15,26,661,21.1
13007,Baker County,2021-03-16,15,676,21.6
13007,Baker County,2021-03-17,13,689,22
13007,Baker County,2021-03-18,14,703,22.4
13007,Baker County,2021-03-19,6,709,22.6
13007,Baker County,2021-03-20,4,713,22.8
13007,Baker County,2021-03-21,2,715,22.8
13007,Baker County,2021-03-22,10,725,23.1
13007,Baker County,2021-03-23,7,732,23.4
13007,Baker County,2021-03-24,6,738,23.6
13007,Baker County,2021-03-25,16,754,24.1
13007,Baker County,2021-03-27,2,756,24.1
13007,Baker County,2021-03-28,1,757,24.2
13007,Baker County,2021-03-29,18,775,24.7
13007,Baker County,2021-03-30,30,805,25.7
13007,Baker County,2021-03-31,9,814,26
13007,Baker County,2021-04-01,20,834,26.6
13007,Baker County,2021-04-02,6,840,26.8
13007,Baker County,2021-04-03,1,841,26.9
13007,Baker County,2021-04-04,1,842,26.9
13007,Baker County,2021-04-05,8,850,27.1
13007,Baker County,2021-04-06,10,860,27.5
13007,Baker County,2021-04-07,16,876,28
13007,Baker County,2021-04-08,7,883,28.2
13007,Baker County,2021-04-09,5,888,28.4
13007,Baker County,2021-04-10,1,889,28.4
13007,Baker County,2021-04-11,1,890,28.4
13007,Baker County,2021-04-12,10,900,28.7
13007,Baker County,2021-04-13,7,907,29
13007,Baker County,2021-04-14,14,921,29.4
13007,Baker County,2021-04-15,9,930,29.7
13007,Baker County,2021-04-17,1,931,29.7
13007,Baker County,2021-04-19,2,933,29.8
13007,Baker County,2021-04-20,6,939,30
13007,Baker County,2021-04-21,3,942,30.1
13007,Baker County,2021-04-22,2,944,30.1
13007,Baker County,2021-04-23,3,947,30.2
13007,Baker County,2021-04-26,1,948,30.3
13007,Baker County,2021-04-27,5,953,30.4
13007,Baker County,2021-04-28,6,959,30.6
13007,Baker County,2021-04-29,6,965,30.8
13007,Baker County,2021-04-30,2,967,30.9
13007,Baker County,2021-05-04,5,972,31
13007,Baker County,2021-05-05,4,976,31.2
13007,Baker County,2021-05-07,4,980,31.3
13007,Baker County,2021-05-08,4,984,31.4
13007,Baker County,2021-05-10,1,985,31.4
13007,Baker County,2021-05-11,6,991,31.6
13007,Baker County,2021-05-12,35,1026,32.8
13007,Baker County,2021-05-13,2,1028,32.8
13007,Baker County,2021-05-15,3,1031,32.9
13007,Baker County,2021-05-17,3,1034,33
13007,Baker County,2021-05-18,7,1041,33.2
13007,Baker County,2021-05-19,9,1050,33.5
13007,Baker County,2021-05-20,1,1051,33.6
13007,Baker County,2021-05-22,3,1054,33.7
13007,Baker County,2021-05-24,1,1055,33.7
13007,Baker County,2021-05-25,4,1059,33.8
13007,Baker County,2021-05-26,1,1060,33.8
13007,Baker County,2021-05-27,1,1061,33.9
13007,Baker County,2021-06-01,4,1065,34
13007,Baker County,2021-06-03,1,1066,34
13007,Baker County,2021-06-04,1,1067,34.1
13007,Baker County,2021-06-06,1,1068,34.1
13007,Baker County,2021-06-08,1,1069,34.1
13007,Baker County,2021-06-09,2,1071,34.2
13007,Baker County,2021-06-10,3,1074,34.3
13007,Baker County,2021-06-12,5,1079,34.5
13007,Baker County,2021-06-15,2,1081,34.5
13007,Baker County,2021-06-16,1,1082,34.5
13007,Baker County,2021-06-17,1,1083,34.6
13007,Baker County,2021-06-18,1,1084,34.6
13007,Baker County,2021-06-19,1,1085,34.6
13007,Baker County,2021-06-21,1,1086,34.7
13007,Baker County,2021-06-22,4,1090,34.8
13007,Baker County,2021-06-23,2,1092,34.9
13007,Baker County,2021-06-24,1,1093,34.9
13007,Baker County,2021-06-29,4,1097,35
13007,Baker County,2021-06-30,2,1099,35.1
13007,Baker County,2021-07-01,7,1106,35.3
13007,Baker County,2021-07-02,2,1108,35.4
13007,Baker County,2021-07-05,1,1109,35.4
13007,Baker County,2021-07-06,1,1110,35.4
13007,Baker County,2021-07-07,4,1114,35.6
13007,Baker County,2021-07-08,2,1116,35.6
13007,Baker County,2021-07-10,1,1117,35.7
13007,Baker County,2021-07-12,1,1118,35.7
13007,Baker County,2021-07-13,1,1119,35.7
13007,Baker County,2021-07-14,1,1120,35.8
13007,Baker County,2021-07-16,5,1125,35.9
13007,Baker County,2021-07-20,6,1131,36.1
13007,Baker County,2021-07-21,1,1132,36.1
13007,Baker County,2021-07-22,5,1137,36.3
13007,Baker County,2021-07-23,3,1140,36.4
13007,Baker County,2021-07-24,1,1141,36.4
13007,Baker County,2021-07-25,1,1142,36.5
13007,Baker County,2021-07-26,5,1147,36.6
13007,Baker County,2021-07-27,18,1165,37.2
13007,Baker County,2021-07-28,5,1170,37.4
13007,Baker County,2021-07-29,7,1177,37.6
13007,Baker County,2021-07-30,5,1182,37.7
13007,Baker County,2021-07-31,5,1187,37.9
13007,Baker County,2021-08-01,1,1188,37.9
13007,Baker County,2021-08-02,14,1202,38.4
13007,Baker County,2021-08-03,7,1209,38.6
13007,Baker County,2021-08-04,9,1218,38.9
13007,Baker County,2021-08-05,8,1226,39.1
13007,Baker County,2021-08-06,7,1233,39.4
13007,Baker County,2021-08-07,7,1240,39.6
13007,Baker County,2021-08-08,1,1241,39.6
13007,Baker County,2021-08-09,8,1249,39.9
13007,Baker County,2021-08-10,12,1261,40.3
13007,Baker County,2021-08-11,11,1272,40.6
13007,Baker County,2021-08-12,8,1280,40.9
13007,Baker County,2021-08-13,8,1288,41.1
13007,Baker County,2021-08-14,1,1289,41.2
13007,Baker County,2021-08-15,2,1291,41.2
13007,Baker County,2021-08-16,3,1294,41.3
13007,Baker County,2021-08-17,12,1306,41.7
13007,Baker County,2021-08-18,8,1314,42
13007,Baker County,2021-08-19,8,1322,42.2
13007,Baker County,2021-08-20,6,1328,42.4
13007,Baker County,2021-08-21,1,1329,42.4
13007,Baker County,2021-08-23,9,1338,42.7
13007,Baker County,2021-08-24,7,1345,42.9
13007,Baker County,2021-08-25,12,1357,43.3
13007,Baker County,2021-08-26,7,1364,43.6
13007,Baker County,2021-08-27,5,1369,43.7
13007,Baker County,2021-08-28,1,1370,43.7
13007,Baker County,2021-08-29,2,1372,43.8
13007,Baker County,2021-08-30,4,1376,43.9
13007,Baker County,2021-08-31,10,1386,44.3
13007,Baker County,2021-09-01,9,1395,44.5
13007,Baker County,2021-09-02,6,1401,44.7
13007,Baker County,2021-09-03,6,1407,44.9
13007,Baker County,2021-09-04,2,1409,45
13007,Baker County,2021-09-05,2,1411,45.1
13007,Baker County,2021-09-07,7,1418,45.3
13007,Baker County,2021-09-08,8,1426,45.5
13007,Baker County,2021-09-09,3,1429,45.6
13007,Baker County,2021-09-10,5,1434,45.8
13007,Baker County,2021-09-12,1,1435,45.8
13007,Baker County,2021-09-13,2,1437,45.9
13007,Baker County,2021-09-14,5,1442,46
13007,Baker County,2021-09-16,5,1447,46.2
13007,Baker County,2021-09-17,5,1452,46.4
13007,Baker County,2021-09-18,1,1453,46.4
13007,Baker County,2021-09-20,3,1456,46.5
13007,Baker County,2021-09-21,3,1459,46.6
13007,Baker County,2021-09-22,1,1460,46.6
13007,Baker County,2021-09-23,4,1464,46.7
13007,Baker County,2021-09-24,2,1466,46.8
13007,Baker County,2021-09-27,1,1467,46.8
13007,Baker County,2021-09-28,2,1469,46.9
13007,Baker County,2021-09-29,2,1471,47
13007,Baker County,2021-09-30,3,1474,47.1
13007,Baker County,2021-10-03,1,1475,47.1
13007,Baker County,2021-10-04,1,1476,47.1
13007,Baker County,2021-10-07,5,1481,47.3
13009,Baldwin County,2020-12-16,1,1,0
13009,Baldwin County,2020-12-17,4,5,0
13009,Baldwin County,2020-12-18,5,10,0
13009,Baldwin County,2020-12-19,3,13,0
13009,Baldwin County,2020-12-20,2,15,0
13009,Baldwin County,2020-12-21,3,18,0
13009,Baldwin County,2020-12-22,20,38,0.1
13009,Baldwin County,2020-12-23,49,87,0.2
13009,Baldwin County,2020-12-24,15,102,0.2
13009,Baldwin County,2020-12-26,9,111,0.2
13009,Baldwin County,2020-12-27,4,115,0.3
13009,Baldwin County,2020-12-28,43,158,0.4
13009,Baldwin County,2020-12-29,33,191,0.4
13009,Baldwin County,2020-12-30,111,302,0.7
13009,Baldwin County,2020-12-31,42,344,0.8
13009,Baldwin County,2021-01-01,3,347,0.8
13009,Baldwin County,2021-01-02,5,352,0.8
13009,Baldwin County,2021-01-03,3,355,0.8
13009,Baldwin County,2021-01-04,234,589,1.3
13009,Baldwin County,2021-01-05,29,618,1.4
13009,Baldwin County,2021-01-06,135,753,1.7
13009,Baldwin County,2021-01-07,27,780,1.7
13009,Baldwin County,2021-01-08,60,840,1.9
13009,Baldwin County,2021-01-09,6,846,1.9
13009,Baldwin County,2021-01-10,8,854,1.9
13009,Baldwin County,2021-01-11,85,939,2.1
13009,Baldwin County,2021-01-12,183,1122,2.5
13009,Baldwin County,2021-01-13,98,1220,2.7
13009,Baldwin County,2021-01-14,156,1376,3.1
13009,Baldwin County,2021-01-15,198,1574,3.5
13009,Baldwin County,2021-01-16,61,1635,3.6
13009,Baldwin County,2021-01-17,34,1669,3.7
13009,Baldwin County,2021-01-18,164,1833,4.1
13009,Baldwin County,2021-01-19,177,2010,4.5
13009,Baldwin County,2021-01-20,237,2247,5
13009,Baldwin County,2021-01-21,276,2523,5.6
13009,Baldwin County,2021-01-22,239,2762,6.1
13009,Baldwin County,2021-01-23,110,2872,6.4
13009,Baldwin County,2021-01-24,23,2895,6.4
13009,Baldwin County,2021-01-25,130,3025,6.7
13009,Baldwin County,2021-01-26,52,3077,6.8
13009,Baldwin County,2021-01-27,201,3278,7.3
13009,Baldwin County,2021-01-28,163,3441,7.6
13009,Baldwin County,2021-01-29,178,3619,8
13009,Baldwin County,2021-01-30,22,3641,8.1
13009,Baldwin County,2021-01-31,4,3645,8.1
13009,Baldwin County,2021-02-01,143,3788,8.4
13009,Baldwin County,2021-02-02,177,3965,8.8
13009,Baldwin County,2021-02-03,175,4140,9.2
13009,Baldwin County,2021-02-04,172,4312,9.6
13009,Baldwin County,2021-02-05,137,4449,9.9
13009,Baldwin County,2021-02-06,33,4482,9.9
13009,Baldwin County,2021-02-07,9,4491,10
13009,Baldwin County,2021-02-08,85,4576,10.1
13009,Baldwin County,2021-02-09,135,4711,10.4
13009,Baldwin County,2021-02-10,119,4830,10.7
13009,Baldwin County,2021-02-11,91,4921,10.9
13009,Baldwin County,2021-02-12,60,4981,11
13009,Baldwin County,2021-02-13,33,5014,11.1
13009,Baldwin County,2021-02-14,19,5033,11.2
13009,Baldwin County,2021-02-15,84,5117,11.3
13009,Baldwin County,2021-02-16,80,5197,11.5
13009,Baldwin County,2021-02-17,130,5327,11.8
13009,Baldwin County,2021-02-18,113,5440,12.1
13009,Baldwin County,2021-02-19,57,5497,12.2
13009,Baldwin County,2021-02-20,41,5538,12.3
13009,Baldwin County,2021-02-21,1,5539,12.3
13009,Baldwin County,2021-02-22,35,5574,12.4
13009,Baldwin County,2021-02-23,70,5644,12.5
13009,Baldwin County,2021-02-24,97,5741,12.7
13009,Baldwin County,2021-02-25,165,5906,13.1
13009,Baldwin County,2021-02-26,103,6009,13.3
13009,Baldwin County,2021-02-27,32,6041,13.4
13009,Baldwin County,2021-02-28,39,6080,13.5
13009,Baldwin County,2021-03-01,110,6190,13.7
13009,Baldwin County,2021-03-02,164,6354,14.1
13009,Baldwin County,2021-03-03,136,6490,14.4
13009,Baldwin County,2021-03-04,162,6652,14.7
13009,Baldwin County,2021-03-05,130,6782,15
13009,Baldwin County,2021-03-06,15,6797,15.1
13009,Baldwin County,2021-03-07,34,6831,15.1
13009,Baldwin County,2021-03-08,122,6953,15.4
13009,Baldwin County,2021-03-09,209,7162,15.9
13009,Baldwin County,2021-03-10,221,7383,16.4
13009,Baldwin County,2021-03-11,242,7625,16.9
13009,Baldwin County,2021-03-12,460,8085,17.9
13009,Baldwin County,2021-03-13,74,8159,18.1
13009,Baldwin County,2021-03-14,25,8184,18.1
13009,Baldwin County,2021-03-15,126,8310,18.4
13009,Baldwin County,2021-03-16,322,8632,19.1
13009,Baldwin County,2021-03-17,272,8904,19.7
13009,Baldwin County,2021-03-18,153,9057,20.1
13009,Baldwin County,2021-03-19,440,9497,21.1
13009,Baldwin County,2021-03-20,45,9542,21.2
13009,Baldwin County,2021-03-21,24,9566,21.2
13009,Baldwin County,2021-03-22,112,9678,21.5
13009,Baldwin County,2021-03-23,327,10005,22.2
13009,Baldwin County,2021-03-24,194,10199,22.6
13009,Baldwin County,2021-03-25,272,10471,23.2
13009,Baldwin County,2021-03-26,220,10691,23.7
13009,Baldwin County,2021-03-27,71,10762,23.9
13009,Baldwin County,2021-03-28,36,10798,23.9
13009,Baldwin County,2021-03-29,116,10914,24.2
13009,Baldwin County,2021-03-30,251,11165,24.8
13009,Baldwin County,2021-03-31,202,11367,25.2
13009,Baldwin County,2021-04-01,305,11672,25.9
13009,Baldwin County,2021-04-02,187,11859,26.3
13009,Baldwin County,2021-04-03,30,11889,26.4
13009,Baldwin County,2021-04-04,24,11913,26.4
13009,Baldwin County,2021-04-05,81,11994,26.6
13009,Baldwin County,2021-04-06,218,12212,27.1
13009,Baldwin County,2021-04-07,170,12382,27.4
13009,Baldwin County,2021-04-08,192,12574,27.9
13009,Baldwin County,2021-04-09,115,12689,28.1
13009,Baldwin County,2021-04-10,35,12724,28.2
13009,Baldwin County,2021-04-11,20,12744,28.3
13009,Baldwin County,2021-04-12,44,12788,28.3
13009,Baldwin County,2021-04-13,129,12917,28.6
13009,Baldwin County,2021-04-14,116,13033,28.9
13009,Baldwin County,2021-04-15,104,13137,29.1
13009,Baldwin County,2021-04-16,70,13207,29.3
13009,Baldwin County,2021-04-17,17,13224,29.3
13009,Baldwin County,2021-04-18,14,13238,29.3
13009,Baldwin County,2021-04-19,37,13275,29.4
13009,Baldwin County,2021-04-20,77,13352,29.6
13009,Baldwin County,2021-04-21,81,13433,29.8
13009,Baldwin County,2021-04-22,148,13581,30.1
13009,Baldwin County,2021-04-23,82,13663,30.3
13009,Baldwin County,2021-04-24,22,13685,30.3
13009,Baldwin County,2021-04-25,3,13688,30.3
13009,Baldwin County,2021-04-26,24,13712,30.4
13009,Baldwin County,2021-04-27,78,13790,30.6
13009,Baldwin County,2021-04-28,83,13873,30.8
13009,Baldwin County,2021-04-29,80,13953,30.9
13009,Baldwin County,2021-04-30,75,14028,31.1
13009,Baldwin County,2021-05-01,53,14081,31.2
13009,Baldwin County,2021-05-02,9,14090,31.2
13009,Baldwin County,2021-05-03,22,14112,31.3
13009,Baldwin County,2021-05-04,43,14155,31.4
13009,Baldwin County,2021-05-05,46,14201,31.5
13009,Baldwin County,2021-05-06,68,14269,31.6
13009,Baldwin County,2021-05-07,56,14325,31.8
13009,Baldwin County,2021-05-08,28,14353,31.8
13009,Baldwin County,2021-05-09,11,14364,31.8
13009,Baldwin County,2021-05-10,11,14375,31.9
13009,Baldwin County,2021-05-11,55,14430,32
13009,Baldwin County,2021-05-12,41,14471,32.1
13009,Baldwin County,2021-05-13,45,14516,32.2
13009,Baldwin County,2021-05-14,42,14558,32.3
13009,Baldwin County,2021-05-15,27,14585,32.3
13009,Baldwin County,2021-05-16,29,14614,32.4
13009,Baldwin County,2021-05-17,48,14662,32.5
13009,Baldwin County,2021-05-18,75,14737,32.7
13009,Baldwin County,2021-05-19,42,14779,32.8
13009,Baldwin County,2021-05-20,66,14845,32.9
13009,Baldwin County,2021-05-21,115,14960,33.2
13009,Baldwin County,2021-05-22,23,14983,33.2
13009,Baldwin County,2021-05-23,16,14999,33.2
13009,Baldwin County,2021-05-24,46,15045,33.4
13009,Baldwin County,2021-05-25,50,15095,33.5
13009,Baldwin County,2021-05-26,33,15128,33.5
13009,Baldwin County,2021-05-27,33,15161,33.6
13009,Baldwin County,2021-05-28,46,15207,33.7
13009,Baldwin County,2021-05-29,22,15229,33.8
13009,Baldwin County,2021-05-30,9,15238,33.8
13009,Baldwin County,2021-05-31,3,15241,33.8
13009,Baldwin County,2021-06-01,51,15292,33.9
13009,Baldwin County,2021-06-02,39,15331,34
13009,Baldwin County,2021-06-03,46,15377,34.1
13009,Baldwin County,2021-06-04,43,15420,34.2
13009,Baldwin County,2021-06-05,18,15438,34.2
13009,Baldwin County,2021-06-06,9,15447,34.2
13009,Baldwin County,2021-06-07,20,15467,34.3
13009,Baldwin County,2021-06-08,22,15489,34.3
13009,Baldwin County,2021-06-09,27,15516,34.4
13009,Baldwin County,2021-06-10,39,15555,34.5
13009,Baldwin County,2021-06-11,34,15589,34.6
13009,Baldwin County,2021-06-12,11,15600,34.6
13009,Baldwin County,2021-06-13,4,15604,34.6
13009,Baldwin County,2021-06-14,13,15617,34.6
13009,Baldwin County,2021-06-15,33,15650,34.7
13009,Baldwin County,2021-06-16,42,15692,34.8
13009,Baldwin County,2021-06-17,25,15717,34.8
13009,Baldwin County,2021-06-18,35,15752,34.9
13009,Baldwin County,2021-06-19,19,15771,35
13009,Baldwin County,2021-06-20,4,15775,35
13009,Baldwin County,2021-06-21,12,15787,35
13009,Baldwin County,2021-06-22,39,15826,35.1
13009,Baldwin County,2021-06-23,29,15855,35.1
13009,Baldwin County,2021-06-24,30,15885,35.2
13009,Baldwin County,2021-06-25,36,15921,35.3
13009,Baldwin County,2021-06-26,13,15934,35.3
13009,Baldwin County,2021-06-27,8,15942,35.3
13009,Baldwin County,2021-06-28,25,15967,35.4
13009,Baldwin County,2021-06-29,29,15996,35.5
13009,Baldwin County,2021-06-30,21,16017,35.5
13009,Baldwin County,2021-07-01,29,16046,35.6
13009,Baldwin County,2021-07-02,31,16077,35.6
13009,Baldwin County,2021-07-03,6,16083,35.7
13009,Baldwin County,2021-07-04,3,16086,35.7
13009,Baldwin County,2021-07-05,18,16104,35.7
13009,Baldwin County,2021-07-06,33,16137,35.8
13009,Baldwin County,2021-07-07,17,16154,35.8
13009,Baldwin County,2021-07-08,26,16180,35.9
13009,Baldwin County,2021-07-09,27,16207,35.9
13009,Baldwin County,2021-07-10,12,16219,36
13009,Baldwin County,2021-07-11,6,16225,36
13009,Baldwin County,2021-07-12,21,16246,36
13009,Baldwin County,2021-07-13,49,16295,36.1
13009,Baldwin County,2021-07-14,41,16336,36.2
13009,Baldwin County,2021-07-15,38,16374,36.3
13009,Baldwin County,2021-07-16,27,16401,36.4
13009,Baldwin County,2021-07-17,16,16417,36.4
13009,Baldwin County,2021-07-18,9,16426,36.4
13009,Baldwin County,2021-07-19,31,16457,36.5
13009,Baldwin County,2021-07-20,47,16504,36.6
13009,Baldwin County,2021-07-21,51,16555,36.7
13009,Baldwin County,2021-07-22,51,16606,36.8
13009,Baldwin County,2021-07-23,130,16736,37.1
13009,Baldwin County,2021-07-24,39,16775,37.2
13009,Baldwin County,2021-07-25,16,16791,37.2
13009,Baldwin County,2021-07-26,48,16839,37.3
13009,Baldwin County,2021-07-27,99,16938,37.5
13009,Baldwin County,2021-07-28,86,17024,37.7
13009,Baldwin County,2021-07-29,78,17102,37.9
13009,Baldwin County,2021-07-30,124,17226,38.2
13009,Baldwin County,2021-07-31,46,17272,38.3
13009,Baldwin County,2021-08-01,36,17308,38.4
13009,Baldwin County,2021-08-02,64,17372,38.5
13009,Baldwin County,2021-08-03,96,17468,38.7
13009,Baldwin County,2021-08-04,61,17529,38.9
13009,Baldwin County,2021-08-05,67,17596,39
13009,Baldwin County,2021-08-06,86,17682,39.2
13009,Baldwin County,2021-08-07,67,17749,39.3
13009,Baldwin County,2021-08-08,29,17778,39.4
13009,Baldwin County,2021-08-09,52,17830,39.5
13009,Baldwin County,2021-08-10,130,17960,39.8
13009,Baldwin County,2021-08-11,118,18078,40.1
13009,Baldwin County,2021-08-12,85,18163,40.3
13009,Baldwin County,2021-08-13,113,18276,40.5
13009,Baldwin County,2021-08-14,59,18335,40.6
13009,Baldwin County,2021-08-15,39,18374,40.7
13009,Baldwin County,2021-08-16,66,18440,40.9
13009,Baldwin County,2021-08-17,137,18577,41.2
13009,Baldwin County,2021-08-18,119,18696,41.4
13009,Baldwin County,2021-08-19,88,18784,41.6
13009,Baldwin County,2021-08-20,72,18856,41.8
13009,Baldwin County,2021-08-21,38,18894,41.9
13009,Baldwin County,2021-08-22,24,18918,41.9
13009,Baldwin County,2021-08-23,61,18979,42.1
13009,Baldwin County,2021-08-24,95,19074,42.3
13009,Baldwin County,2021-08-25,112,19186,42.5
13009,Baldwin County,2021-08-26,87,19273,42.7
13009,Baldwin County,2021-08-27,62,19335,42.9
13009,Baldwin County,2021-08-28,35,19370,42.9
13009,Baldwin County,2021-08-29,17,19387,43
13009,Baldwin County,2021-08-30,38,19425,43.1
13009,Baldwin County,2021-08-31,114,19539,43.3
13009,Baldwin County,2021-09-01,71,19610,43.5
13009,Baldwin County,2021-09-02,66,19676,43.6
13009,Baldwin County,2021-09-03,65,19741,43.8
13009,Baldwin County,2021-09-04,29,19770,43.8
13009,Baldwin County,2021-09-05,22,19792,43.9
13009,Baldwin County,2021-09-06,44,19836,44
13009,Baldwin County,2021-09-07,57,19893,44.1
13009,Baldwin County,2021-09-08,50,19943,44.2
13009,Baldwin County,2021-09-09,43,19986,44.3
13009,Baldwin County,2021-09-10,106,20092,44.5
13009,Baldwin County,2021-09-11,26,20118,44.6
13009,Baldwin County,2021-09-12,16,20134,44.6
13009,Baldwin County,2021-09-13,24,20158,44.7
13009,Baldwin County,2021-09-14,75,20233,44.9
13009,Baldwin County,2021-09-15,72,20305,45
13009,Baldwin County,2021-09-16,27,20332,45.1
13009,Baldwin County,2021-09-17,30,20362,45.1
13009,Baldwin County,2021-09-18,22,20384,45.2
13009,Baldwin County,2021-09-19,15,20399,45.2
13009,Baldwin County,2021-09-20,25,20424,45.3
13009,Baldwin County,2021-09-21,45,20469,45.4
13009,Baldwin County,2021-09-22,33,20502,45.4
13009,Baldwin County,2021-09-23,31,20533,45.5
13009,Baldwin County,2021-09-24,34,20567,45.6
13009,Baldwin County,2021-09-25,10,20577,45.6
13009,Baldwin County,2021-09-26,6,20583,45.6
13009,Baldwin County,2021-09-27,17,20600,45.7
13009,Baldwin County,2021-09-28,33,20633,45.7
13009,Baldwin County,2021-09-29,33,20666,45.8
13009,Baldwin County,2021-09-30,28,20694,45.9
13009,Baldwin County,2021-10-01,27,20721,45.9
13009,Baldwin County,2021-10-02,12,20733,46
13009,Baldwin County,2021-10-03,8,20741,46
13009,Baldwin County,2021-10-04,13,20754,46
13009,Baldwin County,2021-10-05,13,20767,46
13009,Baldwin County,2021-10-06,20,20787,46.1
13009,Baldwin County,2021-10-07,7,20794,46.1
13011,Banks County,2020-12-14,1,1,0
13011,Banks County,2020-12-18,2,3,0
13011,Banks County,2020-12-19,2,5,0
13011,Banks County,2020-12-21,9,14,0.1
13011,Banks County,2020-12-22,15,29,0.2
13011,Banks County,2020-12-23,12,41,0.2
13011,Banks County,2020-12-26,2,43,0.2
13011,Banks County,2020-12-27,2,45,0.2
13011,Banks County,2020-12-28,16,61,0.3
13011,Banks County,2020-12-29,24,85,0.5
13011,Banks County,2020-12-30,14,99,0.5
13011,Banks County,2020-12-31,7,106,0.6
13011,Banks County,2021-01-01,3,109,0.6
13011,Banks County,2021-01-02,2,111,0.6
13011,Banks County,2021-01-03,1,112,0.6
13011,Banks County,2021-01-04,13,125,0.7
13011,Banks County,2021-01-05,21,146,0.8
13011,Banks County,2021-01-06,11,157,0.8
13011,Banks County,2021-01-07,8,165,0.9
13011,Banks County,2021-01-08,14,179,1
13011,Banks County,2021-01-10,3,182,1
13011,Banks County,2021-01-11,34,216,1.2
13011,Banks County,2021-01-12,52,268,1.4
13011,Banks County,2021-01-13,96,364,1.9
13011,Banks County,2021-01-14,132,496,2.7
13011,Banks County,2021-01-15,69,565,3
13011,Banks County,2021-01-16,7,572,3.1
13011,Banks County,2021-01-17,9,581,3.1
13011,Banks County,2021-01-18,78,659,3.5
13011,Banks County,2021-01-19,92,751,4
13011,Banks County,2021-01-20,72,823,4.4
13011,Banks County,2021-01-21,36,859,4.6
13011,Banks County,2021-01-22,36,895,4.8
13011,Banks County,2021-01-23,15,910,4.9
13011,Banks County,2021-01-24,11,921,4.9
13011,Banks County,2021-01-25,19,940,5
13011,Banks County,2021-01-26,53,993,5.3
13011,Banks County,2021-01-27,74,1067,5.7
13011,Banks County,2021-01-28,26,1093,5.8
13011,Banks County,2021-01-29,24,1117,6
13011,Banks County,2021-01-30,8,1125,6
13011,Banks County,2021-01-31,2,1127,6
13011,Banks County,2021-02-01,39,1166,6.2
13011,Banks County,2021-02-02,48,1214,6.5
13011,Banks County,2021-02-03,93,1307,7
13011,Banks County,2021-02-04,22,1329,7.1
13011,Banks County,2021-02-05,24,1353,7.2
13011,Banks County,2021-02-06,10,1363,7.3
13011,Banks County,2021-02-08,20,1383,7.4
13011,Banks County,2021-02-09,22,1405,7.5
13011,Banks County,2021-02-10,20,1425,7.6
13011,Banks County,2021-02-11,24,1449,7.7
13011,Banks County,2021-02-12,26,1475,7.9
13011,Banks County,2021-02-13,2,1477,7.9
13011,Banks County,2021-02-14,1,1478,7.9
13011,Banks County,2021-02-15,27,1505,8
13011,Banks County,2021-02-16,19,1524,8.1
13011,Banks County,2021-02-17,14,1538,8.2
13011,Banks County,2021-02-18,17,1555,8.3
13011,Banks County,2021-02-19,18,1573,8.4
13011,Banks County,2021-02-22,12,1585,8.5
13011,Banks County,2021-02-23,20,1605,8.6
13011,Banks County,2021-02-24,29,1634,8.7
13011,Banks County,2021-02-25,9,1643,8.8
13011,Banks County,2021-02-26,17,1660,8.9
13011,Banks County,2021-02-27,4,1664,8.9
13011,Banks County,2021-02-28,8,1672,8.9
13011,Banks County,2021-03-01,21,1693,9
13011,Banks County,2021-03-02,37,1730,9.2
13011,Banks County,2021-03-03,25,1755,9.4
13011,Banks County,2021-03-04,32,1787,9.6
13011,Banks County,2021-03-05,26,1813,9.7
13011,Banks County,2021-03-06,13,1826,9.8
13011,Banks County,2021-03-07,17,1843,9.9
13011,Banks County,2021-03-08,27,1870,10
13011,Banks County,2021-03-09,39,1909,10.2
13011,Banks County,2021-03-10,50,1959,10.5
13011,Banks County,2021-03-11,48,2007,10.7
13011,Banks County,2021-03-12,91,2098,11.2
13011,Banks County,2021-03-13,32,2130,11.4
13011,Banks County,2021-03-14,9,2139,11.4
13011,Banks County,2021-03-15,67,2206,11.8
13011,Banks County,2021-03-16,145,2351,12.6
13011,Banks County,2021-03-17,65,2416,12.9
13011,Banks County,2021-03-18,104,2520,13.5
13011,Banks County,2021-03-19,71,2591,13.8
13011,Banks County,2021-03-20,20,2611,14
13011,Banks County,2021-03-21,45,2656,14.2
13011,Banks County,2021-03-22,39,2695,14.4
13011,Banks County,2021-03-23,55,2750,14.7
13011,Banks County,2021-03-24,77,2827,15.1
13011,Banks County,2021-03-25,79,2906,15.5
13011,Banks County,2021-03-26,46,2952,15.8
13011,Banks County,2021-03-27,12,2964,15.8
13011,Banks County,2021-03-28,10,2974,15.9
13011,Banks County,2021-03-29,48,3022,16.2
13011,Banks County,2021-03-30,51,3073,16.4
13011,Banks County,2021-03-31,51,3124,16.7
13011,Banks County,2021-04-01,81,3205,17.1
13011,Banks County,2021-04-02,36,3241,17.3
13011,Banks County,2021-04-03,12,3253,17.4
13011,Banks County,2021-04-04,8,3261,17.4
13011,Banks County,2021-04-05,52,3313,17.7
13011,Banks County,2021-04-06,43,3356,17.9
13011,Banks County,2021-04-07,59,3415,18.3
13011,Banks County,2021-04-08,58,3473,18.6
13011,Banks County,2021-04-09,50,3523,18.8
13011,Banks County,2021-04-10,19,3542,18.9
13011,Banks County,2021-04-11,8,3550,19
13011,Banks County,2021-04-12,36,3586,19.2
13011,Banks County,2021-04-13,29,3615,19.3
13011,Banks County,2021-04-14,21,3636,19.4
13011,Banks County,2021-04-15,26,3662,19.6
13011,Banks County,2021-04-16,25,3687,19.7
13011,Banks County,2021-04-17,12,3699,19.8
13011,Banks County,2021-04-18,5,3704,19.8
13011,Banks County,2021-04-19,8,3712,19.8
13011,Banks County,2021-04-20,25,3737,20
13011,Banks County,2021-04-21,29,3766,20.1
13011,Banks County,2021-04-22,25,3791,20.3
13011,Banks County,2021-04-23,40,3831,20.5
13011,Banks County,2021-04-24,12,3843,20.5
13011,Banks County,2021-04-25,4,3847,20.6
13011,Banks County,2021-04-26,15,3862,20.6
13011,Banks County,2021-04-27,21,3883,20.8
13011,Banks County,2021-04-28,25,3908,20.9
13011,Banks County,2021-04-29,28,3936,21
13011,Banks County,2021-04-30,46,3982,21.3
13011,Banks County,2021-05-01,8,3990,21.3
13011,Banks County,2021-05-02,5,3995,21.4
13011,Banks County,2021-05-03,9,4004,21.4
13011,Banks County,2021-05-04,13,4017,21.5
13011,Banks County,2021-05-05,34,4051,21.7
13011,Banks County,2021-05-06,19,4070,21.8
13011,Banks County,2021-05-07,26,4096,21.9
13011,Banks County,2021-05-08,9,4105,21.9
13011,Banks County,2021-05-09,6,4111,22
13011,Banks County,2021-05-10,11,4122,22
13011,Banks County,2021-05-11,14,4136,22.1
13011,Banks County,2021-05-12,22,4158,22.2
13011,Banks County,2021-05-13,17,4175,22.3
13011,Banks County,2021-05-14,33,4208,22.5
13011,Banks County,2021-05-15,11,4219,22.6
13011,Banks County,2021-05-16,7,4226,22.6
13011,Banks County,2021-05-17,15,4241,22.7
13011,Banks County,2021-05-18,23,4264,22.8
13011,Banks County,2021-05-19,21,4285,22.9
13011,Banks County,2021-05-20,22,4307,23
13011,Banks County,2021-05-21,14,4321,23.1
13011,Banks County,2021-05-22,9,4330,23.1
13011,Banks County,2021-05-23,8,4338,23.2
13011,Banks County,2021-05-24,13,4351,23.3
13011,Banks County,2021-05-25,17,4368,23.3
13011,Banks County,2021-05-26,19,4387,23.4
13011,Banks County,2021-05-27,17,4404,23.5
13011,Banks County,2021-05-28,12,4416,23.6
13011,Banks County,2021-05-29,6,4422,23.6
13011,Banks County,2021-05-30,2,4424,23.6
13011,Banks County,2021-05-31,3,4427,23.7
13011,Banks County,2021-06-01,10,4437,23.7
13011,Banks County,2021-06-02,6,4443,23.7
13011,Banks County,2021-06-03,4,4447,23.8
13011,Banks County,2021-06-04,8,4455,23.8
13011,Banks County,2021-06-05,5,4460,23.8
13011,Banks County,2021-06-06,3,4463,23.9
13011,Banks County,2021-06-07,6,4469,23.9
13011,Banks County,2021-06-08,13,4482,24
13011,Banks County,2021-06-09,5,4487,24
13011,Banks County,2021-06-10,15,4502,24.1
13011,Banks County,2021-06-11,13,4515,24.1
13011,Banks County,2021-06-12,4,4519,24.2
13011,Banks County,2021-06-14,6,4525,24.2
13011,Banks County,2021-06-15,11,4536,24.2
13011,Banks County,2021-06-16,8,4544,24.3
13011,Banks County,2021-06-17,5,4549,24.3
13011,Banks County,2021-06-18,14,4563,24.4
13011,Banks County,2021-06-19,7,4570,24.4
13011,Banks County,2021-06-20,1,4571,24.4
13011,Banks County,2021-06-21,6,4577,24.5
13011,Banks County,2021-06-22,8,4585,24.5
13011,Banks County,2021-06-23,12,4597,24.6
13011,Banks County,2021-06-24,2,4599,24.6
13011,Banks County,2021-06-25,8,4607,24.6
13011,Banks County,2021-06-26,1,4608,24.6
13011,Banks County,2021-06-27,1,4609,24.6
13011,Banks County,2021-06-28,4,4613,24.7
13011,Banks County,2021-06-29,2,4615,24.7
13011,Banks County,2021-06-30,4,4619,24.7
13011,Banks County,2021-07-01,9,4628,24.7
13011,Banks County,2021-07-02,9,4637,24.8
13011,Banks County,2021-07-03,6,4643,24.8
13011,Banks County,2021-07-04,2,4645,24.8
13011,Banks County,2021-07-06,6,4651,24.9
13011,Banks County,2021-07-07,6,4657,24.9
13011,Banks County,2021-07-08,7,4664,24.9
13011,Banks County,2021-07-09,8,4672,25
13011,Banks County,2021-07-10,5,4677,25
13011,Banks County,2021-07-11,1,4678,25
13011,Banks County,2021-07-12,6,4684,25
13011,Banks County,2021-07-13,5,4689,25.1
13011,Banks County,2021-07-14,2,4691,25.1
13011,Banks County,2021-07-15,11,4702,25.1
13011,Banks County,2021-07-16,14,4716,25.2
13011,Banks County,2021-07-17,5,4721,25.2
13011,Banks County,2021-07-18,4,4725,25.3
13011,Banks County,2021-07-19,9,4734,25.3
13011,Banks County,2021-07-20,13,4747,25.4
13011,Banks County,2021-07-21,12,4759,25.4
13011,Banks County,2021-07-22,11,4770,25.5
13011,Banks County,2021-07-23,16,4786,25.6
13011,Banks County,2021-07-24,10,4796,25.6
13011,Banks County,2021-07-25,10,4806,25.7
13011,Banks County,2021-07-26,6,4812,25.7
13011,Banks County,2021-07-27,13,4825,25.8
13011,Banks County,2021-07-28,18,4843,25.9
13011,Banks County,2021-07-29,21,4864,26
13011,Banks County,2021-07-30,21,4885,26.1
13011,Banks County,2021-07-31,10,4895,26.2
13011,Banks County,2021-08-01,8,4903,26.2
13011,Banks County,2021-08-02,16,4919,26.3
13011,Banks County,2021-08-03,31,4950,26.5
13011,Banks County,2021-08-04,29,4979,26.6
13011,Banks County,2021-08-05,26,5005,26.8
13011,Banks County,2021-08-06,33,5038,26.9
13011,Banks County,2021-08-07,18,5056,27
13011,Banks County,2021-08-08,12,5068,27.1
13011,Banks County,2021-08-09,27,5095,27.2
13011,Banks County,2021-08-10,25,5120,27.4
13011,Banks County,2021-08-11,24,5144,27.5
13011,Banks County,2021-08-12,27,5171,27.6
13011,Banks County,2021-08-13,36,5207,27.8
13011,Banks County,2021-08-14,26,5233,28
13011,Banks County,2021-08-15,15,5248,28.1
13011,Banks County,2021-08-16,26,5274,28.2
13011,Banks County,2021-08-17,17,5291,28.3
13011,Banks County,2021-08-18,31,5322,28.4
13011,Banks County,2021-08-19,20,5342,28.6
13011,Banks County,2021-08-20,43,5385,28.8
13011,Banks County,2021-08-21,26,5411,28.9
13011,Banks County,2021-08-22,9,5420,29
13011,Banks County,2021-08-23,33,5453,29.1
13011,Banks County,2021-08-24,34,5487,29.3
13011,Banks County,2021-08-25,27,5514,29.5
13011,Banks County,2021-08-26,35,5549,29.7
13011,Banks County,2021-08-27,40,5589,29.9
13011,Banks County,2021-08-28,21,5610,30
13011,Banks County,2021-08-29,9,5619,30
13011,Banks County,2021-08-30,35,5654,30.2
13011,Banks County,2021-08-31,49,5703,30.5
13011,Banks County,2021-09-01,37,5740,30.7
13011,Banks County,2021-09-02,34,5774,30.9
13011,Banks County,2021-09-03,49,5823,31.1
13011,Banks County,2021-09-04,16,5839,31.2
13011,Banks County,2021-09-05,13,5852,31.3
13011,Banks County,2021-09-06,1,5853,31.3
13011,Banks County,2021-09-07,25,5878,31.4
13011,Banks County,2021-09-08,19,5897,31.5
13011,Banks County,2021-09-09,31,5928,31.7
13011,Banks County,2021-09-10,39,5967,31.9
13011,Banks County,2021-09-11,12,5979,32
13011,Banks County,2021-09-12,8,5987,32
13011,Banks County,2021-09-13,12,5999,32.1
13011,Banks County,2021-09-14,22,6021,32.2
13011,Banks County,2021-09-15,15,6036,32.3
13011,Banks County,2021-09-16,12,6048,32.3
13011,Banks County,2021-09-17,12,6060,32.4
13011,Banks County,2021-09-18,13,6073,32.5
13011,Banks County,2021-09-19,8,6081,32.5
13011,Banks County,2021-09-20,13,6094,32.6
13011,Banks County,2021-09-21,14,6108,32.6
13011,Banks County,2021-09-22,10,6118,32.7
13011,Banks County,2021-09-23,7,6125,32.7
13011,Banks County,2021-09-24,12,6137,32.8
13011,Banks County,2021-09-25,2,6139,32.8
13011,Banks County,2021-09-26,3,6142,32.8
13011,Banks County,2021-09-27,8,6150,32.9
13011,Banks County,2021-09-28,1,6151,32.9
13011,Banks County,2021-09-29,5,6156,32.9
13011,Banks County,2021-09-30,5,6161,32.9
13011,Banks County,2021-10-01,7,6168,33
13011,Banks County,2021-10-02,5,6173,33
13011,Banks County,2021-10-03,3,6176,33
13011,Banks County,2021-10-04,3,6179,33
13011,Banks County,2021-10-05,3,6182,33
13011,Banks County,2021-10-06,5,6187,33.1
13011,Banks County,2021-10-07,5,6192,33.1
13013,Barrow County,2020-12-16,2,2,0
13013,Barrow County,2020-12-17,7,9,0
13013,Barrow County,2020-12-18,22,31,0
13013,Barrow County,2020-12-19,10,41,0.1
13013,Barrow County,2020-12-20,11,52,0.1
13013,Barrow County,2020-12-21,31,83,0.1
13013,Barrow County,2020-12-22,36,119,0.2
13013,Barrow County,2020-12-23,62,181,0.2
13013,Barrow County,2020-12-24,17,198,0.3
13013,Barrow County,2020-12-25,1,199,0.3
13013,Barrow County,2020-12-26,8,207,0.3
13013,Barrow County,2020-12-27,10,217,0.3
13013,Barrow County,2020-12-28,76,293,0.4
13013,Barrow County,2020-12-29,172,465,0.6
13013,Barrow County,2020-12-30,76,541,0.7
13013,Barrow County,2020-12-31,46,587,0.7
13013,Barrow County,2021-01-01,11,598,0.8
13013,Barrow County,2021-01-02,13,611,0.8
13013,Barrow County,2021-01-03,20,631,0.8
13013,Barrow County,2021-01-04,61,692,0.9
13013,Barrow County,2021-01-05,59,751,1
13013,Barrow County,2021-01-06,96,847,1.1
13013,Barrow County,2021-01-07,53,900,1.1
13013,Barrow County,2021-01-08,59,959,1.2
13013,Barrow County,2021-01-09,34,993,1.3
13013,Barrow County,2021-01-10,9,1002,1.3
13013,Barrow County,2021-01-11,68,1070,1.4
13013,Barrow County,2021-01-12,82,1152,1.5
13013,Barrow County,2021-01-13,95,1247,1.6
13013,Barrow County,2021-01-14,159,1406,1.8
13013,Barrow County,2021-01-15,180,1586,2
13013,Barrow County,2021-01-16,154,1740,2.2
13013,Barrow County,2021-01-17,48,1788,2.3
13013,Barrow County,2021-01-18,149,1937,2.5
13013,Barrow County,2021-01-19,189,2126,2.7
13013,Barrow County,2021-01-20,266,2392,3
13013,Barrow County,2021-01-21,153,2545,3.2
13013,Barrow County,2021-01-22,156,2701,3.4
13013,Barrow County,2021-01-23,133,2834,3.6
13013,Barrow County,2021-01-24,43,2877,3.6
13013,Barrow County,2021-01-25,100,2977,3.8
13013,Barrow County,2021-01-26,204,3181,4
13013,Barrow County,2021-01-27,272,3453,4.4
13013,Barrow County,2021-01-28,202,3655,4.6
13013,Barrow County,2021-01-29,253,3908,4.9
13013,Barrow County,2021-01-30,41,3949,5
13013,Barrow County,2021-01-31,6,3955,5
13013,Barrow County,2021-02-01,67,4022,5.1
13013,Barrow County,2021-02-02,134,4156,5.3
13013,Barrow County,2021-02-03,185,4341,5.5
13013,Barrow County,2021-02-04,129,4470,5.7
13013,Barrow County,2021-02-05,104,4574,5.8
13013,Barrow County,2021-02-06,30,4604,5.8
13013,Barrow County,2021-02-07,12,4616,5.8
13013,Barrow County,2021-02-08,126,4742,6
13013,Barrow County,2021-02-09,165,4907,6.2
13013,Barrow County,2021-02-10,152,5059,6.4
13013,Barrow County,2021-02-11,70,5129,6.5
13013,Barrow County,2021-02-12,88,5217,6.6
13013,Barrow County,2021-02-13,33,5250,6.6
13013,Barrow County,2021-02-14,14,5264,6.7
13013,Barrow County,2021-02-15,81,5345,6.8
13013,Barrow County,2021-02-16,113,5458,6.9
13013,Barrow County,2021-02-17,116,5574,7.1
13013,Barrow County,2021-02-18,48,5622,7.1
13013,Barrow County,2021-02-19,59,5681,7.2
13013,Barrow County,2021-02-20,18,5699,7.2
13013,Barrow County,2021-02-21,7,5706,7.2
13013,Barrow County,2021-02-22,41,5747,7.3
13013,Barrow County,2021-02-23,116,5863,7.4
13013,Barrow County,2021-02-24,184,6047,7.7
13013,Barrow County,2021-02-25,78,6125,7.8
13013,Barrow County,2021-02-26,94,6219,7.9
13013,Barrow County,2021-02-27,155,6374,8.1
13013,Barrow County,2021-02-28,43,6417,8.1
13013,Barrow County,2021-03-01,127,6544,8.3
13013,Barrow County,2021-03-02,171,6715,8.5
13013,Barrow County,2021-03-03,146,6861,8.7
13013,Barrow County,2021-03-04,134,6995,8.9
13013,Barrow County,2021-03-05,173,7168,9.1
13013,Barrow County,2021-03-06,153,7321,9.3
13013,Barrow County,2021-03-07,45,7366,9.3
13013,Barrow County,2021-03-08,241,7607,9.6
13013,Barrow County,2021-03-09,251,7858,9.9
13013,Barrow County,2021-03-10,264,8122,10.3
13013,Barrow County,2021-03-11,665,8787,11.1
13013,Barrow County,2021-03-12,286,9073,11.5
13013,Barrow County,2021-03-13,158,9231,11.7
13013,Barrow County,2021-03-14,82,9313,11.8
13013,Barrow County,2021-03-15,234,9547,12.1
13013,Barrow County,2021-03-16,350,9897,12.5
13013,Barrow County,2021-03-17,591,10488,13.3
13013,Barrow County,2021-03-18,310,10798,13.7
13013,Barrow County,2021-03-19,282,11080,14
13013,Barrow County,2021-03-20,163,11243,14.2
13013,Barrow County,2021-03-21,88,11331,14.3
13013,Barrow County,2021-03-22,244,11575,14.7
13013,Barrow County,2021-03-23,498,12073,15.3
13013,Barrow County,2021-03-24,400,12473,15.8
13013,Barrow County,2021-03-25,505,12978,16.4
13013,Barrow County,2021-03-26,376,13354,16.9
13013,Barrow County,2021-03-27,148,13502,17.1
13013,Barrow County,2021-03-28,74,13576,17.2
13013,Barrow County,2021-03-29,362,13938,17.6
13013,Barrow County,2021-03-30,458,14396,18.2
13013,Barrow County,2021-03-31,482,14878,18.8
13013,Barrow County,2021-04-01,387,15265,19.3
13013,Barrow County,2021-04-02,324,15589,19.7
13013,Barrow County,2021-04-03,162,15751,19.9
13013,Barrow County,2021-04-04,96,15847,20.1
13013,Barrow County,2021-04-05,308,16155,20.5
13013,Barrow County,2021-04-06,388,16543,20.9
13013,Barrow County,2021-04-07,377,16920,21.4
13013,Barrow County,2021-04-08,335,17255,21.8
13013,Barrow County,2021-04-09,359,17614,22.3
13013,Barrow County,2021-04-10,260,17874,22.6
13013,Barrow County,2021-04-11,111,17985,22.8
13013,Barrow County,2021-04-12,219,18204,23
13013,Barrow County,2021-04-13,287,18491,23.4
13013,Barrow County,2021-04-14,231,18722,23.7
13013,Barrow County,2021-04-15,203,18925,24
13013,Barrow County,2021-04-16,193,19118,24.2
13013,Barrow County,2021-04-17,108,19226,24.3
13013,Barrow County,2021-04-18,43,19269,24.4
13013,Barrow County,2021-04-19,129,19398,24.6
13013,Barrow County,2021-04-20,180,19578,24.8
13013,Barrow County,2021-04-21,240,19818,25.1
13013,Barrow County,2021-04-22,249,20067,25.4
13013,Barrow County,2021-04-23,189,20256,25.6
13013,Barrow County,2021-04-24,72,20328,25.7
13013,Barrow County,2021-04-25,48,20376,25.8
13013,Barrow County,2021-04-26,129,20505,26
13013,Barrow County,2021-04-27,205,20710,26.2
13013,Barrow County,2021-04-28,240,20950,26.5
13013,Barrow County,2021-04-29,207,21157,26.8
13013,Barrow County,2021-04-30,234,21391,27.1
13013,Barrow County,2021-05-01,80,21471,27.2
13013,Barrow County,2021-05-02,54,21525,27.2
13013,Barrow County,2021-05-03,108,21633,27.4
13013,Barrow County,2021-05-04,152,21785,27.6
13013,Barrow County,2021-05-05,160,21945,27.8
13013,Barrow County,2021-05-06,131,22076,27.9
13013,Barrow County,2021-05-07,159,22235,28.1
13013,Barrow County,2021-05-08,96,22331,28.3
13013,Barrow County,2021-05-09,41,22372,28.3
13013,Barrow County,2021-05-10,106,22478,28.5
13013,Barrow County,2021-05-11,126,22604,28.6
13013,Barrow County,2021-05-12,106,22710,28.8
13013,Barrow County,2021-05-13,106,22816,28.9
13013,Barrow County,2021-05-14,208,23024,29.1
13013,Barrow County,2021-05-15,134,23158,29.3
13013,Barrow County,2021-05-16,102,23260,29.4
13013,Barrow County,2021-05-17,164,23424,29.7
13013,Barrow County,2021-05-18,172,23596,29.9
13013,Barrow County,2021-05-19,185,23781,30.1
13013,Barrow County,2021-05-20,117,23898,30.3
13013,Barrow County,2021-05-21,165,24063,30.5
13013,Barrow County,2021-05-22,146,24209,30.6
13013,Barrow County,2021-05-23,55,24264,30.7
13013,Barrow County,2021-05-24,88,24352,30.8
13013,Barrow County,2021-05-25,111,24463,31
13013,Barrow County,2021-05-26,107,24570,31.1
13013,Barrow County,2021-05-27,69,24639,31.2
13013,Barrow County,2021-05-28,108,24747,31.3
13013,Barrow County,2021-05-29,59,24806,31.4
13013,Barrow County,2021-05-30,36,24842,31.4
13013,Barrow County,2021-05-31,16,24858,31.5
13013,Barrow County,2021-06-01,85,24943,31.6
13013,Barrow County,2021-06-02,98,25041,31.7
13013,Barrow County,2021-06-03,79,25120,31.8
13013,Barrow County,2021-06-04,114,25234,31.9
13013,Barrow County,2021-06-05,124,25358,32.1
13013,Barrow County,2021-06-06,31,25389,32.1
13013,Barrow County,2021-06-07,82,25471,32.2
13013,Barrow County,2021-06-08,58,25529,32.3
13013,Barrow County,2021-06-09,81,25610,32.4
13013,Barrow County,2021-06-10,58,25668,32.5
13013,Barrow County,2021-06-11,99,25767,32.6
13013,Barrow County,2021-06-12,50,25817,32.7
13013,Barrow County,2021-06-13,18,25835,32.7
13013,Barrow County,2021-06-14,41,25876,32.8
13013,Barrow County,2021-06-15,84,25960,32.9
13013,Barrow County,2021-06-16,62,26022,32.9
13013,Barrow County,2021-06-17,55,26077,33
13013,Barrow County,2021-06-18,79,26156,33.1
13013,Barrow County,2021-06-19,39,26195,33.2
13013,Barrow County,2021-06-20,17,26212,33.2
13013,Barrow County,2021-06-21,48,26260,33.2
13013,Barrow County,2021-06-22,57,26317,33.3
13013,Barrow County,2021-06-23,52,26369,33.4
13013,Barrow County,2021-06-24,71,26440,33.5
13013,Barrow County,2021-06-25,76,26516,33.6
13013,Barrow County,2021-06-26,59,26575,33.6
13013,Barrow County,2021-06-27,32,26607,33.7
13013,Barrow County,2021-06-28,65,26672,33.8
13013,Barrow County,2021-06-29,57,26729,33.8
13013,Barrow County,2021-06-30,75,26804,33.9
13013,Barrow County,2021-07-01,41,26845,34
13013,Barrow County,2021-07-02,70,26915,34.1
13013,Barrow County,2021-07-03,39,26954,34.1
13013,Barrow County,2021-07-04,5,26959,34.1
13013,Barrow County,2021-07-05,31,26990,34.2
13013,Barrow County,2021-07-06,30,27020,34.2
13013,Barrow County,2021-07-07,53,27073,34.3
13013,Barrow County,2021-07-08,45,27118,34.3
13013,Barrow County,2021-07-09,64,27182,34.4
13013,Barrow County,2021-07-10,35,27217,34.5
13013,Barrow County,2021-07-11,35,27252,34.5
13013,Barrow County,2021-07-12,52,27304,34.6
13013,Barrow County,2021-07-13,37,27341,34.6
13013,Barrow County,2021-07-14,48,27389,34.7
13013,Barrow County,2021-07-15,50,27439,34.7
13013,Barrow County,2021-07-16,84,27523,34.8
13013,Barrow County,2021-07-17,44,27567,34.9
13013,Barrow County,2021-07-18,39,27606,34.9
13013,Barrow County,2021-07-19,61,27667,35
13013,Barrow County,2021-07-20,51,27718,35.1
13013,Barrow County,2021-07-21,127,27845,35.3
13013,Barrow County,2021-07-22,73,27918,35.3
13013,Barrow County,2021-07-23,96,28014,35.5
13013,Barrow County,2021-07-24,73,28087,35.6
13013,Barrow County,2021-07-25,47,28134,35.6
13013,Barrow County,2021-07-26,85,28219,35.7
13013,Barrow County,2021-07-27,89,28308,35.8
13013,Barrow County,2021-07-28,146,28454,36
13013,Barrow County,2021-07-29,99,28553,36.1
13013,Barrow County,2021-07-30,149,28702,36.3
13013,Barrow County,2021-07-31,87,28789,36.4
13013,Barrow County,2021-08-01,52,28841,36.5
13013,Barrow County,2021-08-02,123,28964,36.7
13013,Barrow County,2021-08-03,89,29053,36.8
13013,Barrow County,2021-08-04,135,29188,37
13013,Barrow County,2021-08-05,129,29317,37.1
13013,Barrow County,2021-08-06,127,29444,37.3
13013,Barrow County,2021-08-07,109,29553,37.4
13013,Barrow County,2021-08-08,81,29634,37.5
13013,Barrow County,2021-08-09,122,29756,37.7
13013,Barrow County,2021-08-10,128,29884,37.8
13013,Barrow County,2021-08-11,108,29992,38
13013,Barrow County,2021-08-12,124,30116,38.1
13013,Barrow County,2021-08-13,145,30261,38.3
13013,Barrow County,2021-08-14,91,30352,38.4
13013,Barrow County,2021-08-15,55,30407,38.5
13013,Barrow County,2021-08-16,112,30519,38.6
13013,Barrow County,2021-08-17,121,30640,38.8
13013,Barrow County,2021-08-18,115,30755,38.9
13013,Barrow County,2021-08-19,118,30873,39.1
13013,Barrow County,2021-08-20,167,31040,39.3
13013,Barrow County,2021-08-21,101,31141,39.4
13013,Barrow County,2021-08-22,60,31201,39.5
13013,Barrow County,2021-08-23,113,31314,39.6
13013,Barrow County,2021-08-24,120,31434,39.8
13013,Barrow County,2021-08-25,109,31543,39.9
13013,Barrow County,2021-08-26,110,31653,40.1
13013,Barrow County,2021-08-27,163,31816,40.3
13013,Barrow County,2021-08-28,92,31908,40.4
13013,Barrow County,2021-08-29,67,31975,40.5
13013,Barrow County,2021-08-30,92,32067,40.6
13013,Barrow County,2021-08-31,102,32169,40.7
13013,Barrow County,2021-09-01,114,32283,40.9
13013,Barrow County,2021-09-02,121,32404,41
13013,Barrow County,2021-09-03,171,32575,41.2
13013,Barrow County,2021-09-04,83,32658,41.3
13013,Barrow County,2021-09-05,57,32715,41.4
13013,Barrow County,2021-09-06,16,32731,41.4
13013,Barrow County,2021-09-07,75,32806,41.5
13013,Barrow County,2021-09-08,90,32896,41.6
13013,Barrow County,2021-09-09,102,32998,41.8
13013,Barrow County,2021-09-10,122,33120,41.9
13013,Barrow County,2021-09-11,68,33188,42
13013,Barrow County,2021-09-12,36,33224,42.1
13013,Barrow County,2021-09-13,83,33307,42.2
13013,Barrow County,2021-09-14,69,33376,42.3
13013,Barrow County,2021-09-15,74,33450,42.3
13013,Barrow County,2021-09-16,75,33525,42.4
13013,Barrow County,2021-09-17,107,33632,42.6
13013,Barrow County,2021-09-18,53,33685,42.6
13013,Barrow County,2021-09-19,36,33721,42.7
13013,Barrow County,2021-09-20,44,33765,42.7
13013,Barrow County,2021-09-21,52,33817,42.8
13013,Barrow County,2021-09-22,57,33874,42.9
13013,Barrow County,2021-09-23,34,33908,42.9
13013,Barrow County,2021-09-24,52,33960,43
13013,Barrow County,2021-09-25,39,33999,43
13013,Barrow County,2021-09-26,18,34017,43.1
13013,Barrow County,2021-09-27,23,34040,43.1
13013,Barrow County,2021-09-28,25,34065,43.1
13013,Barrow County,2021-09-29,24,34089,43.2
13013,Barrow County,2021-09-30,24,34113,43.2
13013,Barrow County,2021-10-01,26,34139,43.2
13013,Barrow County,2021-10-02,15,34154,43.2
13013,Barrow County,2021-10-03,10,34164,43.3
13013,Barrow County,2021-10-04,24,34188,43.3
13013,Barrow County,2021-10-05,20,34208,43.3
13013,Barrow County,2021-10-06,18,34226,43.3
13013,Barrow County,2021-10-07,10,34236,43.3
13015,Bartow County,2020-12-14,1,1,0
13015,Bartow County,2020-12-15,1,2,0
13015,Bartow County,2020-12-17,4,6,0
13015,Bartow County,2020-12-18,23,29,0
13015,Bartow County,2020-12-19,3,32,0
13015,Bartow County,2020-12-20,7,39,0
13015,Bartow County,2020-12-21,37,76,0.1
13015,Bartow County,2020-12-22,44,120,0.1
13015,Bartow County,2020-12-23,55,175,0.2
13015,Bartow County,2020-12-24,11,186,0.2
13015,Bartow County,2020-12-26,3,189,0.2
13015,Bartow County,2020-12-27,18,207,0.2
13015,Bartow County,2020-12-28,258,465,0.4
13015,Bartow County,2020-12-29,134,599,0.6
13015,Bartow County,2020-12-30,168,767,0.7
13015,Bartow County,2020-12-31,59,826,0.8
13015,Bartow County,2021-01-01,17,843,0.8
13015,Bartow County,2021-01-02,18,861,0.8
13015,Bartow County,2021-01-03,11,872,0.8
13015,Bartow County,2021-01-04,100,972,0.9
13015,Bartow County,2021-01-05,135,1107,1.1
13015,Bartow County,2021-01-06,109,1216,1.2
13015,Bartow County,2021-01-07,177,1393,1.3
13015,Bartow County,2021-01-08,66,1459,1.4
13015,Bartow County,2021-01-09,12,1471,1.4
13015,Bartow County,2021-01-10,7,1478,1.4
13015,Bartow County,2021-01-11,244,1722,1.6
13015,Bartow County,2021-01-12,302,2024,1.9
13015,Bartow County,2021-01-13,400,2424,2.3
13015,Bartow County,2021-01-14,503,2927,2.8
13015,Bartow County,2021-01-15,229,3156,3
13015,Bartow County,2021-01-16,66,3222,3.1
13015,Bartow County,2021-01-17,42,3264,3.1
13015,Bartow County,2021-01-18,470,3734,3.6
13015,Bartow County,2021-01-19,547,4281,4.1
13015,Bartow County,2021-01-20,454,4735,4.5
13015,Bartow County,2021-01-21,372,5107,4.9
13015,Bartow County,2021-01-22,199,5306,5.1
13015,Bartow County,2021-01-23,46,5352,5.1
13015,Bartow County,2021-01-24,35,5387,5.1
13015,Bartow County,2021-01-25,398,5785,5.5
13015,Bartow County,2021-01-26,525,6310,6
13015,Bartow County,2021-01-27,494,6804,6.5
13015,Bartow County,2021-01-28,478,7282,6.9
13015,Bartow County,2021-01-29,144,7426,7.1
13015,Bartow County,2021-01-30,31,7457,7.1
13015,Bartow County,2021-01-31,1,7458,7.1
13015,Bartow County,2021-02-01,179,7637,7.3
13015,Bartow County,2021-02-02,123,7760,7.4
13015,Bartow County,2021-02-03,181,7941,7.6
13015,Bartow County,2021-02-04,281,8222,7.8
13015,Bartow County,2021-02-05,134,8356,8
13015,Bartow County,2021-02-06,17,8373,8
13015,Bartow County,2021-02-07,4,8377,8
13015,Bartow County,2021-02-08,86,8463,8.1
13015,Bartow County,2021-02-09,88,8551,8.2
13015,Bartow County,2021-02-10,66,8617,8.2
13015,Bartow County,2021-02-11,89,8706,8.3
13015,Bartow County,2021-02-12,93,8799,8.4
13015,Bartow County,2021-02-13,98,8897,8.5
13015,Bartow County,2021-02-14,18,8915,8.5
13015,Bartow County,2021-02-15,157,9072,8.6
13015,Bartow County,2021-02-16,94,9166,8.7
13015,Bartow County,2021-02-17,80,9246,8.8
13015,Bartow County,2021-02-18,78,9324,8.9
13015,Bartow County,2021-02-19,64,9388,8.9
13015,Bartow County,2021-02-20,19,9407,9
13015,Bartow County,2021-02-21,7,9414,9
13015,Bartow County,2021-02-22,22,9436,9
13015,Bartow County,2021-02-23,85,9521,9.1
13015,Bartow County,2021-02-24,194,9715,9.3
13015,Bartow County,2021-02-25,120,9835,9.4
13015,Bartow County,2021-02-26,158,9993,9.5
13015,Bartow County,2021-02-27,67,10060,9.6
13015,Bartow County,2021-02-28,61,10121,9.6
13015,Bartow County,2021-03-01,162,10283,9.8
13015,Bartow County,2021-03-02,176,10459,10
13015,Bartow County,2021-03-03,328,10787,10.3
13015,Bartow County,2021-03-04,326,11113,10.6
13015,Bartow County,2021-03-05,254,11367,10.8
13015,Bartow County,2021-03-06,82,11449,10.9
13015,Bartow County,2021-03-07,55,11504,11
13015,Bartow County,2021-03-08,445,11949,11.4
13015,Bartow County,2021-03-09,411,12360,11.8
13015,Bartow County,2021-03-10,330,12690,12.1
13015,Bartow County,2021-03-11,314,13004,12.4
13015,Bartow County,2021-03-12,433,13437,12.8
13015,Bartow County,2021-03-13,92,13529,12.9
13015,Bartow County,2021-03-14,44,13573,12.9
13015,Bartow County,2021-03-15,531,14104,13.4
13015,Bartow County,2021-03-16,610,14714,14
13015,Bartow County,2021-03-17,524,15238,14.5
13015,Bartow County,2021-03-18,398,15636,14.9
13015,Bartow County,2021-03-19,505,16141,15.4
13015,Bartow County,2021-03-20,57,16198,15.4
13015,Bartow County,2021-03-21,94,16292,15.5
13015,Bartow County,2021-03-22,396,16688,15.9
13015,Bartow County,2021-03-23,529,17217,16.4
13015,Bartow County,2021-03-24,480,17697,16.9
13015,Bartow County,2021-03-25,419,18116,17.3
13015,Bartow County,2021-03-26,473,18589,17.7
13015,Bartow County,2021-03-27,226,18815,17.9
13015,Bartow County,2021-03-28,75,18890,18
13015,Bartow County,2021-03-29,364,19254,18.4
13015,Bartow County,2021-03-30,468,19722,18.8
13015,Bartow County,2021-03-31,519,20241,19.3
13015,Bartow County,2021-04-01,495,20736,19.8
13015,Bartow County,2021-04-02,316,21052,20.1
13015,Bartow County,2021-04-03,165,21217,20.2
13015,Bartow County,2021-04-04,89,21306,20.3
13015,Bartow County,2021-04-05,354,21660,20.6
13015,Bartow County,2021-04-06,403,22063,21
13015,Bartow County,2021-04-07,375,22438,21.4
13015,Bartow County,2021-04-08,406,22844,21.8
13015,Bartow County,2021-04-09,345,23189,22.1
13015,Bartow County,2021-04-10,312,23501,22.4
13015,Bartow County,2021-04-11,88,23589,22.5
13015,Bartow County,2021-04-12,279,23868,22.7
13015,Bartow County,2021-04-13,317,24185,23.1
13015,Bartow County,2021-04-14,287,24472,23.3
13015,Bartow County,2021-04-15,379,24851,23.7
13015,Bartow County,2021-04-16,294,25145,24
13015,Bartow County,2021-04-17,75,25220,24
13015,Bartow County,2021-04-18,29,25249,24.1
13015,Bartow County,2021-04-19,210,25459,24.3
13015,Bartow County,2021-04-20,248,25707,24.5
13015,Bartow County,2021-04-21,200,25907,24.7
13015,Bartow County,2021-04-22,253,26160,24.9
13015,Bartow County,2021-04-23,258,26418,25.2
13015,Bartow County,2021-04-24,69,26487,25.2
13015,Bartow County,2021-04-25,38,26525,25.3
13015,Bartow County,2021-04-26,151,26676,25.4
13015,Bartow County,2021-04-27,137,26813,25.6
13015,Bartow County,2021-04-28,187,27000,25.7
13015,Bartow County,2021-04-29,160,27160,25.9
13015,Bartow County,2021-04-30,206,27366,26.1
13015,Bartow County,2021-05-01,69,27435,26.1
13015,Bartow County,2021-05-02,50,27485,26.2
13015,Bartow County,2021-05-03,121,27606,26.3
13015,Bartow County,2021-05-04,171,27777,26.5
13015,Bartow County,2021-05-05,124,27901,26.6
13015,Bartow County,2021-05-06,143,28044,26.7
13015,Bartow County,2021-05-07,159,28203,26.9
13015,Bartow County,2021-05-08,114,28317,27
13015,Bartow County,2021-05-09,30,28347,27
13015,Bartow County,2021-05-10,86,28433,27.1
13015,Bartow County,2021-05-11,109,28542,27.2
13015,Bartow County,2021-05-12,97,28639,27.3
13015,Bartow County,2021-05-13,160,28799,27.4
13015,Bartow County,2021-05-14,179,28978,27.6
13015,Bartow County,2021-05-15,125,29103,27.7
13015,Bartow County,2021-05-16,75,29178,27.8
13015,Bartow County,2021-05-17,135,29313,27.9
13015,Bartow County,2021-05-18,137,29450,28.1
13015,Bartow County,2021-05-19,149,29599,28.2
13015,Bartow County,2021-05-20,118,29717,28.3
13015,Bartow County,2021-05-21,153,29870,28.5
13015,Bartow County,2021-05-22,94,29964,28.6
13015,Bartow County,2021-05-23,50,30014,28.6
13015,Bartow County,2021-05-24,95,30109,28.7
13015,Bartow County,2021-05-25,96,30205,28.8
13015,Bartow County,2021-05-26,93,30298,28.9
13015,Bartow County,2021-05-27,91,30389,29
13015,Bartow County,2021-05-28,89,30478,29
13015,Bartow County,2021-05-29,32,30510,29.1
13015,Bartow County,2021-05-30,24,30534,29.1
13015,Bartow County,2021-05-31,15,30549,29.1
13015,Bartow County,2021-06-01,97,30646,29.2
13015,Bartow County,2021-06-02,89,30735,29.3
13015,Bartow County,2021-06-03,64,30799,29.4
13015,Bartow County,2021-06-04,86,30885,29.4
13015,Bartow County,2021-06-05,37,30922,29.5
13015,Bartow County,2021-06-06,35,30957,29.5
13015,Bartow County,2021-06-07,65,31022,29.6
13015,Bartow County,2021-06-08,84,31106,29.6
13015,Bartow County,2021-06-09,48,31154,29.7
13015,Bartow County,2021-06-10,76,31230,29.8
13015,Bartow County,2021-06-11,91,31321,29.9
13015,Bartow County,2021-06-12,48,31369,29.9
13015,Bartow County,2021-06-13,17,31386,29.9
13015,Bartow County,2021-06-14,34,31420,29.9
13015,Bartow County,2021-06-15,54,31474,30
13015,Bartow County,2021-06-16,42,31516,30
13015,Bartow County,2021-06-17,46,31562,30.1
13015,Bartow County,2021-06-18,48,31610,30.1
13015,Bartow County,2021-06-19,37,31647,30.2
13015,Bartow County,2021-06-20,17,31664,30.2
13015,Bartow County,2021-06-21,55,31719,30.2
13015,Bartow County,2021-06-22,45,31764,30.3
13015,Bartow County,2021-06-23,64,31828,30.3
13015,Bartow County,2021-06-24,58,31886,30.4
13015,Bartow County,2021-06-25,61,31947,30.4
13015,Bartow County,2021-06-26,33,31980,30.5
13015,Bartow County,2021-06-27,19,31999,30.5
13015,Bartow County,2021-06-28,38,32037,30.5
13015,Bartow County,2021-06-29,73,32110,30.6
13015,Bartow County,2021-06-30,31,32141,30.6
13015,Bartow County,2021-07-01,52,32193,30.7
13015,Bartow County,2021-07-02,76,32269,30.8
13015,Bartow County,2021-07-03,28,32297,30.8
13015,Bartow County,2021-07-04,2,32299,30.8
13015,Bartow County,2021-07-05,35,32334,30.8
13015,Bartow County,2021-07-06,38,32372,30.9
13015,Bartow County,2021-07-07,38,32410,30.9
13015,Bartow County,2021-07-08,50,32460,30.9
13015,Bartow County,2021-07-09,65,32525,31
13015,Bartow County,2021-07-10,49,32574,31
13015,Bartow County,2021-07-11,15,32589,31.1
13015,Bartow County,2021-07-12,41,32630,31.1
13015,Bartow County,2021-07-13,57,32687,31.2
13015,Bartow County,2021-07-14,39,32726,31.2
13015,Bartow County,2021-07-15,65,32791,31.3
13015,Bartow County,2021-07-16,96,32887,31.3
13015,Bartow County,2021-07-17,45,32932,31.4
13015,Bartow County,2021-07-18,36,32968,31.4
13015,Bartow County,2021-07-19,66,33034,31.5
13015,Bartow County,2021-07-20,110,33144,31.6
13015,Bartow County,2021-07-21,76,33220,31.7
13015,Bartow County,2021-07-22,103,33323,31.8
13015,Bartow County,2021-07-23,106,33429,31.9
13015,Bartow County,2021-07-24,70,33499,31.9
13015,Bartow County,2021-07-25,59,33558,32
13015,Bartow County,2021-07-26,97,33655,32.1
13015,Bartow County,2021-07-27,117,33772,32.2
13015,Bartow County,2021-07-28,139,33911,32.3
13015,Bartow County,2021-07-29,121,34032,32.4
13015,Bartow County,2021-07-30,168,34200,32.6
13015,Bartow County,2021-07-31,116,34316,32.7
13015,Bartow County,2021-08-01,88,34404,32.8
13015,Bartow County,2021-08-02,140,34544,32.9
13015,Bartow County,2021-08-03,177,34721,33.1
13015,Bartow County,2021-08-04,169,34890,33.3
13015,Bartow County,2021-08-05,177,35067,33.4
13015,Bartow County,2021-08-06,185,35252,33.6
13015,Bartow County,2021-08-07,125,35377,33.7
13015,Bartow County,2021-08-08,80,35457,33.8
13015,Bartow County,2021-08-09,135,35592,33.9
13015,Bartow County,2021-08-10,177,35769,34.1
13015,Bartow County,2021-08-11,149,35918,34.2
13015,Bartow County,2021-08-12,198,36116,34.4
13015,Bartow County,2021-08-13,238,36354,34.6
13015,Bartow County,2021-08-14,131,36485,34.8
13015,Bartow County,2021-08-15,84,36569,34.9
13015,Bartow County,2021-08-16,130,36699,35
13015,Bartow County,2021-08-17,160,36859,35.1
13015,Bartow County,2021-08-18,171,37030,35.3
13015,Bartow County,2021-08-19,266,37296,35.5
13015,Bartow County,2021-08-20,272,37568,35.8
13015,Bartow County,2021-08-21,124,37692,35.9
13015,Bartow County,2021-08-22,93,37785,36
13015,Bartow County,2021-08-23,188,37973,36.2
13015,Bartow County,2021-08-24,186,38159,36.4
13015,Bartow County,2021-08-25,191,38350,36.6
13015,Bartow County,2021-08-26,159,38509,36.7
13015,Bartow County,2021-08-27,234,38743,36.9
13015,Bartow County,2021-08-28,107,38850,37
13015,Bartow County,2021-08-29,102,38952,37.1
13015,Bartow County,2021-08-30,159,39111,37.3
13015,Bartow County,2021-08-31,191,39302,37.5
13015,Bartow County,2021-09-01,182,39484,37.6
13015,Bartow County,2021-09-02,221,39705,37.8
13015,Bartow County,2021-09-03,209,39914,38
13015,Bartow County,2021-09-04,120,40034,38.2
13015,Bartow County,2021-09-05,76,40110,38.2
13015,Bartow County,2021-09-06,31,40141,38.3
13015,Bartow County,2021-09-07,118,40259,38.4
13015,Bartow County,2021-09-08,130,40389,38.5
13015,Bartow County,2021-09-09,128,40517,38.6
13015,Bartow County,2021-09-10,172,40689,38.8
13015,Bartow County,2021-09-11,87,40776,38.9
13015,Bartow County,2021-09-12,60,40836,38.9
13015,Bartow County,2021-09-13,93,40929,39
13015,Bartow County,2021-09-14,110,41039,39.1
13015,Bartow County,2021-09-15,89,41128,39.2
13015,Bartow County,2021-09-16,98,41226,39.3
13015,Bartow County,2021-09-17,125,41351,39.4
13015,Bartow County,2021-09-18,78,41429,39.5
13015,Bartow County,2021-09-19,44,41473,39.5
13015,Bartow County,2021-09-20,86,41559,39.6
13015,Bartow County,2021-09-21,66,41625,39.7
13015,Bartow County,2021-09-22,78,41703,39.7
13015,Bartow County,2021-09-23,77,41780,39.8
13015,Bartow County,2021-09-24,70,41850,39.9
13015,Bartow County,2021-09-25,30,41880,39.9
13015,Bartow County,2021-09-26,16,41896,39.9
13015,Bartow County,2021-09-27,30,41926,40
13015,Bartow County,2021-09-28,57,41983,40
13015,Bartow County,2021-09-29,59,42042,40.1
13015,Bartow County,2021-09-30,34,42076,40.1
13015,Bartow County,2021-10-01,52,42128,40.2
13015,Bartow County,2021-10-02,24,42152,40.2
13015,Bartow County,2021-10-03,15,42167,40.2
13015,Bartow County,2021-10-04,17,42184,40.2
13015,Bartow County,2021-10-05,40,42224,40.2
13015,Bartow County,2021-10-06,22,42246,40.3
13015,Bartow County,2021-10-07,13,42259,40.3
13017,Ben Hill County,2020-12-18,2,2,0
13017,Ben Hill County,2020-12-22,3,5,0
13017,Ben Hill County,2020-12-23,13,18,0.1
13017,Ben Hill County,2020-12-24,11,29,0.2
13017,Ben Hill County,2020-12-27,5,34,0.2
13017,Ben Hill County,2020-12-28,13,47,0.3
13017,Ben Hill County,2020-12-29,59,106,0.6
13017,Ben Hill County,2020-12-30,24,130,0.8
13017,Ben Hill County,2020-12-31,17,147,0.9
13017,Ben Hill County,2021-01-01,1,148,0.9
13017,Ben Hill County,2021-01-03,2,150,0.9
13017,Ben Hill County,2021-01-04,55,205,1.2
13017,Ben Hill County,2021-01-05,25,230,1.4
13017,Ben Hill County,2021-01-06,29,259,1.5
13017,Ben Hill County,2021-01-07,46,305,1.8
13017,Ben Hill County,2021-01-08,27,332,1.9
13017,Ben Hill County,2021-01-09,3,335,2
13017,Ben Hill County,2021-01-10,3,338,2
13017,Ben Hill County,2021-01-11,67,405,2.4
13017,Ben Hill County,2021-01-12,88,493,2.9
13017,Ben Hill County,2021-01-13,64,557,3.3
13017,Ben Hill County,2021-01-14,120,677,4
13017,Ben Hill County,2021-01-15,131,808,4.7
13017,Ben Hill County,2021-01-16,10,818,4.8
13017,Ben Hill County,2021-01-17,11,829,4.9
13017,Ben Hill County,2021-01-18,112,941,5.5
13017,Ben Hill County,2021-01-19,86,1027,6
13017,Ben Hill County,2021-01-20,83,1110,6.5
13017,Ben Hill County,2021-01-21,113,1223,7.2
13017,Ben Hill County,2021-01-22,57,1280,7.5
13017,Ben Hill County,2021-01-23,1,1281,7.5
13017,Ben Hill County,2021-01-24,7,1288,7.6
13017,Ben Hill County,2021-01-25,35,1323,7.8
13017,Ben Hill County,2021-01-26,46,1369,8
13017,Ben Hill County,2021-01-27,54,1423,8.4
13017,Ben Hill County,2021-01-28,53,1476,8.7
13017,Ben Hill County,2021-01-29,20,1496,8.8
13017,Ben Hill County,2021-01-31,1,1497,8.8
13017,Ben Hill County,2021-02-01,23,1520,8.9
13017,Ben Hill County,2021-02-02,25,1545,9.1
13017,Ben Hill County,2021-02-03,39,1584,9.3
13017,Ben Hill County,2021-02-04,29,1613,9.5
13017,Ben Hill County,2021-02-05,17,1630,9.6
13017,Ben Hill County,2021-02-07,2,1632,9.6
13017,Ben Hill County,2021-02-08,22,1654,9.7
13017,Ben Hill County,2021-02-09,50,1704,10
13017,Ben Hill County,2021-02-10,48,1752,10.3
13017,Ben Hill County,2021-02-11,30,1782,10.5
13017,Ben Hill County,2021-02-12,52,1834,10.8
13017,Ben Hill County,2021-02-13,11,1845,10.8
13017,Ben Hill County,2021-02-14,5,1850,10.9
13017,Ben Hill County,2021-02-15,83,1933,11.3
13017,Ben Hill County,2021-02-16,38,1971,11.6
13017,Ben Hill County,2021-02-17,37,2008,11.8
13017,Ben Hill County,2021-02-18,46,2054,12.1
13017,Ben Hill County,2021-02-19,20,2074,12.2
13017,Ben Hill County,2021-02-20,2,2076,12.2
13017,Ben Hill County,2021-02-22,19,2095,12.3
13017,Ben Hill County,2021-02-23,15,2110,12.4
13017,Ben Hill County,2021-02-24,19,2129,12.5
13017,Ben Hill County,2021-02-25,37,2166,12.7
13017,Ben Hill County,2021-02-26,20,2186,12.8
13017,Ben Hill County,2021-02-27,6,2192,12.9
13017,Ben Hill County,2021-02-28,1,2193,12.9
13017,Ben Hill County,2021-03-01,10,2203,12.9
13017,Ben Hill County,2021-03-02,40,2243,13.2
13017,Ben Hill County,2021-03-03,38,2281,13.4
13017,Ben Hill County,2021-03-04,59,2340,13.7
13017,Ben Hill County,2021-03-05,52,2392,14
13017,Ben Hill County,2021-03-06,2,2394,14.1
13017,Ben Hill County,2021-03-08,52,2446,14.4
13017,Ben Hill County,2021-03-09,51,2497,14.7
13017,Ben Hill County,2021-03-10,56,2553,15
13017,Ben Hill County,2021-03-11,61,2614,15.3
13017,Ben Hill County,2021-03-12,70,2684,15.8
13017,Ben Hill County,2021-03-13,2,2686,15.8
13017,Ben Hill County,2021-03-14,1,2687,15.8
13017,Ben Hill County,2021-03-15,50,2737,16.1
13017,Ben Hill County,2021-03-16,72,2809,16.5
13017,Ben Hill County,2021-03-17,70,2879,16.9
13017,Ben Hill County,2021-03-18,86,2965,17.4
13017,Ben Hill County,2021-03-19,89,3054,17.9
13017,Ben Hill County,2021-03-20,2,3056,17.9
13017,Ben Hill County,2021-03-21,1,3057,17.9
13017,Ben Hill County,2021-03-22,45,3102,18.2
13017,Ben Hill County,2021-03-23,151,3253,19.1
13017,Ben Hill County,2021-03-24,87,3340,19.6
13017,Ben Hill County,2021-03-25,67,3407,20
13017,Ben Hill County,2021-03-26,123,3530,20.7
13017,Ben Hill County,2021-03-27,2,3532,20.7
13017,Ben Hill County,2021-03-29,62,3594,21.1
13017,Ben Hill County,2021-03-30,55,3649,21.4
13017,Ben Hill County,2021-03-31,41,3690,21.7
13017,Ben Hill County,2021-04-01,38,3728,21.9
13017,Ben Hill County,2021-04-02,68,3796,22.3
13017,Ben Hill County,2021-04-03,2,3798,22.3
13017,Ben Hill County,2021-04-05,48,3846,22.6
13017,Ben Hill County,2021-04-06,36,3882,22.8
13017,Ben Hill County,2021-04-07,42,3924,23
13017,Ben Hill County,2021-04-08,43,3967,23.3
13017,Ben Hill County,2021-04-09,40,4007,23.5
13017,Ben Hill County,2021-04-10,7,4014,23.6
13017,Ben Hill County,2021-04-11,6,4020,23.6
13017,Ben Hill County,2021-04-12,44,4064,23.9
13017,Ben Hill County,2021-04-13,20,4084,24
13017,Ben Hill County,2021-04-14,15,4099,24.1
13017,Ben Hill County,2021-04-15,33,4132,24.3
13017,Ben Hill County,2021-04-16,32,4164,24.4
13017,Ben Hill County,2021-04-17,32,4196,24.6
13017,Ben Hill County,2021-04-18,1,4197,24.6
13017,Ben Hill County,2021-04-19,51,4248,24.9
13017,Ben Hill County,2021-04-20,30,4278,25.1
13017,Ben Hill County,2021-04-21,27,4305,25.3
13017,Ben Hill County,2021-04-22,21,4326,25.4
13017,Ben Hill County,2021-04-23,21,4347,25.5
13017,Ben Hill County,2021-04-24,4,4351,25.5
13017,Ben Hill County,2021-04-26,5,4356,25.6
13017,Ben Hill County,2021-04-27,18,4374,25.7
13017,Ben Hill County,2021-04-28,18,4392,25.8
13017,Ben Hill County,2021-04-29,11,4403,25.8
13017,Ben Hill County,2021-04-30,16,4419,25.9
13017,Ben Hill County,2021-05-01,2,4421,26
13017,Ben Hill County,2021-05-02,3,4424,26
13017,Ben Hill County,2021-05-03,16,4440,26.1
13017,Ben Hill County,2021-05-04,23,4463,26.2
13017,Ben Hill County,2021-05-05,27,4490,26.4
13017,Ben Hill County,2021-05-06,15,4505,26.4
13017,Ben Hill County,2021-05-07,15,4520,26.5
13017,Ben Hill County,2021-05-08,12,4532,26.6
13017,Ben Hill County,2021-05-09,3,4535,26.6
13017,Ben Hill County,2021-05-10,16,4551,26.7
13017,Ben Hill County,2021-05-11,15,4566,26.8
13017,Ben Hill County,2021-05-12,19,4585,26.9
13017,Ben Hill County,2021-05-13,13,4598,27
13017,Ben Hill County,2021-05-14,16,4614,27.1
13017,Ben Hill County,2021-05-15,3,4617,27.1
13017,Ben Hill County,2021-05-16,8,4625,27.2
13017,Ben Hill County,2021-05-17,24,4649,27.3
13017,Ben Hill County,2021-05-18,48,4697,27.6
13017,Ben Hill County,2021-05-19,27,4724,27.7
13017,Ben Hill County,2021-05-20,10,4734,27.8
13017,Ben Hill County,2021-05-21,37,4771,28
13017,Ben Hill County,2021-05-22,10,4781,28.1
13017,Ben Hill County,2021-05-23,2,4783,28.1
13017,Ben Hill County,2021-05-24,8,4791,28.1
13017,Ben Hill County,2021-05-25,5,4796,28.2
13017,Ben Hill County,2021-05-26,10,4806,28.2
13017,Ben Hill County,2021-05-27,16,4822,28.3
13017,Ben Hill County,2021-05-28,11,4833,28.4
13017,Ben Hill County,2021-05-29,3,4836,28.4
13017,Ben Hill County,2021-05-30,2,4838,28.4
13017,Ben Hill County,2021-05-31,2,4840,28.4
13017,Ben Hill County,2021-06-01,7,4847,28.5
13017,Ben Hill County,2021-06-02,12,4859,28.5
13017,Ben Hill County,2021-06-03,10,4869,28.6
13017,Ben Hill County,2021-06-04,5,4874,28.6
13017,Ben Hill County,2021-06-05,2,4876,28.6
13017,Ben Hill County,2021-06-06,2,4878,28.6
13017,Ben Hill County,2021-06-07,9,4887,28.7
13017,Ben Hill County,2021-06-08,11,4898,28.8
13017,Ben Hill County,2021-06-09,6,4904,28.8
13017,Ben Hill County,2021-06-10,5,4909,28.8
13017,Ben Hill County,2021-06-11,11,4920,28.9
13017,Ben Hill County,2021-06-12,2,4922,28.9
13017,Ben Hill County,2021-06-14,12,4934,29
13017,Ben Hill County,2021-06-15,11,4945,29
13017,Ben Hill County,2021-06-16,11,4956,29.1
13017,Ben Hill County,2021-06-17,4,4960,29.1
13017,Ben Hill County,2021-06-18,17,4977,29.2
13017,Ben Hill County,2021-06-19,6,4983,29.3
13017,Ben Hill County,2021-06-20,1,4984,29.3
13017,Ben Hill County,2021-06-21,6,4990,29.3
13017,Ben Hill County,2021-06-22,16,5006,29.4
13017,Ben Hill County,2021-06-23,7,5013,29.4
13017,Ben Hill County,2021-06-24,13,5026,29.5
13017,Ben Hill County,2021-06-25,11,5037,29.6
13017,Ben Hill County,2021-06-26,10,5047,29.6
13017,Ben Hill County,2021-06-28,10,5057,29.7
13017,Ben Hill County,2021-06-29,6,5063,29.7
13017,Ben Hill County,2021-06-30,5,5068,29.8
13017,Ben Hill County,2021-07-01,3,5071,29.8
13017,Ben Hill County,2021-07-02,10,5081,29.8
13017,Ben Hill County,2021-07-03,4,5085,29.9
13017,Ben Hill County,2021-07-05,3,5088,29.9
13017,Ben Hill County,2021-07-06,12,5100,29.9
13017,Ben Hill County,2021-07-07,9,5109,30
13017,Ben Hill County,2021-07-08,5,5114,30
13017,Ben Hill County,2021-07-09,9,5123,30.1
13017,Ben Hill County,2021-07-10,4,5127,30.1
13017,Ben Hill County,2021-07-12,5,5132,30.1
13017,Ben Hill County,2021-07-13,16,5148,30.2
13017,Ben Hill County,2021-07-14,7,5155,30.3
13017,Ben Hill County,2021-07-15,24,5179,30.4
13017,Ben Hill County,2021-07-16,12,5191,30.5
13017,Ben Hill County,2021-07-17,2,5193,30.5
13017,Ben Hill County,2021-07-18,1,5194,30.5
13017,Ben Hill County,2021-07-19,25,5219,30.6
13017,Ben Hill County,2021-07-20,31,5250,30.8
13017,Ben Hill County,2021-07-21,33,5283,31
13017,Ben Hill County,2021-07-22,30,5313,31.2
13017,Ben Hill County,2021-07-23,46,5359,31.5
13017,Ben Hill County,2021-07-24,19,5378,31.6
13017,Ben Hill County,2021-07-25,5,5383,31.6
13017,Ben Hill County,2021-07-26,42,5425,31.8
13017,Ben Hill County,2021-07-27,18,5443,32
13017,Ben Hill County,2021-07-28,26,5469,32.1
13017,Ben Hill County,2021-07-29,10,5479,32.2
13017,Ben Hill County,2021-07-30,40,5519,32.4
13017,Ben Hill County,2021-07-31,11,5530,32.5
13017,Ben Hill County,2021-08-01,5,5535,32.5
13017,Ben Hill County,2021-08-02,55,5590,32.8
13017,Ben Hill County,2021-08-03,41,5631,33.1
13017,Ben Hill County,2021-08-04,38,5669,33.3
13017,Ben Hill County,2021-08-05,38,5707,33.5
13017,Ben Hill County,2021-08-06,70,5777,33.9
13017,Ben Hill County,2021-08-07,20,5797,34
13017,Ben Hill County,2021-08-08,11,5808,34.1
13017,Ben Hill County,2021-08-09,42,5850,34.3
13017,Ben Hill County,2021-08-10,43,5893,34.6
13017,Ben Hill County,2021-08-11,47,5940,34.9
13017,Ben Hill County,2021-08-12,28,5968,35
13017,Ben Hill County,2021-08-13,85,6053,35.5
13017,Ben Hill County,2021-08-14,25,6078,35.7
13017,Ben Hill County,2021-08-15,11,6089,35.7
13017,Ben Hill County,2021-08-16,53,6142,36.1
13017,Ben Hill County,2021-08-17,54,6196,36.4
13017,Ben Hill County,2021-08-18,38,6234,36.6
13017,Ben Hill County,2021-08-19,22,6256,36.7
13017,Ben Hill County,2021-08-20,58,6314,37.1
13017,Ben Hill County,2021-08-21,22,6336,37.2
13017,Ben Hill County,2021-08-22,11,6347,37.3
13017,Ben Hill County,2021-08-23,30,6377,37.4
13017,Ben Hill County,2021-08-24,23,6400,37.6
13017,Ben Hill County,2021-08-25,26,6426,37.7
13017,Ben Hill County,2021-08-26,18,6444,37.8
13017,Ben Hill County,2021-08-27,31,6475,38
13017,Ben Hill County,2021-08-28,15,6490,38.1
13017,Ben Hill County,2021-08-29,9,6499,38.2
13017,Ben Hill County,2021-08-30,31,6530,38.3
13017,Ben Hill County,2021-08-31,27,6557,38.5
13017,Ben Hill County,2021-09-01,21,6578,38.6
13017,Ben Hill County,2021-09-02,29,6607,38.8
13017,Ben Hill County,2021-09-03,20,6627,38.9
13017,Ben Hill County,2021-09-04,9,6636,39
13017,Ben Hill County,2021-09-05,9,6645,39
13017,Ben Hill County,2021-09-06,9,6654,39.1
13017,Ben Hill County,2021-09-07,10,6664,39.1
13017,Ben Hill County,2021-09-08,12,6676,39.2
13017,Ben Hill County,2021-09-09,22,6698,39.3
13017,Ben Hill County,2021-09-10,19,6717,39.4
13017,Ben Hill County,2021-09-11,11,6728,39.5
13017,Ben Hill County,2021-09-12,10,6738,39.6
13017,Ben Hill County,2021-09-13,12,6750,39.6
13017,Ben Hill County,2021-09-14,14,6764,39.7
13017,Ben Hill County,2021-09-15,15,6779,39.8
13017,Ben Hill County,2021-09-16,16,6795,39.9
13017,Ben Hill County,2021-09-17,25,6820,40
13017,Ben Hill County,2021-09-18,5,6825,40.1
13017,Ben Hill County,2021-09-19,6,6831,40.1
13017,Ben Hill County,2021-09-20,12,6843,40.2
13017,Ben Hill County,2021-09-21,9,6852,40.2
13017,Ben Hill County,2021-09-22,6,6858,40.3
13017,Ben Hill County,2021-09-23,10,6868,40.3
13017,Ben Hill County,2021-09-24,6,6874,40.4
13017,Ben Hill County,2021-09-25,3,6877,40.4
13017,Ben Hill County,2021-09-26,1,6878,40.4
13017,Ben Hill County,2021-09-27,7,6885,40.4
13017,Ben Hill County,2021-09-28,5,6890,40.5
13017,Ben Hill County,2021-09-29,4,6894,40.5
13017,Ben Hill County,2021-09-30,5,6899,40.5
13017,Ben Hill County,2021-10-01,9,6908,40.6
13017,Ben Hill County,2021-10-02,1,6909,40.6
13017,Ben Hill County,2021-10-03,1,6910,40.6
13017,Ben Hill County,2021-10-04,3,6913,40.6
13017,Ben Hill County,2021-10-05,4,6917,40.6
13017,Ben Hill County,2021-10-06,2,6919,40.6
13017,Ben Hill County,2021-10-07,2,6921,40.6
13019,Berrien County,2020-12-18,1,1,0
13019,Berrien County,2020-12-21,9,10,0.1
13019,Berrien County,2020-12-22,16,26,0.1
13019,Berrien County,2020-12-23,27,53,0.3
13019,Berrien County,2020-12-24,5,58,0.3
13019,Berrien County,2020-12-26,2,60,0.3
13019,Berrien County,2020-12-28,19,79,0.4
13019,Berrien County,2020-12-29,37,116,0.6
13019,Berrien County,2020-12-30,42,158,0.8
13019,Berrien County,2020-12-31,14,172,0.9
13019,Berrien County,2021-01-01,2,174,0.9
13019,Berrien County,2021-01-03,48,222,1.2
13019,Berrien County,2021-01-04,47,269,1.4
13019,Berrien County,2021-01-05,36,305,1.6
13019,Berrien County,2021-01-06,30,335,1.7
13019,Berrien County,2021-01-07,16,351,1.8
13019,Berrien County,2021-01-08,15,366,1.9
13019,Berrien County,2021-01-09,1,367,1.9
13019,Berrien County,2021-01-11,56,423,2.2
13019,Berrien County,2021-01-12,53,476,2.5
13019,Berrien County,2021-01-13,82,558,2.9
13019,Berrien County,2021-01-14,65,623,3.3
13019,Berrien County,2021-01-15,73,696,3.6
13019,Berrien County,2021-01-16,2,698,3.6
13019,Berrien County,2021-01-18,75,773,4
13019,Berrien County,2021-01-19,80,853,4.5
13019,Berrien County,2021-01-20,100,953,5
13019,Berrien County,2021-01-21,74,1027,5.4
13019,Berrien County,2021-01-22,74,1101,5.7
13019,Berrien County,2021-01-24,11,1112,5.8
13019,Berrien County,2021-01-25,59,1171,6.1
13019,Berrien County,2021-01-26,40,1211,6.3
13019,Berrien County,2021-01-27,108,1319,6.9
13019,Berrien County,2021-01-28,46,1365,7.1
13019,Berrien County,2021-01-29,41,1406,7.3
13019,Berrien County,2021-01-30,66,1472,7.7
13019,Berrien County,2021-01-31,1,1473,7.7
13019,Berrien County,2021-02-01,80,1553,8.1
13019,Berrien County,2021-02-02,65,1618,8.4
13019,Berrien County,2021-02-03,102,1720,9
13019,Berrien County,2021-02-04,40,1760,9.2
13019,Berrien County,2021-02-05,59,1819,9.5
13019,Berrien County,2021-02-06,1,1820,9.5
13019,Berrien County,2021-02-08,14,1834,9.6
13019,Berrien County,2021-02-09,23,1857,9.7
13019,Berrien County,2021-02-10,30,1887,9.9
13019,Berrien County,2021-02-11,11,1898,9.9
13019,Berrien County,2021-02-12,59,1957,10.2
13019,Berrien County,2021-02-13,7,1964,10.3
13019,Berrien County,2021-02-14,3,1967,10.3
13019,Berrien County,2021-02-15,29,1996,10.4
13019,Berrien County,2021-02-16,13,2009,10.5
13019,Berrien County,2021-02-17,50,2059,10.8
13019,Berrien County,2021-02-18,26,2085,10.9
13019,Berrien County,2021-02-19,21,2106,11
13019,Berrien County,2021-02-20,1,2107,11
13019,Berrien County,2021-02-22,49,2156,11.3
13019,Berrien County,2021-02-23,50,2206,11.5
13019,Berrien County,2021-02-24,50,2256,11.8
13019,Berrien County,2021-02-25,29,2285,11.9
13019,Berrien County,2021-02-26,30,2315,12.1
13019,Berrien County,2021-02-27,4,2319,12.1
13019,Berrien County,2021-02-28,2,2321,12.1
13019,Berrien County,2021-03-01,29,2350,12.3
13019,Berrien County,2021-03-02,21,2371,12.4
13019,Berrien County,2021-03-03,44,2415,12.6
13019,Berrien County,2021-03-04,11,2426,12.7
13019,Berrien County,2021-03-05,32,2458,12.8
13019,Berrien County,2021-03-06,4,2462,12.9
13019,Berrien County,2021-03-07,2,2464,12.9
13019,Berrien County,2021-03-08,36,2500,13.1
13019,Berrien County,2021-03-09,72,2572,13.4
13019,Berrien County,2021-03-10,55,2627,13.7
13019,Berrien County,2021-03-11,52,2679,14
13019,Berrien County,2021-03-12,43,2722,14.2
13019,Berrien County,2021-03-13,7,2729,14.2
13019,Berrien County,2021-03-14,17,2746,14.3
13019,Berrien County,2021-03-15,54,2800,14.6
13019,Berrien County,2021-03-16,52,2852,14.9
13019,Berrien County,2021-03-17,72,2924,15.3
13019,Berrien County,2021-03-18,31,2955,15.4
13019,Berrien County,2021-03-19,52,3007,15.7
13019,Berrien County,2021-03-20,6,3013,15.7
13019,Berrien County,2021-03-21,8,3021,15.8
13019,Berrien County,2021-03-22,52,3073,16
13019,Berrien County,2021-03-23,36,3109,16.2
13019,Berrien County,2021-03-24,56,3165,16.5
13019,Berrien County,2021-03-25,40,3205,16.7
13019,Berrien County,2021-03-26,29,3234,16.9
13019,Berrien County,2021-03-27,23,3257,17
13019,Berrien County,2021-03-28,11,3268,17.1
13019,Berrien County,2021-03-29,72,3340,17.4
13019,Berrien County,2021-03-30,62,3402,17.8
13019,Berrien County,2021-03-31,64,3466,18.1
13019,Berrien County,2021-04-01,47,3513,18.3
13019,Berrien County,2021-04-02,47,3560,18.6
13019,Berrien County,2021-04-03,9,3569,18.6
13019,Berrien County,2021-04-04,5,3574,18.7
13019,Berrien County,2021-04-05,48,3622,18.9
13019,Berrien County,2021-04-06,42,3664,19.1
13019,Berrien County,2021-04-07,69,3733,19.5
13019,Berrien County,2021-04-08,43,3776,19.7
13019,Berrien County,2021-04-09,41,3817,19.9
13019,Berrien County,2021-04-10,5,3822,20
13019,Berrien County,2021-04-11,9,3831,20
13019,Berrien County,2021-04-12,53,3884,20.3
13019,Berrien County,2021-04-13,37,3921,20.5
13019,Berrien County,2021-04-14,38,3959,20.7
13019,Berrien County,2021-04-15,48,4007,20.9
13019,Berrien County,2021-04-16,26,4033,21.1
13019,Berrien County,2021-04-18,4,4037,21.1
13019,Berrien County,2021-04-19,21,4058,21.2
13019,Berrien County,2021-04-20,16,4074,21.3
13019,Berrien County,2021-04-21,28,4102,21.4
13019,Berrien County,2021-04-22,14,4116,21.5
13019,Berrien County,2021-04-23,9,4125,21.5
13019,Berrien County,2021-04-24,2,4127,21.5
13019,Berrien County,2021-04-26,24,4151,21.7
13019,Berrien County,2021-04-27,11,4162,21.7
13019,Berrien County,2021-04-28,30,4192,21.9
13019,Berrien County,2021-04-29,17,4209,22
13019,Berrien County,2021-04-30,24,4233,22.1
13019,Berrien County,2021-05-01,3,4236,22.1
13019,Berrien County,2021-05-02,1,4237,22.1
13019,Berrien County,2021-05-03,12,4249,22.2
13019,Berrien County,2021-05-04,25,4274,22.3
13019,Berrien County,2021-05-05,15,4289,22.4
13019,Berrien County,2021-05-06,17,4306,22.5
13019,Berrien County,2021-05-07,8,4314,22.5
13019,Berrien County,2021-05-08,3,4317,22.5
13019,Berrien County,2021-05-09,2,4319,22.6
13019,Berrien County,2021-05-10,12,4331,22.6
13019,Berrien County,2021-05-11,22,4353,22.7
13019,Berrien County,2021-05-12,12,4365,22.8
13019,Berrien County,2021-05-13,18,4383,22.9
13019,Berrien County,2021-05-14,23,4406,23
13019,Berrien County,2021-05-15,14,4420,23.1
13019,Berrien County,2021-05-16,4,4424,23.1
13019,Berrien County,2021-05-17,17,4441,23.2
13019,Berrien County,2021-05-18,20,4461,23.3
13019,Berrien County,2021-05-19,20,4481,23.4
13019,Berrien County,2021-05-20,24,4505,23.5
13019,Berrien County,2021-05-21,22,4527,23.6
13019,Berrien County,2021-05-22,8,4535,23.7
13019,Berrien County,2021-05-23,3,4538,23.7
13019,Berrien County,2021-05-24,10,4548,23.7
13019,Berrien County,2021-05-25,10,4558,23.8
13019,Berrien County,2021-05-26,17,4575,23.9
13019,Berrien County,2021-05-27,16,4591,24
13019,Berrien County,2021-05-28,12,4603,24
13019,Berrien County,2021-05-29,9,4612,24.1
13019,Berrien County,2021-05-30,2,4614,24.1
13019,Berrien County,2021-05-31,1,4615,24.1
13019,Berrien County,2021-06-01,9,4624,24.1
13019,Berrien County,2021-06-02,9,4633,24.2
13019,Berrien County,2021-06-03,11,4644,24.2
13019,Berrien County,2021-06-04,11,4655,24.3
13019,Berrien County,2021-06-05,2,4657,24.3
13019,Berrien County,2021-06-06,2,4659,24.3
13019,Berrien County,2021-06-07,8,4667,24.4
13019,Berrien County,2021-06-08,10,4677,24.4
13019,Berrien County,2021-06-09,3,4680,24.4
13019,Berrien County,2021-06-10,15,4695,24.5
13019,Berrien County,2021-06-11,17,4712,24.6
13019,Berrien County,2021-06-12,2,4714,24.6
13019,Berrien County,2021-06-13,4,4718,24.6
13019,Berrien County,2021-06-14,5,4723,24.7
13019,Berrien County,2021-06-15,7,4730,24.7
13019,Berrien County,2021-06-16,7,4737,24.7
13019,Berrien County,2021-06-17,4,4741,24.8
13019,Berrien County,2021-06-18,11,4752,24.8
13019,Berrien County,2021-06-19,8,4760,24.9
13019,Berrien County,2021-06-20,1,4761,24.9
13019,Berrien County,2021-06-21,14,4775,24.9
13019,Berrien County,2021-06-22,6,4781,25
13019,Berrien County,2021-06-23,3,4784,25
13019,Berrien County,2021-06-24,10,4794,25
13019,Berrien County,2021-06-25,16,4810,25.1
13019,Berrien County,2021-06-26,3,4813,25.1
13019,Berrien County,2021-06-27,5,4818,25.2
13019,Berrien County,2021-06-28,3,4821,25.2
13019,Berrien County,2021-06-29,4,4825,25.2
13019,Berrien County,2021-06-30,3,4828,25.2
13019,Berrien County,2021-07-01,4,4832,25.2
13019,Berrien County,2021-07-02,11,4843,25.3
13019,Berrien County,2021-07-03,1,4844,25.3
13019,Berrien County,2021-07-05,4,4848,25.3
13019,Berrien County,2021-07-06,3,4851,25.3
13019,Berrien County,2021-07-07,5,4856,25.4
13019,Berrien County,2021-07-08,6,4862,25.4
13019,Berrien County,2021-07-09,13,4875,25.5
13019,Berrien County,2021-07-10,4,4879,25.5
13019,Berrien County,2021-07-11,2,4881,25.5
13019,Berrien County,2021-07-12,4,4885,25.5
13019,Berrien County,2021-07-13,7,4892,25.5
13019,Berrien County,2021-07-14,6,4898,25.6
13019,Berrien County,2021-07-15,5,4903,25.6
13019,Berrien County,2021-07-16,11,4914,25.7
13019,Berrien County,2021-07-17,7,4921,25.7
13019,Berrien County,2021-07-18,3,4924,25.7
13019,Berrien County,2021-07-19,17,4941,25.8
13019,Berrien County,2021-07-20,10,4951,25.9
13019,Berrien County,2021-07-21,12,4963,25.9
13019,Berrien County,2021-07-22,12,4975,26
13019,Berrien County,2021-07-23,32,5007,26.1
13019,Berrien County,2021-07-24,11,5018,26.2
13019,Berrien County,2021-07-25,7,5025,26.2
13019,Berrien County,2021-07-26,32,5057,26.4
13019,Berrien County,2021-07-27,38,5095,26.6
13019,Berrien County,2021-07-28,48,5143,26.9
13019,Berrien County,2021-07-29,30,5173,27
13019,Berrien County,2021-07-30,42,5215,27.2
13019,Berrien County,2021-07-31,14,5229,27.3
13019,Berrien County,2021-08-01,4,5233,27.3
13019,Berrien County,2021-08-02,24,5257,27.4
13019,Berrien County,2021-08-03,36,5293,27.6
13019,Berrien County,2021-08-04,32,5325,27.8
13019,Berrien County,2021-08-05,34,5359,28
13019,Berrien County,2021-08-06,64,5423,28.3
13019,Berrien County,2021-08-07,25,5448,28.4
13019,Berrien County,2021-08-08,20,5468,28.6
13019,Berrien County,2021-08-09,55,5523,28.8
13019,Berrien County,2021-08-10,47,5570,29.1
13019,Berrien County,2021-08-11,56,5626,29.4
13019,Berrien County,2021-08-12,44,5670,29.6
13019,Berrien County,2021-08-13,73,5743,30
13019,Berrien County,2021-08-14,28,5771,30.1
13019,Berrien County,2021-08-15,6,5777,30.2
13019,Berrien County,2021-08-16,43,5820,30.4
13019,Berrien County,2021-08-17,55,5875,30.7
13019,Berrien County,2021-08-18,40,5915,30.9
13019,Berrien County,2021-08-19,45,5960,31.1
13019,Berrien County,2021-08-20,38,5998,31.3
13019,Berrien County,2021-08-21,21,6019,31.4
13019,Berrien County,2021-08-22,13,6032,31.5
13019,Berrien County,2021-08-23,33,6065,31.7
13019,Berrien County,2021-08-24,25,6090,31.8
13019,Berrien County,2021-08-25,31,6121,32
13019,Berrien County,2021-08-26,87,6208,32.4
13019,Berrien County,2021-08-27,45,6253,32.6
13019,Berrien County,2021-08-28,21,6274,32.8
13019,Berrien County,2021-08-29,6,6280,32.8
13019,Berrien County,2021-08-30,24,6304,32.9
13019,Berrien County,2021-08-31,27,6331,33.1
13019,Berrien County,2021-09-01,18,6349,33.2
13019,Berrien County,2021-09-02,35,6384,33.3
13019,Berrien County,2021-09-03,24,6408,33.5
13019,Berrien County,2021-09-04,10,6418,33.5
13019,Berrien County,2021-09-05,5,6423,33.5
13019,Berrien County,2021-09-06,2,6425,33.5
13019,Berrien County,2021-09-07,27,6452,33.7
13019,Berrien County,2021-09-08,23,6475,33.8
13019,Berrien County,2021-09-09,17,6492,33.9
13019,Berrien County,2021-09-10,27,6519,34
13019,Berrien County,2021-09-11,7,6526,34.1
13019,Berrien County,2021-09-12,5,6531,34.1
13019,Berrien County,2021-09-13,17,6548,34.2
13019,Berrien County,2021-09-14,10,6558,34.2
13019,Berrien County,2021-09-15,17,6575,34.3
13019,Berrien County,2021-09-16,14,6589,34.4
13019,Berrien County,2021-09-17,10,6599,34.5
13019,Berrien County,2021-09-18,4,6603,34.5
13019,Berrien County,2021-09-19,3,6606,34.5
13019,Berrien County,2021-09-20,8,6614,34.5
13019,Berrien County,2021-09-21,9,6623,34.6
13019,Berrien County,2021-09-22,5,6628,34.6
13019,Berrien County,2021-09-23,7,6635,34.6
13019,Berrien County,2021-09-24,13,6648,34.7
13019,Berrien County,2021-09-25,2,6650,34.7
13019,Berrien County,2021-09-26,2,6652,34.7
13019,Berrien County,2021-09-28,3,6655,34.7
13019,Berrien County,2021-09-29,5,6660,34.8
13019,Berrien County,2021-09-30,3,6663,34.8
13019,Berrien County,2021-10-01,9,6672,34.8
13019,Berrien County,2021-10-03,2,6674,34.8
13019,Berrien County,2021-10-04,1,6675,34.9
13019,Berrien County,2021-10-05,3,6678,34.9
13019,Berrien County,2021-10-06,3,6681,34.9
13019,Berrien County,2021-10-07,1,6682,34.9
13021,Bibb County,2020-12-16,4,4,0
13021,Bibb County,2020-12-17,7,11,0
13021,Bibb County,2020-12-18,18,29,0
13021,Bibb County,2020-12-19,12,41,0
13021,Bibb County,2020-12-20,3,44,0
13021,Bibb County,2020-12-21,33,77,0.1
13021,Bibb County,2020-12-22,161,238,0.2
13021,Bibb County,2020-12-23,187,425,0.3
13021,Bibb County,2020-12-24,220,645,0.4
13021,Bibb County,2020-12-25,2,647,0.4
13021,Bibb County,2020-12-26,135,782,0.5
13021,Bibb County,2020-12-27,41,823,0.5
13021,Bibb County,2020-12-28,430,1253,0.8
13021,Bibb County,2020-12-29,217,1470,1
13021,Bibb County,2020-12-30,444,1914,1.2
13021,Bibb County,2020-12-31,50,1964,1.3
13021,Bibb County,2021-01-01,52,2016,1.3
13021,Bibb County,2021-01-02,18,2034,1.3
13021,Bibb County,2021-01-03,41,2075,1.4
13021,Bibb County,2021-01-04,182,2257,1.5
13021,Bibb County,2021-01-05,253,2510,1.6
13021,Bibb County,2021-01-06,316,2826,1.8
13021,Bibb County,2021-01-07,251,3077,2
13021,Bibb County,2021-01-08,249,3326,2.2
13021,Bibb County,2021-01-09,45,3371,2.2
13021,Bibb County,2021-01-10,100,3471,2.3
13021,Bibb County,2021-01-11,249,3720,2.4
13021,Bibb County,2021-01-12,223,3943,2.6
13021,Bibb County,2021-01-13,411,4354,2.8
13021,Bibb County,2021-01-14,392,4746,3.1
13021,Bibb County,2021-01-15,509,5255,3.4
13021,Bibb County,2021-01-16,166,5421,3.5
13021,Bibb County,2021-01-17,94,5515,3.6
13021,Bibb County,2021-01-18,565,6080,4
13021,Bibb County,2021-01-19,428,6508,4.2
13021,Bibb County,2021-01-20,978,7486,4.9
13021,Bibb County,2021-01-21,601,8087,5.3
13021,Bibb County,2021-01-22,837,8924,5.8
13021,Bibb County,2021-01-23,95,9019,5.9
13021,Bibb County,2021-01-24,106,9125,6
13021,Bibb County,2021-01-25,487,9612,6.3
13021,Bibb County,2021-01-26,224,9836,6.4
13021,Bibb County,2021-01-27,732,10568,6.9
13021,Bibb County,2021-01-28,372,10940,7.1
13021,Bibb County,2021-01-29,593,11533,7.5
13021,Bibb County,2021-01-30,55,11588,7.6
13021,Bibb County,2021-01-31,53,11641,7.6
13021,Bibb County,2021-02-01,314,11955,7.8
13021,Bibb County,2021-02-02,204,12159,7.9
13021,Bibb County,2021-02-03,501,12660,8.3
13021,Bibb County,2021-02-04,262,12922,8.4
13021,Bibb County,2021-02-05,481,13403,8.7
13021,Bibb County,2021-02-06,47,13450,8.8
13021,Bibb County,2021-02-07,27,13477,8.8
13021,Bibb County,2021-02-08,327,13804,9
13021,Bibb County,2021-02-09,248,14052,9.2
13021,Bibb County,2021-02-10,419,14471,9.4
13021,Bibb County,2021-02-11,195,14666,9.6
13021,Bibb County,2021-02-12,356,15022,9.8
13021,Bibb County,2021-02-13,111,15133,9.9
13021,Bibb County,2021-02-14,45,15178,9.9
13021,Bibb County,2021-02-15,323,15501,10.1
13021,Bibb County,2021-02-16,208,15709,10.3
13021,Bibb County,2021-02-17,368,16077,10.5
13021,Bibb County,2021-02-18,275,16352,10.7
13021,Bibb County,2021-02-19,170,16522,10.8
13021,Bibb County,2021-02-20,107,16629,10.9
13021,Bibb County,2021-02-21,3,16632,10.9
13021,Bibb County,2021-02-22,418,17050,11.1
13021,Bibb County,2021-02-23,380,17430,11.4
13021,Bibb County,2021-02-24,442,17872,11.7
13021,Bibb County,2021-02-25,463,18335,12
13021,Bibb County,2021-02-26,559,18894,12.3
13021,Bibb County,2021-02-27,95,18989,12.4
13021,Bibb County,2021-02-28,76,19065,12.4
13021,Bibb County,2021-03-01,854,19919,13
13021,Bibb County,2021-03-02,532,20451,13.3
13021,Bibb County,2021-03-03,878,21329,13.9
13021,Bibb County,2021-03-04,720,22049,14.4
13021,Bibb County,2021-03-05,663,22712,14.8
13021,Bibb County,2021-03-06,74,22786,14.9
13021,Bibb County,2021-03-07,53,22839,14.9
13021,Bibb County,2021-03-08,923,23762,15.5
13021,Bibb County,2021-03-09,618,24380,15.9
13021,Bibb County,2021-03-10,927,25307,16.5
13021,Bibb County,2021-03-11,738,26045,17
13021,Bibb County,2021-03-12,739,26784,17.5
13021,Bibb County,2021-03-13,703,27487,17.9
13021,Bibb County,2021-03-14,148,27635,18
13021,Bibb County,2021-03-15,1043,28678,18.7
13021,Bibb County,2021-03-16,748,29426,19.2
13021,Bibb County,2021-03-17,942,30368,19.8
13021,Bibb County,2021-03-18,565,30933,20.2
13021,Bibb County,2021-03-19,1022,31955,20.9
13021,Bibb County,2021-03-20,165,32120,21
13021,Bibb County,2021-03-21,72,32192,21
13021,Bibb County,2021-03-22,711,32903,21.5
13021,Bibb County,2021-03-23,626,33529,21.9
13021,Bibb County,2021-03-24,664,34193,22.3
13021,Bibb County,2021-03-25,891,35084,22.9
13021,Bibb County,2021-03-26,870,35954,23.5
13021,Bibb County,2021-03-27,120,36074,23.5
13021,Bibb County,2021-03-28,88,36162,23.6
13021,Bibb County,2021-03-29,857,37019,24.2
13021,Bibb County,2021-03-30,734,37753,24.6
13021,Bibb County,2021-03-31,857,38610,25.2
13021,Bibb County,2021-04-01,943,39553,25.8
13021,Bibb County,2021-04-02,839,40392,26.4
13021,Bibb County,2021-04-03,243,40635,26.5
13021,Bibb County,2021-04-04,78,40713,26.6
13021,Bibb County,2021-04-05,675,41388,27
13021,Bibb County,2021-04-06,582,41970,27.4
13021,Bibb County,2021-04-07,662,42632,27.8
13021,Bibb County,2021-04-08,577,43209,28.2
13021,Bibb County,2021-04-09,714,43923,28.7
13021,Bibb County,2021-04-10,146,44069,28.8
13021,Bibb County,2021-04-11,94,44163,28.8
13021,Bibb County,2021-04-12,412,44575,29.1
13021,Bibb County,2021-04-13,370,44945,29.3
13021,Bibb County,2021-04-14,358,45303,29.6
13021,Bibb County,2021-04-15,294,45597,29.8
13021,Bibb County,2021-04-16,362,45959,30
13021,Bibb County,2021-04-17,55,46014,30
13021,Bibb County,2021-04-18,42,46056,30.1
13021,Bibb County,2021-04-19,209,46265,30.2
13021,Bibb County,2021-04-20,239,46504,30.4
13021,Bibb County,2021-04-21,303,46807,30.6
13021,Bibb County,2021-04-22,241,47048,30.7
13021,Bibb County,2021-04-23,312,47360,30.9
13021,Bibb County,2021-04-24,61,47421,31
13021,Bibb County,2021-04-25,45,47466,31
13021,Bibb County,2021-04-26,187,47653,31.1
13021,Bibb County,2021-04-27,257,47910,31.3
13021,Bibb County,2021-04-28,260,48170,31.4
13021,Bibb County,2021-04-29,308,48478,31.6
13021,Bibb County,2021-04-30,303,48781,31.8
13021,Bibb County,2021-05-01,88,48869,31.9
13021,Bibb County,2021-05-02,62,48931,31.9
13021,Bibb County,2021-05-03,180,49111,32.1
13021,Bibb County,2021-05-04,230,49341,32.2
13021,Bibb County,2021-05-05,206,49547,32.3
13021,Bibb County,2021-05-06,218,49765,32.5
13021,Bibb County,2021-05-07,239,50004,32.6
13021,Bibb County,2021-05-08,103,50107,32.7
13021,Bibb County,2021-05-09,30,50137,32.7
13021,Bibb County,2021-05-10,109,50246,32.8
13021,Bibb County,2021-05-11,170,50416,32.9
13021,Bibb County,2021-05-12,182,50598,33
13021,Bibb County,2021-05-13,197,50795,33.2
13021,Bibb County,2021-05-14,224,51019,33.3
13021,Bibb County,2021-05-15,163,51182,33.4
13021,Bibb County,2021-05-16,91,51273,33.5
13021,Bibb County,2021-05-17,252,51525,33.6
13021,Bibb County,2021-05-18,319,51844,33.8
13021,Bibb County,2021-05-19,216,52060,34
13021,Bibb County,2021-05-20,251,52311,34.1
13021,Bibb County,2021-05-21,261,52572,34.3
13021,Bibb County,2021-05-22,120,52692,34.4
13021,Bibb County,2021-05-23,73,52765,34.4
13021,Bibb County,2021-05-24,147,52912,34.5
13021,Bibb County,2021-05-25,173,53085,34.7
13021,Bibb County,2021-05-26,166,53251,34.8
13021,Bibb County,2021-05-27,155,53406,34.9
13021,Bibb County,2021-05-28,98,53504,34.9
13021,Bibb County,2021-05-29,72,53576,35
13021,Bibb County,2021-05-30,65,53641,35
13021,Bibb County,2021-05-31,29,53670,35
13021,Bibb County,2021-06-01,156,53826,35.1
13021,Bibb County,2021-06-02,154,53980,35.2
13021,Bibb County,2021-06-03,138,54118,35.3
13021,Bibb County,2021-06-04,143,54261,35.4
13021,Bibb County,2021-06-05,71,54332,35.5
13021,Bibb County,2021-06-06,54,54386,35.5
13021,Bibb County,2021-06-07,130,54516,35.6
13021,Bibb County,2021-06-08,73,54589,35.6
13021,Bibb County,2021-06-09,105,54694,35.7
13021,Bibb County,2021-06-10,145,54839,35.8
13021,Bibb County,2021-06-11,105,54944,35.9
13021,Bibb County,2021-06-12,66,55010,35.9
13021,Bibb County,2021-06-13,27,55037,35.9
13021,Bibb County,2021-06-14,88,55125,36
13021,Bibb County,2021-06-15,105,55230,36.1
13021,Bibb County,2021-06-16,77,55307,36.1
13021,Bibb County,2021-06-17,105,55412,36.2
13021,Bibb County,2021-06-18,90,55502,36.2
13021,Bibb County,2021-06-19,51,55553,36.3
13021,Bibb County,2021-06-20,37,55590,36.3
13021,Bibb County,2021-06-21,81,55671,36.3
13021,Bibb County,2021-06-22,110,55781,36.4
13021,Bibb County,2021-06-23,97,55878,36.5
13021,Bibb County,2021-06-24,95,55973,36.5
13021,Bibb County,2021-06-25,94,56067,36.6
13021,Bibb County,2021-06-26,78,56145,36.6
13021,Bibb County,2021-06-27,44,56189,36.7
13021,Bibb County,2021-06-28,89,56278,36.7
13021,Bibb County,2021-06-29,94,56372,36.8
13021,Bibb County,2021-06-30,163,56535,36.9
13021,Bibb County,2021-07-01,84,56619,37
13021,Bibb County,2021-07-02,85,56704,37
13021,Bibb County,2021-07-03,32,56736,37
13021,Bibb County,2021-07-04,8,56744,37
13021,Bibb County,2021-07-05,85,56829,37.1
13021,Bibb County,2021-07-06,101,56930,37.2
13021,Bibb County,2021-07-07,85,57015,37.2
13021,Bibb County,2021-07-08,92,57107,37.3
13021,Bibb County,2021-07-09,120,57227,37.4
13021,Bibb County,2021-07-10,52,57279,37.4
13021,Bibb County,2021-07-11,36,57315,37.4
13021,Bibb County,2021-07-12,77,57392,37.5
13021,Bibb County,2021-07-13,99,57491,37.5
13021,Bibb County,2021-07-14,130,57621,37.6
13021,Bibb County,2021-07-15,95,57716,37.7
13021,Bibb County,2021-07-16,114,57830,37.7
13021,Bibb County,2021-07-17,93,57923,37.8
13021,Bibb County,2021-07-18,50,57973,37.8
13021,Bibb County,2021-07-19,122,58095,37.9
13021,Bibb County,2021-07-20,142,58237,38
13021,Bibb County,2021-07-21,172,58409,38.1
13021,Bibb County,2021-07-22,194,58603,38.3
13021,Bibb County,2021-07-23,210,58813,38.4
13021,Bibb County,2021-07-24,245,59058,38.5
13021,Bibb County,2021-07-25,105,59163,38.6
13021,Bibb County,2021-07-26,236,59399,38.8
13021,Bibb County,2021-07-27,228,59627,38.9
13021,Bibb County,2021-07-28,260,59887,39.1
13021,Bibb County,2021-07-29,246,60133,39.3
13021,Bibb County,2021-07-30,308,60441,39.5
13021,Bibb County,2021-07-31,191,60632,39.6
13021,Bibb County,2021-08-01,138,60770,39.7
13021,Bibb County,2021-08-02,221,60991,39.8
13021,Bibb County,2021-08-03,214,61205,40
13021,Bibb County,2021-08-04,284,61489,40.1
13021,Bibb County,2021-08-05,296,61785,40.3
13021,Bibb County,2021-08-06,370,62155,40.6
13021,Bibb County,2021-08-07,184,62339,40.7
13021,Bibb County,2021-08-08,179,62518,40.8
13021,Bibb County,2021-08-09,244,62762,41
13021,Bibb County,2021-08-10,310,63072,41.2
13021,Bibb County,2021-08-11,313,63385,41.4
13021,Bibb County,2021-08-12,329,63714,41.6
13021,Bibb County,2021-08-13,364,64078,41.8
13021,Bibb County,2021-08-14,213,64291,42
13021,Bibb County,2021-08-15,140,64431,42.1
13021,Bibb County,2021-08-16,294,64725,42.2
13021,Bibb County,2021-08-17,286,65011,42.4
13021,Bibb County,2021-08-18,310,65321,42.6
13021,Bibb County,2021-08-19,248,65569,42.8
13021,Bibb County,2021-08-20,351,65920,43
13021,Bibb County,2021-08-21,157,66077,43.1
13021,Bibb County,2021-08-22,130,66207,43.2
13021,Bibb County,2021-08-23,213,66420,43.4
13021,Bibb County,2021-08-24,291,66711,43.5
13021,Bibb County,2021-08-25,268,66979,43.7
13021,Bibb County,2021-08-26,233,67212,43.9
13021,Bibb County,2021-08-27,259,67471,44
13021,Bibb County,2021-08-28,164,67635,44.1
13021,Bibb County,2021-08-29,115,67750,44.2
13021,Bibb County,2021-08-30,194,67944,44.3
13021,Bibb County,2021-08-31,242,68186,44.5
13021,Bibb County,2021-09-01,207,68393,44.6
13021,Bibb County,2021-09-02,246,68639,44.8
13021,Bibb County,2021-09-03,235,68874,45
13021,Bibb County,2021-09-04,150,69024,45.1
13021,Bibb County,2021-09-05,99,69123,45.1
13021,Bibb County,2021-09-06,43,69166,45.1
13021,Bibb County,2021-09-07,181,69347,45.3
13021,Bibb County,2021-09-08,234,69581,45.4
13021,Bibb County,2021-09-09,226,69807,45.6
13021,Bibb County,2021-09-10,308,70115,45.8
13021,Bibb County,2021-09-11,146,70261,45.9
13021,Bibb County,2021-09-12,74,70335,45.9
13021,Bibb County,2021-09-13,168,70503,46
13021,Bibb County,2021-09-14,144,70647,46.1
13021,Bibb County,2021-09-15,184,70831,46.2
13021,Bibb County,2021-09-16,171,71002,46.3
13021,Bibb County,2021-09-17,209,71211,46.5
13021,Bibb County,2021-09-18,83,71294,46.5
13021,Bibb County,2021-09-19,75,71369,46.6
13021,Bibb County,2021-09-20,113,71482,46.7
13021,Bibb County,2021-09-21,114,71596,46.7
13021,Bibb County,2021-09-22,138,71734,46.8
13021,Bibb County,2021-09-23,108,71842,46.9
13021,Bibb County,2021-09-24,104,71946,47
13021,Bibb County,2021-09-25,55,72001,47
13021,Bibb County,2021-09-26,46,72047,47
13021,Bibb County,2021-09-27,65,72112,47.1
13021,Bibb County,2021-09-28,94,72206,47.1
13021,Bibb County,2021-09-29,86,72292,47.2
13021,Bibb County,2021-09-30,89,72381,47.2
13021,Bibb County,2021-10-01,93,72474,47.3
13021,Bibb County,2021-10-02,54,72528,47.3
13021,Bibb County,2021-10-03,37,72565,47.4
13021,Bibb County,2021-10-04,50,72615,47.4
13021,Bibb County,2021-10-05,49,72664,47.4
13021,Bibb County,2021-10-06,48,72712,47.5
13021,Bibb County,2021-10-07,25,72737,47.5
13023,Bleckley County,2020-12-16,1,1,0
13023,Bleckley County,2020-12-17,1,2,0
13023,Bleckley County,2020-12-18,4,6,0
13023,Bleckley County,2020-12-19,1,7,0.1
13023,Bleckley County,2020-12-21,2,9,0.1
13023,Bleckley County,2020-12-22,5,14,0.1
13023,Bleckley County,2020-12-23,3,17,0.1
13023,Bleckley County,2020-12-24,4,21,0.2
13023,Bleckley County,2020-12-26,5,26,0.2
13023,Bleckley County,2020-12-27,1,27,0.2
13023,Bleckley County,2020-12-28,22,49,0.4
13023,Bleckley County,2020-12-29,14,63,0.5
13023,Bleckley County,2020-12-30,11,74,0.6
13023,Bleckley County,2020-12-31,6,80,0.6
13023,Bleckley County,2021-01-01,1,81,0.6
13023,Bleckley County,2021-01-02,2,83,0.6
13023,Bleckley County,2021-01-03,3,86,0.7
13023,Bleckley County,2021-01-04,25,111,0.9
13023,Bleckley County,2021-01-05,20,131,1
13023,Bleckley County,2021-01-06,22,153,1.2
13023,Bleckley County,2021-01-07,23,176,1.4
13023,Bleckley County,2021-01-08,36,212,1.7
13023,Bleckley County,2021-01-09,1,213,1.7
13023,Bleckley County,2021-01-11,41,254,2
13023,Bleckley County,2021-01-12,13,267,2.1
13023,Bleckley County,2021-01-13,83,350,2.7
13023,Bleckley County,2021-01-14,34,384,3
13023,Bleckley County,2021-01-15,45,429,3.3
13023,Bleckley County,2021-01-16,3,432,3.4
13023,Bleckley County,2021-01-17,4,436,3.4
13023,Bleckley County,2021-01-18,336,772,6
13023,Bleckley County,2021-01-19,21,793,6.2
13023,Bleckley County,2021-01-20,63,856,6.7
13023,Bleckley County,2021-01-21,60,916,7.2
13023,Bleckley County,2021-01-22,126,1042,8.1
13023,Bleckley County,2021-01-23,1,1043,8.1
13023,Bleckley County,2021-01-25,295,1338,10.4
13023,Bleckley County,2021-01-26,21,1359,10.6
13023,Bleckley County,2021-01-27,8,1367,10.7
13023,Bleckley County,2021-01-28,33,1400,10.9
13023,Bleckley County,2021-01-29,21,1421,11.1
13023,Bleckley County,2021-02-01,90,1511,11.8
13023,Bleckley County,2021-02-02,7,1518,11.9
13023,Bleckley County,2021-02-03,15,1533,12
13023,Bleckley County,2021-02-04,3,1536,12
13023,Bleckley County,2021-02-05,11,1547,12.1
13023,Bleckley County,2021-02-08,51,1598,12.5
13023,Bleckley County,2021-02-09,6,1604,12.5
13023,Bleckley County,2021-02-10,11,1615,12.6
13023,Bleckley County,2021-02-11,6,1621,12.7
13023,Bleckley County,2021-02-12,9,1630,12.7
13023,Bleckley County,2021-02-13,10,1640,12.8
13023,Bleckley County,2021-02-15,32,1672,13.1
13023,Bleckley County,2021-02-16,5,1677,13.1
13023,Bleckley County,2021-02-17,13,1690,13.2
13023,Bleckley County,2021-02-18,8,1698,13.3
13023,Bleckley County,2021-02-19,4,1702,13.3
13023,Bleckley County,2021-02-20,2,1704,13.3
13023,Bleckley County,2021-02-22,15,1719,13.4
13023,Bleckley County,2021-02-23,6,1725,13.5
13023,Bleckley County,2021-02-24,8,1733,13.5
13023,Bleckley County,2021-02-25,7,1740,13.6
13023,Bleckley County,2021-02-26,9,1749,13.7
13023,Bleckley County,2021-02-27,4,1753,13.7
13023,Bleckley County,2021-02-28,4,1757,13.7
13023,Bleckley County,2021-03-01,79,1836,14.3
13023,Bleckley County,2021-03-02,6,1842,14.4
13023,Bleckley County,2021-03-03,8,1850,14.4
13023,Bleckley County,2021-03-04,14,1864,14.6
13023,Bleckley County,2021-03-05,10,1874,14.6
13023,Bleckley County,2021-03-06,4,1878,14.7
13023,Bleckley County,2021-03-07,6,1884,14.7
13023,Bleckley County,2021-03-08,28,1912,14.9
13023,Bleckley County,2021-03-09,15,1927,15
13023,Bleckley County,2021-03-10,21,1948,15.2
13023,Bleckley County,2021-03-11,17,1965,15.3
13023,Bleckley County,2021-03-12,20,1985,15.5
13023,Bleckley County,2021-03-13,8,1993,15.6
13023,Bleckley County,2021-03-14,5,1998,15.6
13023,Bleckley County,2021-03-15,121,2119,16.5
13023,Bleckley County,2021-03-16,20,2139,16.7
13023,Bleckley County,2021-03-17,25,2164,16.9
13023,Bleckley County,2021-03-18,57,2221,17.3
13023,Bleckley County,2021-03-19,51,2272,17.7
13023,Bleckley County,2021-03-20,10,2282,17.8
13023,Bleckley County,2021-03-21,2,2284,17.8
13023,Bleckley County,2021-03-22,29,2313,18.1
13023,Bleckley County,2021-03-23,17,2330,18.2
13023,Bleckley County,2021-03-24,31,2361,18.4
13023,Bleckley County,2021-03-25,46,2407,18.8
13023,Bleckley County,2021-03-26,25,2432,19
13023,Bleckley County,2021-03-27,5,2437,19
13023,Bleckley County,2021-03-28,8,2445,19.1
13023,Bleckley County,2021-03-29,23,2468,19.3
13023,Bleckley County,2021-03-30,33,2501,19.5
13023,Bleckley County,2021-03-31,48,2549,19.9
13023,Bleckley County,2021-04-01,68,2617,20.4
13023,Bleckley County,2021-04-02,32,2649,20.7
13023,Bleckley County,2021-04-03,10,2659,20.8
13023,Bleckley County,2021-04-04,3,2662,20.8
13023,Bleckley County,2021-04-05,25,2687,21
13023,Bleckley County,2021-04-06,21,2708,21.1
13023,Bleckley County,2021-04-07,25,2733,21.3
13023,Bleckley County,2021-04-08,73,2806,21.9
13023,Bleckley County,2021-04-09,39,2845,22.2
13023,Bleckley County,2021-04-10,13,2858,22.3
13023,Bleckley County,2021-04-11,11,2869,22.4
13023,Bleckley County,2021-04-12,16,2885,22.5
13023,Bleckley County,2021-04-13,23,2908,22.7
13023,Bleckley County,2021-04-14,6,2914,22.8
13023,Bleckley County,2021-04-15,41,2955,23.1
13023,Bleckley County,2021-04-16,19,2974,23.2
13023,Bleckley County,2021-04-17,7,2981,23.3
13023,Bleckley County,2021-04-18,3,2984,23.3
13023,Bleckley County,2021-04-19,13,2997,23.4
13023,Bleckley County,2021-04-20,7,3004,23.5
13023,Bleckley County,2021-04-21,14,3018,23.6
13023,Bleckley County,2021-04-22,46,3064,23.9
13023,Bleckley County,2021-04-23,8,3072,24
13023,Bleckley County,2021-04-25,4,3076,24
13023,Bleckley County,2021-04-26,6,3082,24.1
13023,Bleckley County,2021-04-27,6,3088,24.1
13023,Bleckley County,2021-04-28,16,3104,24.2
13023,Bleckley County,2021-04-29,39,3143,24.5
13023,Bleckley County,2021-04-30,14,3157,24.7
13023,Bleckley County,2021-05-01,2,3159,24.7
13023,Bleckley County,2021-05-02,3,3162,24.7
13023,Bleckley County,2021-05-03,6,3168,24.7
13023,Bleckley County,2021-05-04,10,3178,24.8
13023,Bleckley County,2021-05-05,14,3192,24.9
13023,Bleckley County,2021-05-06,27,3219,25.1
13023,Bleckley County,2021-05-07,12,3231,25.2
13023,Bleckley County,2021-05-08,2,3233,25.2
13023,Bleckley County,2021-05-09,2,3235,25.3
13023,Bleckley County,2021-05-10,1,3236,25.3
13023,Bleckley County,2021-05-11,6,3242,25.3
13023,Bleckley County,2021-05-12,7,3249,25.4
13023,Bleckley County,2021-05-13,14,3263,25.5
13023,Bleckley County,2021-05-14,7,3270,25.5
13023,Bleckley County,2021-05-15,6,3276,25.6
13023,Bleckley County,2021-05-16,2,3278,25.6
13023,Bleckley County,2021-05-17,15,3293,25.7
13023,Bleckley County,2021-05-18,15,3308,25.8
13023,Bleckley County,2021-05-19,5,3313,25.9
13023,Bleckley County,2021-05-20,10,3323,25.9
13023,Bleckley County,2021-05-21,14,3337,26.1
13023,Bleckley County,2021-05-22,8,3345,26.1
13023,Bleckley County,2021-05-23,8,3353,26.2
13023,Bleckley County,2021-05-24,3,3356,26.2
13023,Bleckley County,2021-05-25,3,3359,26.2
13023,Bleckley County,2021-05-26,8,3367,26.3
13023,Bleckley County,2021-05-27,11,3378,26.4
13023,Bleckley County,2021-05-28,3,3381,26.4
13023,Bleckley County,2021-05-29,2,3383,26.4
13023,Bleckley County,2021-05-30,5,3388,26.5
13023,Bleckley County,2021-05-31,2,3390,26.5
13023,Bleckley County,2021-06-01,8,3398,26.5
13023,Bleckley County,2021-06-02,13,3411,26.6
13023,Bleckley County,2021-06-03,6,3417,26.7
13023,Bleckley County,2021-06-04,3,3420,26.7
13023,Bleckley County,2021-06-05,2,3422,26.7
13023,Bleckley County,2021-06-06,2,3424,26.7
13023,Bleckley County,2021-06-07,4,3428,26.8
13023,Bleckley County,2021-06-08,4,3432,26.8
13023,Bleckley County,2021-06-09,6,3438,26.8
13023,Bleckley County,2021-06-10,4,3442,26.9
13023,Bleckley County,2021-06-11,5,3447,26.9
13023,Bleckley County,2021-06-14,1,3448,26.9
13023,Bleckley County,2021-06-15,6,3454,27
13023,Bleckley County,2021-06-16,3,3457,27
13023,Bleckley County,2021-06-17,8,3465,27.1
13023,Bleckley County,2021-06-18,3,3468,27.1
13023,Bleckley County,2021-06-19,2,3470,27.1
13023,Bleckley County,2021-06-20,2,3472,27.1
13023,Bleckley County,2021-06-21,5,3477,27.1
13023,Bleckley County,2021-06-22,2,3479,27.2
13023,Bleckley County,2021-06-23,9,3488,27.2
13023,Bleckley County,2021-06-24,3,3491,27.3
13023,Bleckley County,2021-06-25,4,3495,27.3
13023,Bleckley County,2021-06-26,8,3503,27.4
13023,Bleckley County,2021-06-27,1,3504,27.4
13023,Bleckley County,2021-06-28,8,3512,27.4
13023,Bleckley County,2021-06-29,6,3518,27.5
13023,Bleckley County,2021-06-30,5,3523,27.5
13023,Bleckley County,2021-07-01,5,3528,27.5
13023,Bleckley County,2021-07-02,8,3536,27.6
13023,Bleckley County,2021-07-03,5,3541,27.6
13023,Bleckley County,2021-07-04,1,3542,27.7
13023,Bleckley County,2021-07-05,3,3545,27.7
13023,Bleckley County,2021-07-06,6,3551,27.7
13023,Bleckley County,2021-07-07,9,3560,27.8
13023,Bleckley County,2021-07-08,9,3569,27.9
13023,Bleckley County,2021-07-09,2,3571,27.9
13023,Bleckley County,2021-07-10,2,3573,27.9
13023,Bleckley County,2021-07-11,3,3576,27.9
13023,Bleckley County,2021-07-12,5,3581,28
13023,Bleckley County,2021-07-13,9,3590,28
13023,Bleckley County,2021-07-14,7,3597,28.1
13023,Bleckley County,2021-07-15,4,3601,28.1
13023,Bleckley County,2021-07-16,12,3613,28.2
13023,Bleckley County,2021-07-17,3,3616,28.2
13023,Bleckley County,2021-07-18,1,3617,28.2
13023,Bleckley County,2021-07-19,11,3628,28.3
13023,Bleckley County,2021-07-20,16,3644,28.5
13023,Bleckley County,2021-07-21,9,3653,28.5
13023,Bleckley County,2021-07-22,7,3660,28.6
13023,Bleckley County,2021-07-23,13,3673,28.7
13023,Bleckley County,2021-07-24,5,3678,28.7
13023,Bleckley County,2021-07-25,5,3683,28.8
13023,Bleckley County,2021-07-26,20,3703,28.9
13023,Bleckley County,2021-07-27,12,3715,29
13023,Bleckley County,2021-07-28,30,3745,29.2
13023,Bleckley County,2021-07-29,27,3772,29.5
13023,Bleckley County,2021-07-30,24,3796,29.6
13023,Bleckley County,2021-07-31,19,3815,29.8
13023,Bleckley County,2021-08-01,9,3824,29.9
13023,Bleckley County,2021-08-02,17,3841,30
13023,Bleckley County,2021-08-03,15,3856,30.1
13023,Bleckley County,2021-08-04,25,3881,30.3
13023,Bleckley County,2021-08-05,21,3902,30.5
13023,Bleckley County,2021-08-06,31,3933,30.7
13023,Bleckley County,2021-08-07,18,3951,30.9
13023,Bleckley County,2021-08-08,9,3960,30.9
13023,Bleckley County,2021-08-09,39,3999,31.2
13023,Bleckley County,2021-08-10,29,4028,31.5
13023,Bleckley County,2021-08-11,25,4053,31.6
13023,Bleckley County,2021-08-12,13,4066,31.7
13023,Bleckley County,2021-08-13,45,4111,32.1
13023,Bleckley County,2021-08-14,12,4123,32.2
13023,Bleckley County,2021-08-15,4,4127,32.2
13023,Bleckley County,2021-08-16,31,4158,32.5
13023,Bleckley County,2021-08-17,39,4197,32.8
13023,Bleckley County,2021-08-18,33,4230,33
13023,Bleckley County,2021-08-19,32,4262,33.3
13023,Bleckley County,2021-08-20,52,4314,33.7
13023,Bleckley County,2021-08-21,13,4327,33.8
13023,Bleckley County,2021-08-22,9,4336,33.9
13023,Bleckley County,2021-08-23,29,4365,34.1
13023,Bleckley County,2021-08-24,20,4385,34.2
13023,Bleckley County,2021-08-25,37,4422,34.5
13023,Bleckley County,2021-08-26,24,4446,34.7
13023,Bleckley County,2021-08-27,20,4466,34.9
13023,Bleckley County,2021-08-28,11,4477,35
13023,Bleckley County,2021-08-29,11,4488,35
13023,Bleckley County,2021-08-30,25,4513,35.2
13023,Bleckley County,2021-08-31,25,4538,35.4
13023,Bleckley County,2021-09-01,34,4572,35.7
13023,Bleckley County,2021-09-02,34,4606,36
13023,Bleckley County,2021-09-03,23,4629,36.1
13023,Bleckley County,2021-09-04,7,4636,36.2
13023,Bleckley County,2021-09-05,5,4641,36.2
13023,Bleckley County,2021-09-06,8,4649,36.3
13023,Bleckley County,2021-09-07,12,4661,36.4
13023,Bleckley County,2021-09-08,17,4678,36.5
13023,Bleckley County,2021-09-09,16,4694,36.7
13023,Bleckley County,2021-09-10,20,4714,36.8
13023,Bleckley County,2021-09-11,12,4726,36.9
13023,Bleckley County,2021-09-12,2,4728,36.9
13023,Bleckley County,2021-09-13,11,4739,37
13023,Bleckley County,2021-09-14,12,4751,37.1
13023,Bleckley County,2021-09-15,11,4762,37.2
13023,Bleckley County,2021-09-16,14,4776,37.3
13023,Bleckley County,2021-09-17,18,4794,37.4
13023,Bleckley County,2021-09-18,6,4800,37.5
13023,Bleckley County,2021-09-19,6,4806,37.5
13023,Bleckley County,2021-09-20,4,4810,37.6
13023,Bleckley County,2021-09-21,6,4816,37.6
13023,Bleckley County,2021-09-22,12,4828,37.7
13023,Bleckley County,2021-09-23,17,4845,37.8
13023,Bleckley County,2021-09-24,13,4858,37.9
13023,Bleckley County,2021-09-25,4,4862,38
13023,Bleckley County,2021-09-26,4,4866,38
13023,Bleckley County,2021-09-27,5,4871,38
13023,Bleckley County,2021-09-28,2,4873,38
13023,Bleckley County,2021-09-29,10,4883,38.1
13023,Bleckley County,2021-09-30,4,4887,38.2
13023,Bleckley County,2021-10-01,4,4891,38.2
13023,Bleckley County,2021-10-02,1,4892,38.2
13023,Bleckley County,2021-10-03,2,4894,38.2
13023,Bleckley County,2021-10-04,5,4899,38.3
13023,Bleckley County,2021-10-05,2,4901,38.3
13023,Bleckley County,2021-10-06,5,4906,38.3
13023,Bleckley County,2021-10-07,1,4907,38.3
13025,Brantley County,2020-12-15,6,6,0
13025,Brantley County,2020-12-17,14,20,0.1
13025,Brantley County,2020-12-18,2,22,0.1
13025,Brantley County,2020-12-19,1,23,0.1
13025,Brantley County,2020-12-21,8,31,0.2
13025,Brantley County,2020-12-22,6,37,0.2
13025,Brantley County,2020-12-23,8,45,0.2
13025,Brantley County,2020-12-24,3,48,0.3
13025,Brantley County,2020-12-27,1,49,0.3
13025,Brantley County,2020-12-28,6,55,0.3
13025,Brantley County,2020-12-29,9,64,0.3
13025,Brantley County,2020-12-30,13,77,0.4
13025,Brantley County,2020-12-31,6,83,0.4
13025,Brantley County,2021-01-01,1,84,0.4
13025,Brantley County,2021-01-03,2,86,0.5
13025,Brantley County,2021-01-04,8,94,0.5
13025,Brantley County,2021-01-05,16,110,0.6
13025,Brantley County,2021-01-06,10,120,0.6
13025,Brantley County,2021-01-07,31,151,0.8
13025,Brantley County,2021-01-08,24,175,0.9
13025,Brantley County,2021-01-09,1,176,0.9
13025,Brantley County,2021-01-10,2,178,0.9
13025,Brantley County,2021-01-11,30,208,1.1
13025,Brantley County,2021-01-12,25,233,1.2
13025,Brantley County,2021-01-13,26,259,1.4
13025,Brantley County,2021-01-14,24,283,1.5
13025,Brantley County,2021-01-15,55,338,1.8
13025,Brantley County,2021-01-16,36,374,2
13025,Brantley County,2021-01-17,3,377,2
13025,Brantley County,2021-01-18,32,409,2.2
13025,Brantley County,2021-01-19,28,437,2.3
13025,Brantley County,2021-01-20,46,483,2.6
13025,Brantley County,2021-01-21,22,505,2.7
13025,Brantley County,2021-01-22,36,541,2.9
13025,Brantley County,2021-01-23,17,558,3
13025,Brantley County,2021-01-24,1,559,3
13025,Brantley County,2021-01-25,28,587,3.1
13025,Brantley County,2021-01-26,27,614,3.3
13025,Brantley County,2021-01-27,24,638,3.4
13025,Brantley County,2021-01-28,30,668,3.6
13025,Brantley County,2021-01-29,48,716,3.8
13025,Brantley County,2021-01-30,26,742,4
13025,Brantley County,2021-02-01,49,791,4.2
13025,Brantley County,2021-02-02,18,809,4.3
13025,Brantley County,2021-02-03,41,850,4.5
13025,Brantley County,2021-02-04,22,872,4.6
13025,Brantley County,2021-02-05,28,900,4.8
13025,Brantley County,2021-02-07,1,901,4.8
13025,Brantley County,2021-02-08,30,931,5
13025,Brantley County,2021-02-09,4,935,5
13025,Brantley County,2021-02-10,23,958,5.1
13025,Brantley County,2021-02-11,19,977,5.2
13025,Brantley County,2021-02-12,24,1001,5.3
13025,Brantley County,2021-02-13,24,1025,5.5
13025,Brantley County,2021-02-15,45,1070,5.7
13025,Brantley County,2021-02-16,19,1089,5.8
13025,Brantley County,2021-02-17,68,1157,6.2
13025,Brantley County,2021-02-18,7,1164,6.2
13025,Brantley County,2021-02-19,55,1219,6.5
13025,Brantley County,2021-02-20,25,1244,6.6
13025,Brantley County,2021-02-22,33,1277,6.8
13025,Brantley County,2021-02-23,7,1284,6.8
13025,Brantley County,2021-02-24,39,1323,7.1
13025,Brantley County,2021-02-25,21,1344,7.2
13025,Brantley County,2021-02-26,21,1365,7.3
13025,Brantley County,2021-02-27,17,1382,7.4
13025,Brantley County,2021-03-01,10,1392,7.4
13025,Brantley County,2021-03-02,11,1403,7.5
13025,Brantley County,2021-03-03,52,1455,7.8
13025,Brantley County,2021-03-04,13,1468,7.8
13025,Brantley County,2021-03-05,27,1495,8
13025,Brantley County,2021-03-06,13,1508,8
13025,Brantley County,2021-03-08,24,1532,8.2
13025,Brantley County,2021-03-09,10,1542,8.2
13025,Brantley County,2021-03-10,47,1589,8.5
13025,Brantley County,2021-03-11,35,1624,8.7
13025,Brantley County,2021-03-12,36,1660,8.9
13025,Brantley County,2021-03-13,13,1673,8.9
13025,Brantley County,2021-03-14,1,1674,8.9
13025,Brantley County,2021-03-15,25,1699,9.1
13025,Brantley County,2021-03-16,56,1755,9.4
13025,Brantley County,2021-03-17,94,1849,9.9
13025,Brantley County,2021-03-18,35,1884,10
13025,Brantley County,2021-03-19,53,1937,10.3
13025,Brantley County,2021-03-20,39,1976,10.5
13025,Brantley County,2021-03-21,2,1978,10.5
13025,Brantley County,2021-03-22,39,2017,10.8
13025,Brantley County,2021-03-23,34,2051,10.9
13025,Brantley County,2021-03-24,79,2130,11.4
13025,Brantley County,2021-03-25,72,2202,11.7
13025,Brantley County,2021-03-26,97,2299,12.3
13025,Brantley County,2021-03-27,37,2336,12.5
13025,Brantley County,2021-03-28,2,2338,12.5
13025,Brantley County,2021-03-29,30,2368,12.6
13025,Brantley County,2021-03-30,63,2431,13
13025,Brantley County,2021-03-31,100,2531,13.5
13025,Brantley County,2021-04-01,58,2589,13.8
13025,Brantley County,2021-04-02,34,2623,14
13025,Brantley County,2021-04-03,28,2651,14.1
13025,Brantley County,2021-04-04,1,2652,14.1
13025,Brantley County,2021-04-05,5,2657,14.2
13025,Brantley County,2021-04-06,43,2700,14.4
13025,Brantley County,2021-04-07,39,2739,14.6
13025,Brantley County,2021-04-08,39,2778,14.8
13025,Brantley County,2021-04-09,26,2804,14.9
13025,Brantley County,2021-04-10,24,2828,15.1
13025,Brantley County,2021-04-11,1,2829,15.1
13025,Brantley County,2021-04-12,8,2837,15.1
13025,Brantley County,2021-04-13,23,2860,15.2
13025,Brantley County,2021-04-14,25,2885,15.4
13025,Brantley County,2021-04-15,8,2893,15.4
13025,Brantley County,2021-04-16,18,2911,15.5
13025,Brantley County,2021-04-17,8,2919,15.6
13025,Brantley County,2021-04-19,5,2924,15.6
13025,Brantley County,2021-04-20,28,2952,15.7
13025,Brantley County,2021-04-21,40,2992,16
13025,Brantley County,2021-04-22,21,3013,16.1
13025,Brantley County,2021-04-23,16,3029,16.1
13025,Brantley County,2021-04-24,17,3046,16.2
13025,Brantley County,2021-04-25,1,3047,16.2
13025,Brantley County,2021-04-26,4,3051,16.3
13025,Brantley County,2021-04-27,8,3059,16.3
13025,Brantley County,2021-04-28,23,3082,16.4
13025,Brantley County,2021-04-29,5,3087,16.5
13025,Brantley County,2021-04-30,20,3107,16.6
13025,Brantley County,2021-05-01,12,3119,16.6
13025,Brantley County,2021-05-02,2,3121,16.6
13025,Brantley County,2021-05-03,9,3130,16.7
13025,Brantley County,2021-05-04,9,3139,16.7
13025,Brantley County,2021-05-05,20,3159,16.8
13025,Brantley County,2021-05-06,9,3168,16.9
13025,Brantley County,2021-05-07,13,3181,17
13025,Brantley County,2021-05-08,6,3187,17
13025,Brantley County,2021-05-10,7,3194,17
13025,Brantley County,2021-05-11,10,3204,17.1
13025,Brantley County,2021-05-12,21,3225,17.2
13025,Brantley County,2021-05-13,11,3236,17.3
13025,Brantley County,2021-05-14,13,3249,17.3
13025,Brantley County,2021-05-15,14,3263,17.4
13025,Brantley County,2021-05-16,3,3266,17.4
13025,Brantley County,2021-05-17,7,3273,17.5
13025,Brantley County,2021-05-18,10,3283,17.5
13025,Brantley County,2021-05-19,39,3322,17.7
13025,Brantley County,2021-05-20,8,3330,17.8
13025,Brantley County,2021-05-21,17,3347,17.8
13025,Brantley County,2021-05-22,5,3352,17.9
13025,Brantley County,2021-05-23,2,3354,17.9
13025,Brantley County,2021-05-24,7,3361,17.9
13025,Brantley County,2021-05-25,26,3387,18.1
13025,Brantley County,2021-05-26,26,3413,18.2
13025,Brantley County,2021-05-27,9,3422,18.2
13025,Brantley County,2021-05-28,4,3426,18.3
13025,Brantley County,2021-05-29,13,3439,18.3
13025,Brantley County,2021-05-31,1,3440,18.3
13025,Brantley County,2021-06-01,3,3443,18.4
13025,Brantley County,2021-06-02,16,3459,18.4
13025,Brantley County,2021-06-03,9,3468,18.5
13025,Brantley County,2021-06-04,9,3477,18.5
13025,Brantley County,2021-06-05,4,3481,18.6
13025,Brantley County,2021-06-07,2,3483,18.6
13025,Brantley County,2021-06-08,6,3489,18.6
13025,Brantley County,2021-06-09,12,3501,18.7
13025,Brantley County,2021-06-10,7,3508,18.7
13025,Brantley County,2021-06-11,3,3511,18.7
13025,Brantley County,2021-06-12,3,3514,18.7
13025,Brantley County,2021-06-13,1,3515,18.7
13025,Brantley County,2021-06-14,2,3517,18.8
13025,Brantley County,2021-06-15,4,3521,18.8
13025,Brantley County,2021-06-16,6,3527,18.8
13025,Brantley County,2021-06-17,7,3534,18.8
13025,Brantley County,2021-06-18,8,3542,18.9
13025,Brantley County,2021-06-19,3,3545,18.9
13025,Brantley County,2021-06-20,1,3546,18.9
13025,Brantley County,2021-06-21,3,3549,18.9
13025,Brantley County,2021-06-22,4,3553,18.9
13025,Brantley County,2021-06-23,9,3562,19
13025,Brantley County,2021-06-24,3,3565,19
13025,Brantley County,2021-06-25,2,3567,19
13025,Brantley County,2021-06-26,2,3569,19
13025,Brantley County,2021-06-28,6,3575,19.1
13025,Brantley County,2021-06-29,2,3577,19.1
13025,Brantley County,2021-06-30,5,3582,19.1
13025,Brantley County,2021-07-01,2,3584,19.1
13025,Brantley County,2021-07-02,3,3587,19.1
13025,Brantley County,2021-07-03,1,3588,19.1
13025,Brantley County,2021-07-05,1,3589,19.1
13025,Brantley County,2021-07-06,7,3596,19.2
13025,Brantley County,2021-07-07,6,3602,19.2
13025,Brantley County,2021-07-08,1,3603,19.2
13025,Brantley County,2021-07-09,2,3605,19.2
13025,Brantley County,2021-07-10,1,3606,19.2
13025,Brantley County,2021-07-12,3,3609,19.2
13025,Brantley County,2021-07-13,5,3614,19.3
13025,Brantley County,2021-07-14,18,3632,19.4
13025,Brantley County,2021-07-15,5,3637,19.4
13025,Brantley County,2021-07-16,5,3642,19.4
13025,Brantley County,2021-07-17,2,3644,19.4
13025,Brantley County,2021-07-18,1,3645,19.4
13025,Brantley County,2021-07-19,9,3654,19.5
13025,Brantley County,2021-07-20,7,3661,19.5
13025,Brantley County,2021-07-21,30,3691,19.7
13025,Brantley County,2021-07-22,19,3710,19.8
13025,Brantley County,2021-07-23,19,3729,19.9
13025,Brantley County,2021-07-24,7,3736,19.9
13025,Brantley County,2021-07-25,3,3739,19.9
13025,Brantley County,2021-07-26,22,3761,20.1
13025,Brantley County,2021-07-27,31,3792,20.2
13025,Brantley County,2021-07-28,32,3824,20.4
13025,Brantley County,2021-07-29,30,3854,20.5
13025,Brantley County,2021-07-30,41,3895,20.8
13025,Brantley County,2021-07-31,19,3914,20.9
13025,Brantley County,2021-08-01,11,3925,20.9
13025,Brantley County,2021-08-02,28,3953,21.1
13025,Brantley County,2021-08-03,49,4002,21.3
13025,Brantley County,2021-08-04,41,4043,21.6
13025,Brantley County,2021-08-05,37,4080,21.8
13025,Brantley County,2021-08-06,51,4131,22
13025,Brantley County,2021-08-07,25,4156,22.2
13025,Brantley County,2021-08-08,14,4170,22.2
13025,Brantley County,2021-08-09,39,4209,22.4
13025,Brantley County,2021-08-10,37,4246,22.6
13025,Brantley County,2021-08-11,48,4294,22.9
13025,Brantley County,2021-08-12,54,4348,23.2
13025,Brantley County,2021-08-13,48,4396,23.4
13025,Brantley County,2021-08-14,17,4413,23.5
13025,Brantley County,2021-08-15,14,4427,23.6
13025,Brantley County,2021-08-16,26,4453,23.7
13025,Brantley County,2021-08-17,47,4500,24
13025,Brantley County,2021-08-18,39,4539,24.2
13025,Brantley County,2021-08-19,42,4581,24.4
13025,Brantley County,2021-08-20,53,4634,24.7
13025,Brantley County,2021-08-21,18,4652,24.8
13025,Brantley County,2021-08-22,8,4660,24.8
13025,Brantley County,2021-08-23,32,4692,25
13025,Brantley County,2021-08-24,41,4733,25.2
13025,Brantley County,2021-08-25,28,4761,25.4
13025,Brantley County,2021-08-26,40,4801,25.6
13025,Brantley County,2021-08-27,43,4844,25.8
13025,Brantley County,2021-08-28,9,4853,25.9
13025,Brantley County,2021-08-29,5,4858,25.9
13025,Brantley County,2021-08-30,19,4877,26
13025,Brantley County,2021-08-31,25,4902,26.1
13025,Brantley County,2021-09-01,30,4932,26.3
13025,Brantley County,2021-09-02,38,4970,26.5
13025,Brantley County,2021-09-03,40,5010,26.7
13025,Brantley County,2021-09-04,5,5015,26.7
13025,Brantley County,2021-09-05,7,5022,26.8
13025,Brantley County,2021-09-06,9,5031,26.8
13025,Brantley County,2021-09-07,38,5069,27
13025,Brantley County,2021-09-08,13,5082,27.1
13025,Brantley County,2021-09-09,22,5104,27.2
13025,Brantley County,2021-09-10,26,5130,27.4
13025,Brantley County,2021-09-11,7,5137,27.4
13025,Brantley County,2021-09-12,10,5147,27.4
13025,Brantley County,2021-09-13,22,5169,27.6
13025,Brantley County,2021-09-14,21,5190,27.7
13025,Brantley County,2021-09-15,17,5207,27.8
13025,Brantley County,2021-09-16,9,5216,27.8
13025,Brantley County,2021-09-17,28,5244,28
13025,Brantley County,2021-09-18,6,5250,28
13025,Brantley County,2021-09-19,3,5253,28
13025,Brantley County,2021-09-20,16,5269,28.1
13025,Brantley County,2021-09-21,15,5284,28.2
13025,Brantley County,2021-09-22,4,5288,28.2
13025,Brantley County,2021-09-23,10,5298,28.2
13025,Brantley County,2021-09-24,6,5304,28.3
13025,Brantley County,2021-09-27,3,5307,28.3
13025,Brantley County,2021-09-28,8,5315,28.3
13025,Brantley County,2021-09-29,8,5323,28.4
13025,Brantley County,2021-09-30,4,5327,28.4
13025,Brantley County,2021-10-01,3,5330,28.4
13025,Brantley County,2021-10-02,2,5332,28.4
13025,Brantley County,2021-10-04,4,5336,28.4
13025,Brantley County,2021-10-05,9,5345,28.5
13025,Brantley County,2021-10-06,2,5347,28.5
13025,Brantley County,2021-10-07,2,5349,28.5
13027,Brooks County,2020-12-16,1,1,0
13027,Brooks County,2020-12-17,1,2,0
13027,Brooks County,2020-12-18,5,7,0
13027,Brooks County,2020-12-19,3,10,0.1
13027,Brooks County,2020-12-21,15,25,0.2
13027,Brooks County,2020-12-22,25,50,0.3
13027,Brooks County,2020-12-23,19,69,0.4
13027,Brooks County,2020-12-24,1,70,0.4
13027,Brooks County,2020-12-26,1,71,0.5
13027,Brooks County,2020-12-28,18,89,0.6
13027,Brooks County,2020-12-29,14,103,0.7
13027,Brooks County,2020-12-30,22,125,0.8
13027,Brooks County,2020-12-31,21,146,0.9
13027,Brooks County,2021-01-01,6,152,1
13027,Brooks County,2021-01-04,28,180,1.2
13027,Brooks County,2021-01-05,28,208,1.3
13027,Brooks County,2021-01-06,26,234,1.5
13027,Brooks County,2021-01-07,12,246,1.6
13027,Brooks County,2021-01-08,13,259,1.7
13027,Brooks County,2021-01-11,58,317,2
13027,Brooks County,2021-01-12,56,373,2.4
13027,Brooks County,2021-01-13,95,468,3
13027,Brooks County,2021-01-14,129,597,3.8
13027,Brooks County,2021-01-15,79,676,4.3
13027,Brooks County,2021-01-16,2,678,4.3
13027,Brooks County,2021-01-17,1,679,4.4
13027,Brooks County,2021-01-18,38,717,4.6
13027,Brooks County,2021-01-19,175,892,5.7
13027,Brooks County,2021-01-20,144,1036,6.6
13027,Brooks County,2021-01-21,98,1134,7.3
13027,Brooks County,2021-01-22,82,1216,7.8
13027,Brooks County,2021-01-23,2,1218,7.8
13027,Brooks County,2021-01-25,67,1285,8.2
13027,Brooks County,2021-01-26,54,1339,8.6
13027,Brooks County,2021-01-27,63,1402,9
13027,Brooks County,2021-01-28,32,1434,9.2
13027,Brooks County,2021-01-29,76,1510,9.7
13027,Brooks County,2021-02-01,46,1556,10
13027,Brooks County,2021-02-02,94,1650,10.6
13027,Brooks County,2021-02-03,105,1755,11.3
13027,Brooks County,2021-02-04,99,1854,11.9
13027,Brooks County,2021-02-05,47,1901,12.2
13027,Brooks County,2021-02-08,23,1924,12.3
13027,Brooks County,2021-02-09,30,1954,12.5
13027,Brooks County,2021-02-10,30,1984,12.7
13027,Brooks County,2021-02-11,53,2037,13.1
13027,Brooks County,2021-02-12,85,2122,13.6
13027,Brooks County,2021-02-13,18,2140,13.7
13027,Brooks County,2021-02-14,1,2141,13.7
13027,Brooks County,2021-02-15,34,2175,14
13027,Brooks County,2021-02-16,11,2186,14
13027,Brooks County,2021-02-17,72,2258,14.5
13027,Brooks County,2021-02-18,72,2330,14.9
13027,Brooks County,2021-02-19,22,2352,15.1
13027,Brooks County,2021-02-20,1,2353,15.1
13027,Brooks County,2021-02-21,1,2354,15.1
13027,Brooks County,2021-02-22,34,2388,15.3
13027,Brooks County,2021-02-23,23,2411,15.5
13027,Brooks County,2021-02-24,53,2464,15.8
13027,Brooks County,2021-02-25,73,2537,16.3
13027,Brooks County,2021-02-26,30,2567,16.5
13027,Brooks County,2021-03-01,34,2601,16.7
13027,Brooks County,2021-03-02,31,2632,16.9
13027,Brooks County,2021-03-03,42,2674,17.2
13027,Brooks County,2021-03-04,30,2704,17.3
13027,Brooks County,2021-03-05,32,2736,17.5
13027,Brooks County,2021-03-06,2,2738,17.6
13027,Brooks County,2021-03-07,5,2743,17.6
13027,Brooks County,2021-03-08,26,2769,17.8
13027,Brooks County,2021-03-09,113,2882,18.5
13027,Brooks County,2021-03-10,31,2913,18.7
13027,Brooks County,2021-03-11,40,2953,18.9
13027,Brooks County,2021-03-12,54,3007,19.3
13027,Brooks County,2021-03-13,11,3018,19.4
13027,Brooks County,2021-03-14,3,3021,19.4
13027,Brooks County,2021-03-15,45,3066,19.7
13027,Brooks County,2021-03-16,91,3157,20.3
13027,Brooks County,2021-03-17,50,3207,20.6
13027,Brooks County,2021-03-18,39,3246,20.8
13027,Brooks County,2021-03-19,88,3334,21.4
13027,Brooks County,2021-03-20,20,3354,21.5
13027,Brooks County,2021-03-21,4,3358,21.5
13027,Brooks County,2021-03-22,83,3441,22.1
13027,Brooks County,2021-03-23,56,3497,22.4
13027,Brooks County,2021-03-24,80,3577,22.9
13027,Brooks County,2021-03-25,74,3651,23.4
13027,Brooks County,2021-03-26,91,3742,24
13027,Brooks County,2021-03-27,5,3747,24
13027,Brooks County,2021-03-28,4,3751,24.1
13027,Brooks County,2021-03-29,75,3826,24.5
13027,Brooks County,2021-03-30,75,3901,25
13027,Brooks County,2021-03-31,75,3976,25.5
13027,Brooks County,2021-04-01,62,4038,25.9
13027,Brooks County,2021-04-02,48,4086,26.2
13027,Brooks County,2021-04-03,10,4096,26.3
13027,Brooks County,2021-04-04,3,4099,26.3
13027,Brooks County,2021-04-05,70,4169,26.7
13027,Brooks County,2021-04-06,56,4225,27.1
13027,Brooks County,2021-04-07,54,4279,27.4
13027,Brooks County,2021-04-08,43,4322,27.7
13027,Brooks County,2021-04-09,40,4362,28
13027,Brooks County,2021-04-10,8,4370,28
13027,Brooks County,2021-04-11,8,4378,28.1
13027,Brooks County,2021-04-12,38,4416,28.3
13027,Brooks County,2021-04-13,41,4457,28.6
13027,Brooks County,2021-04-14,28,4485,28.8
13027,Brooks County,2021-04-15,22,4507,28.9
13027,Brooks County,2021-04-16,20,4527,29
13027,Brooks County,2021-04-17,3,4530,29.1
13027,Brooks County,2021-04-18,1,4531,29.1
13027,Brooks County,2021-04-19,11,4542,29.1
13027,Brooks County,2021-04-20,18,4560,29.2
13027,Brooks County,2021-04-21,39,4599,29.5
13027,Brooks County,2021-04-22,34,4633,29.7
13027,Brooks County,2021-04-23,30,4663,29.9
13027,Brooks County,2021-04-24,4,4667,29.9
13027,Brooks County,2021-04-25,1,4668,29.9
13027,Brooks County,2021-04-26,15,4683,30
13027,Brooks County,2021-04-27,22,4705,30.2
13027,Brooks County,2021-04-28,17,4722,30.3
13027,Brooks County,2021-04-29,12,4734,30.4
13027,Brooks County,2021-04-30,24,4758,30.5
13027,Brooks County,2021-05-01,4,4762,30.5
13027,Brooks County,2021-05-02,1,4763,30.6
13027,Brooks County,2021-05-03,19,4782,30.7
13027,Brooks County,2021-05-04,11,4793,30.7
13027,Brooks County,2021-05-05,17,4810,30.9
13027,Brooks County,2021-05-06,23,4833,31
13027,Brooks County,2021-05-07,17,4850,31.1
13027,Brooks County,2021-05-08,5,4855,31.1
13027,Brooks County,2021-05-09,4,4859,31.2
13027,Brooks County,2021-05-10,11,4870,31.2
13027,Brooks County,2021-05-11,13,4883,31.3
13027,Brooks County,2021-05-12,18,4901,31.4
13027,Brooks County,2021-05-13,15,4916,31.5
13027,Brooks County,2021-05-14,18,4934,31.6
13027,Brooks County,2021-05-15,11,4945,31.7
13027,Brooks County,2021-05-16,7,4952,31.8
13027,Brooks County,2021-05-17,14,4966,31.9
13027,Brooks County,2021-05-18,22,4988,32
13027,Brooks County,2021-05-19,16,5004,32.1
13027,Brooks County,2021-05-20,23,5027,32.2
13027,Brooks County,2021-05-21,20,5047,32.4
13027,Brooks County,2021-05-22,8,5055,32.4
13027,Brooks County,2021-05-23,3,5058,32.4
13027,Brooks County,2021-05-24,14,5072,32.5
13027,Brooks County,2021-05-25,16,5088,32.6
13027,Brooks County,2021-05-26,16,5104,32.7
13027,Brooks County,2021-05-27,20,5124,32.9
13027,Brooks County,2021-05-28,8,5132,32.9
13027,Brooks County,2021-05-29,3,5135,32.9
13027,Brooks County,2021-05-30,3,5138,33
13027,Brooks County,2021-05-31,1,5139,33
13027,Brooks County,2021-06-01,17,5156,33.1
13027,Brooks County,2021-06-02,17,5173,33.2
13027,Brooks County,2021-06-03,16,5189,33.3
13027,Brooks County,2021-06-04,10,5199,33.3
13027,Brooks County,2021-06-05,6,5205,33.4
13027,Brooks County,2021-06-06,1,5206,33.4
13027,Brooks County,2021-06-07,11,5217,33.5
13027,Brooks County,2021-06-08,11,5228,33.5
13027,Brooks County,2021-06-09,7,5235,33.6
13027,Brooks County,2021-06-10,18,5253,33.7
13027,Brooks County,2021-06-11,7,5260,33.7
13027,Brooks County,2021-06-12,9,5269,33.8
13027,Brooks County,2021-06-13,1,5270,33.8
13027,Brooks County,2021-06-14,6,5276,33.8
13027,Brooks County,2021-06-15,6,5282,33.9
13027,Brooks County,2021-06-16,10,5292,33.9
13027,Brooks County,2021-06-17,16,5308,34
13027,Brooks County,2021-06-18,10,5318,34.1
13027,Brooks County,2021-06-19,1,5319,34.1
13027,Brooks County,2021-06-20,2,5321,34.1
13027,Brooks County,2021-06-21,6,5327,34.2
13027,Brooks County,2021-06-22,12,5339,34.2
13027,Brooks County,2021-06-23,11,5350,34.3
13027,Brooks County,2021-06-24,4,5354,34.3
13027,Brooks County,2021-06-25,7,5361,34.4
13027,Brooks County,2021-06-26,8,5369,34.4
13027,Brooks County,2021-06-27,6,5375,34.5
13027,Brooks County,2021-06-28,15,5390,34.6
13027,Brooks County,2021-06-29,10,5400,34.6
13027,Brooks County,2021-06-30,6,5406,34.7
13027,Brooks County,2021-07-01,8,5414,34.7
13027,Brooks County,2021-07-02,10,5424,34.8
13027,Brooks County,2021-07-03,6,5430,34.8
13027,Brooks County,2021-07-05,6,5436,34.9
13027,Brooks County,2021-07-06,5,5441,34.9
13027,Brooks County,2021-07-07,9,5450,35
13027,Brooks County,2021-07-08,10,5460,35
13027,Brooks County,2021-07-09,10,5470,35.1
13027,Brooks County,2021-07-10,6,5476,35.1
13027,Brooks County,2021-07-11,3,5479,35.1
13027,Brooks County,2021-07-12,12,5491,35.2
13027,Brooks County,2021-07-13,7,5498,35.3
13027,Brooks County,2021-07-14,12,5510,35.3
13027,Brooks County,2021-07-15,5,5515,35.4
13027,Brooks County,2021-07-16,8,5523,35.4
13027,Brooks County,2021-07-17,3,5526,35.4
13027,Brooks County,2021-07-18,2,5528,35.5
13027,Brooks County,2021-07-19,15,5543,35.6
13027,Brooks County,2021-07-20,12,5555,35.6
13027,Brooks County,2021-07-21,22,5577,35.8
13027,Brooks County,2021-07-22,36,5613,36
13027,Brooks County,2021-07-23,23,5636,36.2
13027,Brooks County,2021-07-24,10,5646,36.2
13027,Brooks County,2021-07-25,3,5649,36.2
13027,Brooks County,2021-07-26,44,5693,36.5
13027,Brooks County,2021-07-27,24,5717,36.7
13027,Brooks County,2021-07-28,49,5766,37
13027,Brooks County,2021-07-29,63,5829,37.4
13027,Brooks County,2021-07-30,51,5880,37.7
13027,Brooks County,2021-07-31,11,5891,37.8
13027,Brooks County,2021-08-01,12,5903,37.9
13027,Brooks County,2021-08-02,67,5970,38.3
13027,Brooks County,2021-08-03,37,6007,38.5
13027,Brooks County,2021-08-04,48,6055,38.8
13027,Brooks County,2021-08-05,40,6095,39.1
13027,Brooks County,2021-08-06,61,6156,39.5
13027,Brooks County,2021-08-07,40,6196,39.7
13027,Brooks County,2021-08-08,8,6204,39.8
13027,Brooks County,2021-08-09,59,6263,40.2
13027,Brooks County,2021-08-10,49,6312,40.5
13027,Brooks County,2021-08-11,46,6358,40.8
13027,Brooks County,2021-08-12,37,6395,41
13027,Brooks County,2021-08-13,45,6440,41.3
13027,Brooks County,2021-08-14,26,6466,41.5
13027,Brooks County,2021-08-15,8,6474,41.5
13027,Brooks County,2021-08-16,35,6509,41.8
13027,Brooks County,2021-08-17,28,6537,41.9
13027,Brooks County,2021-08-18,62,6599,42.3
13027,Brooks County,2021-08-19,30,6629,42.5
13027,Brooks County,2021-08-20,54,6683,42.9
13027,Brooks County,2021-08-21,20,6703,43
13027,Brooks County,2021-08-22,12,6715,43.1
13027,Brooks County,2021-08-23,27,6742,43.2
13027,Brooks County,2021-08-24,27,6769,43.4
13027,Brooks County,2021-08-25,55,6824,43.8
13027,Brooks County,2021-08-26,21,6845,43.9
13027,Brooks County,2021-08-27,35,6880,44.1
13027,Brooks County,2021-08-28,38,6918,44.4
13027,Brooks County,2021-08-29,4,6922,44.4
13027,Brooks County,2021-08-30,26,6948,44.6
13027,Brooks County,2021-08-31,34,6982,44.8
13027,Brooks County,2021-09-01,34,7016,45
13027,Brooks County,2021-09-02,16,7032,45.1
13027,Brooks County,2021-09-03,28,7060,45.3
13027,Brooks County,2021-09-04,15,7075,45.4
13027,Brooks County,2021-09-05,7,7082,45.4
13027,Brooks County,2021-09-06,1,7083,45.4
13027,Brooks County,2021-09-07,16,7099,45.5
13027,Brooks County,2021-09-08,13,7112,45.6
13027,Brooks County,2021-09-09,31,7143,45.8
13027,Brooks County,2021-09-10,36,7179,46
13027,Brooks County,2021-09-11,9,7188,46.1
13027,Brooks County,2021-09-12,4,7192,46.1
13027,Brooks County,2021-09-13,29,7221,46.3
13027,Brooks County,2021-09-14,18,7239,46.4
13027,Brooks County,2021-09-15,24,7263,46.6
13027,Brooks County,2021-09-16,19,7282,46.7
13027,Brooks County,2021-09-17,25,7307,46.9
13027,Brooks County,2021-09-18,7,7314,46.9
13027,Brooks County,2021-09-20,7,7321,47
13027,Brooks County,2021-09-21,12,7333,47
13027,Brooks County,2021-09-22,10,7343,47.1
13027,Brooks County,2021-09-23,11,7354,47.2
13027,Brooks County,2021-09-24,10,7364,47.2
13027,Brooks County,2021-09-25,2,7366,47.2
13027,Brooks County,2021-09-27,5,7371,47.3
13027,Brooks County,2021-09-28,6,7377,47.3
13027,Brooks County,2021-09-29,3,7380,47.3
13027,Brooks County,2021-09-30,8,7388,47.4
13027,Brooks County,2021-10-01,5,7393,47.4
13027,Brooks County,2021-10-02,2,7395,47.4
13027,Brooks County,2021-10-04,3,7398,47.5
13027,Brooks County,2021-10-05,4,7402,47.5
13027,Brooks County,2021-10-06,4,7406,47.5
13027,Brooks County,2021-10-07,2,7408,47.5
13029,Bryan County,2020-12-15,5,5,0
13029,Bryan County,2020-12-16,51,56,0.2
13029,Bryan County,2020-12-17,12,68,0.2
13029,Bryan County,2020-12-18,104,172,0.5
13029,Bryan County,2020-12-19,9,181,0.5
13029,Bryan County,2020-12-20,3,184,0.5
13029,Bryan County,2020-12-21,45,229,0.6
13029,Bryan County,2020-12-22,60,289,0.8
13029,Bryan County,2020-12-23,46,335,0.9
13029,Bryan County,2020-12-24,8,343,0.9
13029,Bryan County,2020-12-26,1,344,0.9
13029,Bryan County,2020-12-27,1,345,0.9
13029,Bryan County,2020-12-28,39,384,1
13029,Bryan County,2020-12-29,76,460,1.2
13029,Bryan County,2020-12-30,59,519,1.4
13029,Bryan County,2020-12-31,35,554,1.5
13029,Bryan County,2021-01-01,4,558,1.5
13029,Bryan County,2021-01-02,10,568,1.5
13029,Bryan County,2021-01-04,24,592,1.6
13029,Bryan County,2021-01-05,44,636,1.7
13029,Bryan County,2021-01-06,79,715,1.9
13029,Bryan County,2021-01-07,55,770,2.1
13029,Bryan County,2021-01-08,66,836,2.3
13029,Bryan County,2021-01-09,38,874,2.4
13029,Bryan County,2021-01-10,7,881,2.4
13029,Bryan County,2021-01-11,81,962,2.6
13029,Bryan County,2021-01-12,63,1025,2.8
13029,Bryan County,2021-01-13,78,1103,3
13029,Bryan County,2021-01-14,267,1370,3.7
13029,Bryan County,2021-01-15,95,1465,4
13029,Bryan County,2021-01-16,140,1605,4.3
13029,Bryan County,2021-01-17,33,1638,4.4
13029,Bryan County,2021-01-18,161,1799,4.9
13029,Bryan County,2021-01-19,99,1898,5.1
13029,Bryan County,2021-01-20,124,2022,5.5
13029,Bryan County,2021-01-21,294,2316,6.2
13029,Bryan County,2021-01-22,100,2416,6.5
13029,Bryan County,2021-01-23,79,2495,6.7
13029,Bryan County,2021-01-24,50,2545,6.9
13029,Bryan County,2021-01-25,186,2731,7.4
13029,Bryan County,2021-01-26,64,2795,7.5
13029,Bryan County,2021-01-27,66,2861,7.7
13029,Bryan County,2021-01-28,243,3104,8.4
13029,Bryan County,2021-01-29,129,3233,8.7
13029,Bryan County,2021-01-30,275,3508,9.5
13029,Bryan County,2021-01-31,25,3533,9.5
13029,Bryan County,2021-02-01,185,3718,10
13029,Bryan County,2021-02-02,219,3937,10.6
13029,Bryan County,2021-02-03,72,4009,10.8
13029,Bryan County,2021-02-04,130,4139,11.2
13029,Bryan County,2021-02-05,66,4205,11.3
13029,Bryan County,2021-02-06,48,4253,11.5
13029,Bryan County,2021-02-07,7,4260,11.5
13029,Bryan County,2021-02-08,65,4325,11.7
13029,Bryan County,2021-02-09,140,4465,12
13029,Bryan County,2021-02-10,31,4496,12.1
13029,Bryan County,2021-02-11,34,4530,12.2
13029,Bryan County,2021-02-12,52,4582,12.4
13029,Bryan County,2021-02-13,29,4611,12.4
13029,Bryan County,2021-02-14,6,4617,12.5
13029,Bryan County,2021-02-15,66,4683,12.6
13029,Bryan County,2021-02-16,91,4774,12.9
13029,Bryan County,2021-02-17,31,4805,13
13029,Bryan County,2021-02-18,50,4855,13.1
13029,Bryan County,2021-02-19,66,4921,13.3
13029,Bryan County,2021-02-20,14,4935,13.3
13029,Bryan County,2021-02-21,5,4940,13.3
13029,Bryan County,2021-02-22,34,4974,13.4
13029,Bryan County,2021-02-23,151,5125,13.8
13029,Bryan County,2021-02-24,53,5178,14
13029,Bryan County,2021-02-25,85,5263,14.2
13029,Bryan County,2021-02-26,34,5297,14.3
13029,Bryan County,2021-02-27,34,5331,14.4
13029,Bryan County,2021-02-28,20,5351,14.4
13029,Bryan County,2021-03-01,152,5503,14.8
13029,Bryan County,2021-03-02,152,5655,15.3
13029,Bryan County,2021-03-03,51,5706,15.4
13029,Bryan County,2021-03-04,62,5768,15.6
13029,Bryan County,2021-03-05,51,5819,15.7
13029,Bryan County,2021-03-06,18,5837,15.7
13029,Bryan County,2021-03-07,31,5868,15.8
13029,Bryan County,2021-03-08,173,6041,16.3
13029,Bryan County,2021-03-09,159,6200,16.7
13029,Bryan County,2021-03-10,106,6306,17
13029,Bryan County,2021-03-11,112,6418,17.3
13029,Bryan County,2021-03-12,158,6576,17.7
13029,Bryan County,2021-03-13,273,6849,18.5
13029,Bryan County,2021-03-14,42,6891,18.6
13029,Bryan County,2021-03-15,246,7137,19.3
13029,Bryan County,2021-03-16,273,7410,20
13029,Bryan County,2021-03-17,153,7563,20.4
13029,Bryan County,2021-03-18,159,7722,20.8
13029,Bryan County,2021-03-19,256,7978,21.5
13029,Bryan County,2021-03-20,164,8142,22
13029,Bryan County,2021-03-21,31,8173,22.1
13029,Bryan County,2021-03-22,244,8417,22.7
13029,Bryan County,2021-03-23,283,8700,23.5
13029,Bryan County,2021-03-24,240,8940,24.1
13029,Bryan County,2021-03-25,291,9231,24.9
13029,Bryan County,2021-03-26,208,9439,25.5
13029,Bryan County,2021-03-27,145,9584,25.9
13029,Bryan County,2021-03-28,66,9650,26
13029,Bryan County,2021-03-29,248,9898,26.7
13029,Bryan County,2021-03-30,360,10258,27.7
13029,Bryan County,2021-03-31,186,10444,28.2
13029,Bryan County,2021-04-01,210,10654,28.7
13029,Bryan County,2021-04-02,219,10873,29.3
13029,Bryan County,2021-04-03,77,10950,29.5
13029,Bryan County,2021-04-04,32,10982,29.6
13029,Bryan County,2021-04-05,162,11144,30.1
13029,Bryan County,2021-04-06,180,11324,30.6
13029,Bryan County,2021-04-07,146,11470,30.9
13029,Bryan County,2021-04-08,159,11629,31.4
13029,Bryan County,2021-04-09,109,11738,31.7
13029,Bryan County,2021-04-10,84,11822,31.9
13029,Bryan County,2021-04-11,24,11846,32
13029,Bryan County,2021-04-12,136,11982,32.3
13029,Bryan County,2021-04-13,135,12117,32.7
13029,Bryan County,2021-04-14,68,12185,32.9
13029,Bryan County,2021-04-15,113,12298,33.2
13029,Bryan County,2021-04-16,68,12366,33.4
13029,Bryan County,2021-04-17,39,12405,33.5
13029,Bryan County,2021-04-18,4,12409,33.5
13029,Bryan County,2021-04-19,83,12492,33.7
13029,Bryan County,2021-04-20,64,12556,33.9
13029,Bryan County,2021-04-21,66,12622,34.1
13029,Bryan County,2021-04-22,56,12678,34.2
13029,Bryan County,2021-04-23,75,12753,34.4
13029,Bryan County,2021-04-24,23,12776,34.5
13029,Bryan County,2021-04-25,11,12787,34.5
13029,Bryan County,2021-04-26,72,12859,34.7
13029,Bryan County,2021-04-27,43,12902,34.8
13029,Bryan County,2021-04-28,67,12969,35
13029,Bryan County,2021-04-29,49,13018,35.1
13029,Bryan County,2021-04-30,62,13080,35.3
13029,Bryan County,2021-05-01,41,13121,35.4
13029,Bryan County,2021-05-02,13,13134,35.4
13029,Bryan County,2021-05-03,66,13200,35.6
13029,Bryan County,2021-05-04,49,13249,35.7
13029,Bryan County,2021-05-05,50,13299,35.9
13029,Bryan County,2021-05-06,65,13364,36.1
13029,Bryan County,2021-05-07,41,13405,36.2
13029,Bryan County,2021-05-08,29,13434,36.2
13029,Bryan County,2021-05-09,7,13441,36.3
13029,Bryan County,2021-05-10,39,13480,36.4
13029,Bryan County,2021-05-11,43,13523,36.5
13029,Bryan County,2021-05-12,40,13563,36.6
13029,Bryan County,2021-05-13,66,13629,36.8
13029,Bryan County,2021-05-14,78,13707,37
13029,Bryan County,2021-05-15,58,13765,37.1
13029,Bryan County,2021-05-16,39,13804,37.2
13029,Bryan County,2021-05-17,100,13904,37.5
13029,Bryan County,2021-05-18,64,13968,37.7
13029,Bryan County,2021-05-19,60,14028,37.8
13029,Bryan County,2021-05-20,66,14094,38
13029,Bryan County,2021-05-21,81,14175,38.2
13029,Bryan County,2021-05-22,50,14225,38.4
13029,Bryan County,2021-05-23,31,14256,38.5
13029,Bryan County,2021-05-24,50,14306,38.6
13029,Bryan County,2021-05-25,48,14354,38.7
13029,Bryan County,2021-05-26,48,14402,38.9
13029,Bryan County,2021-05-27,61,14463,39
13029,Bryan County,2021-05-28,51,14514,39.2
13029,Bryan County,2021-05-29,30,14544,39.2
13029,Bryan County,2021-05-30,12,14556,39.3
13029,Bryan County,2021-05-31,4,14560,39.3
13029,Bryan County,2021-06-01,36,14596,39.4
13029,Bryan County,2021-06-02,52,14648,39.5
13029,Bryan County,2021-06-03,38,14686,39.6
13029,Bryan County,2021-06-04,37,14723,39.7
13029,Bryan County,2021-06-05,26,14749,39.8
13029,Bryan County,2021-06-06,12,14761,39.8
13029,Bryan County,2021-06-07,48,14809,40
13029,Bryan County,2021-06-08,32,14841,40
13029,Bryan County,2021-06-09,22,14863,40.1
13029,Bryan County,2021-06-10,34,14897,40.2
13029,Bryan County,2021-06-11,40,14937,40.3
13029,Bryan County,2021-06-12,15,14952,40.3
13029,Bryan County,2021-06-13,10,14962,40.4
13029,Bryan County,2021-06-14,26,14988,40.4
13029,Bryan County,2021-06-15,27,15015,40.5
13029,Bryan County,2021-06-16,25,15040,40.6
13029,Bryan County,2021-06-17,41,15081,40.7
13029,Bryan County,2021-06-18,41,15122,40.8
13029,Bryan County,2021-06-19,15,15137,40.8
13029,Bryan County,2021-06-20,6,15143,40.9
13029,Bryan County,2021-06-21,29,15172,40.9
13029,Bryan County,2021-06-22,12,15184,41
13029,Bryan County,2021-06-23,31,15215,41.1
13029,Bryan County,2021-06-24,23,15238,41.1
13029,Bryan County,2021-06-25,40,15278,41.2
13029,Bryan County,2021-06-26,8,15286,41.2
13029,Bryan County,2021-06-27,6,15292,41.3
13029,Bryan County,2021-06-28,13,15305,41.3
13029,Bryan County,2021-06-29,23,15328,41.4
13029,Bryan County,2021-06-30,28,15356,41.4
13029,Bryan County,2021-07-01,28,15384,41.5
13029,Bryan County,2021-07-02,28,15412,41.6
13029,Bryan County,2021-07-03,16,15428,41.6
13029,Bryan County,2021-07-04,2,15430,41.6
13029,Bryan County,2021-07-05,14,15444,41.7
13029,Bryan County,2021-07-06,19,15463,41.7
13029,Bryan County,2021-07-07,31,15494,41.8
13029,Bryan County,2021-07-08,19,15513,41.9
13029,Bryan County,2021-07-09,40,15553,42
13029,Bryan County,2021-07-10,13,15566,42
13029,Bryan County,2021-07-11,10,15576,42
13029,Bryan County,2021-07-12,23,15599,42.1
13029,Bryan County,2021-07-13,23,15622,42.1
13029,Bryan County,2021-07-14,27,15649,42.2
13029,Bryan County,2021-07-15,38,15687,42.3
13029,Bryan County,2021-07-16,46,15733,42.4
13029,Bryan County,2021-07-17,22,15755,42.5
13029,Bryan County,2021-07-18,4,15759,42.5
13029,Bryan County,2021-07-19,25,15784,42.6
13029,Bryan County,2021-07-20,32,15816,42.7
13029,Bryan County,2021-07-21,50,15866,42.8
13029,Bryan County,2021-07-22,40,15906,42.9
13029,Bryan County,2021-07-23,83,15989,43.1
13029,Bryan County,2021-07-24,33,16022,43.2
13029,Bryan County,2021-07-25,15,16037,43.3
13029,Bryan County,2021-07-26,75,16112,43.5
13029,Bryan County,2021-07-27,74,16186,43.7
13029,Bryan County,2021-07-28,73,16259,43.9
13029,Bryan County,2021-07-29,76,16335,44.1
13029,Bryan County,2021-07-30,109,16444,44.4
13029,Bryan County,2021-07-31,41,16485,44.5
13029,Bryan County,2021-08-01,28,16513,44.6
13029,Bryan County,2021-08-02,52,16565,44.7
13029,Bryan County,2021-08-03,56,16621,44.8
13029,Bryan County,2021-08-04,54,16675,45
13029,Bryan County,2021-08-05,74,16749,45.2
13029,Bryan County,2021-08-06,106,16855,45.5
13029,Bryan County,2021-08-07,37,16892,45.6
13029,Bryan County,2021-08-08,23,16915,45.6
13029,Bryan County,2021-08-09,60,16975,45.8
13029,Bryan County,2021-08-10,63,17038,46
13029,Bryan County,2021-08-11,83,17121,46.2
13029,Bryan County,2021-08-12,123,17244,46.5
13029,Bryan County,2021-08-13,133,17377,46.9
13029,Bryan County,2021-08-14,56,17433,47
13029,Bryan County,2021-08-15,34,17467,47.1
13029,Bryan County,2021-08-16,83,17550,47.4
13029,Bryan County,2021-08-17,86,17636,47.6
13029,Bryan County,2021-08-18,99,17735,47.9
13029,Bryan County,2021-08-19,111,17846,48.2
13029,Bryan County,2021-08-20,129,17975,48.5
13029,Bryan County,2021-08-21,67,18042,48.7
13029,Bryan County,2021-08-22,26,18068,48.7
13029,Bryan County,2021-08-23,64,18132,48.9
13029,Bryan County,2021-08-24,56,18188,49.1
13029,Bryan County,2021-08-25,69,18257,49.3
13029,Bryan County,2021-08-26,91,18348,49.5
13029,Bryan County,2021-08-27,93,18441,49.8
13029,Bryan County,2021-08-28,48,18489,49.9
13029,Bryan County,2021-08-29,25,18514,50
13029,Bryan County,2021-08-30,62,18576,50.1
13029,Bryan County,2021-08-31,66,18642,50.3
13029,Bryan County,2021-09-01,89,18731,50.5
13029,Bryan County,2021-09-02,73,18804,50.7
13029,Bryan County,2021-09-03,87,18891,51
13029,Bryan County,2021-09-04,27,18918,51
13029,Bryan County,2021-09-05,19,18937,51.1
13029,Bryan County,2021-09-06,13,18950,51.1
13029,Bryan County,2021-09-07,47,18997,51.3
13029,Bryan County,2021-09-08,46,19043,51.4
13029,Bryan County,2021-09-09,44,19087,51.5
13029,Bryan County,2021-09-10,56,19143,51.6
13029,Bryan County,2021-09-11,30,19173,51.7
13029,Bryan County,2021-09-12,17,19190,51.8
13029,Bryan County,2021-09-13,47,19237,51.9
13029,Bryan County,2021-09-14,36,19273,52
13029,Bryan County,2021-09-15,46,19319,52.1
13029,Bryan County,2021-09-16,47,19366,52.3
13029,Bryan County,2021-09-17,46,19412,52.4
13029,Bryan County,2021-09-18,26,19438,52.4
13029,Bryan County,2021-09-19,15,19453,52.5
13029,Bryan County,2021-09-20,37,19490,52.6
13029,Bryan County,2021-09-21,20,19510,52.6
13029,Bryan County,2021-09-22,32,19542,52.7
13029,Bryan County,2021-09-23,29,19571,52.8
13029,Bryan County,2021-09-24,14,19585,52.8
13029,Bryan County,2021-09-25,13,19598,52.9
13029,Bryan County,2021-09-26,4,19602,52.9
13029,Bryan County,2021-09-27,14,19616,52.9
13029,Bryan County,2021-09-28,19,19635,53
13029,Bryan County,2021-09-29,24,19659,53
13029,Bryan County,2021-09-30,13,19672,53.1
13029,Bryan County,2021-10-01,13,19685,53.1
13029,Bryan County,2021-10-02,8,19693,53.1
13029,Bryan County,2021-10-03,7,19700,53.2
13029,Bryan County,2021-10-04,9,19709,53.2
13029,Bryan County,2021-10-05,11,19720,53.2
13029,Bryan County,2021-10-06,8,19728,53.2
13029,Bryan County,2021-10-07,8,19736,53.2
13031,Bulloch County,2020-12-15,2,2,0
13031,Bulloch County,2020-12-16,6,8,0
13031,Bulloch County,2020-12-17,2,10,0
13031,Bulloch County,2020-12-18,25,35,0
13031,Bulloch County,2020-12-19,6,41,0.1
13031,Bulloch County,2020-12-20,1,42,0.1
13031,Bulloch County,2020-12-21,16,58,0.1
13031,Bulloch County,2020-12-22,19,77,0.1
13031,Bulloch County,2020-12-23,117,194,0.3
13031,Bulloch County,2020-12-24,61,255,0.3
13031,Bulloch County,2020-12-26,2,257,0.3
13031,Bulloch County,2020-12-27,13,270,0.4
13031,Bulloch County,2020-12-28,117,387,0.5
13031,Bulloch County,2020-12-29,72,459,0.6
13031,Bulloch County,2020-12-30,106,565,0.7
13031,Bulloch County,2020-12-31,80,645,0.8
13031,Bulloch County,2021-01-01,38,683,0.9
13031,Bulloch County,2021-01-02,3,686,0.9
13031,Bulloch County,2021-01-03,2,688,0.9
13031,Bulloch County,2021-01-04,100,788,1
13031,Bulloch County,2021-01-05,101,889,1.2
13031,Bulloch County,2021-01-06,127,1016,1.3
13031,Bulloch County,2021-01-07,203,1219,1.6
13031,Bulloch County,2021-01-08,148,1367,1.8
13031,Bulloch County,2021-01-09,16,1383,1.8
13031,Bulloch County,2021-01-10,18,1401,1.8
13031,Bulloch County,2021-01-11,241,1642,2.2
13031,Bulloch County,2021-01-12,329,1971,2.6
13031,Bulloch County,2021-01-13,206,2177,2.9
13031,Bulloch County,2021-01-14,260,2437,3.2
13031,Bulloch County,2021-01-15,334,2771,3.6
13031,Bulloch County,2021-01-16,131,2902,3.8
13031,Bulloch County,2021-01-17,10,2912,3.8
13031,Bulloch County,2021-01-18,217,3129,4.1
13031,Bulloch County,2021-01-19,393,3522,4.6
13031,Bulloch County,2021-01-20,154,3676,4.8
13031,Bulloch County,2021-01-21,296,3972,5.2
13031,Bulloch County,2021-01-22,284,4256,5.6
13031,Bulloch County,2021-01-23,180,4436,5.8
13031,Bulloch County,2021-01-24,1,4437,5.8
13031,Bulloch County,2021-01-25,202,4639,6.1
13031,Bulloch County,2021-01-26,300,4939,6.5
13031,Bulloch County,2021-01-27,155,5094,6.7
13031,Bulloch County,2021-01-28,151,5245,6.9
13031,Bulloch County,2021-01-29,284,5529,7.3
13031,Bulloch County,2021-01-30,71,5600,7.4
13031,Bulloch County,2021-01-31,4,5604,7.4
13031,Bulloch County,2021-02-01,255,5859,7.7
13031,Bulloch County,2021-02-02,209,6068,8
13031,Bulloch County,2021-02-03,107,6175,8.1
13031,Bulloch County,2021-02-04,121,6296,8.3
13031,Bulloch County,2021-02-05,262,6558,8.6
13031,Bulloch County,2021-02-06,83,6641,8.7
13031,Bulloch County,2021-02-07,2,6643,8.7
13031,Bulloch County,2021-02-08,136,6779,8.9
13031,Bulloch County,2021-02-09,183,6962,9.1
13031,Bulloch County,2021-02-10,69,7031,9.2
13031,Bulloch County,2021-02-11,70,7101,9.3
13031,Bulloch County,2021-02-12,192,7293,9.6
13031,Bulloch County,2021-02-13,135,7428,9.8
13031,Bulloch County,2021-02-14,16,7444,9.8
13031,Bulloch County,2021-02-15,137,7581,10
13031,Bulloch County,2021-02-16,118,7699,10.1
13031,Bulloch County,2021-02-17,75,7774,10.2
13031,Bulloch County,2021-02-18,65,7839,10.3
13031,Bulloch County,2021-02-19,176,8015,10.5
13031,Bulloch County,2021-02-20,7,8022,10.5
13031,Bulloch County,2021-02-21,11,8033,10.6
13031,Bulloch County,2021-02-22,76,8109,10.7
13031,Bulloch County,2021-02-23,124,8233,10.8
13031,Bulloch County,2021-02-24,63,8296,10.9
13031,Bulloch County,2021-02-25,98,8394,11
13031,Bulloch County,2021-02-26,147,8541,11.2
13031,Bulloch County,2021-02-27,4,8545,11.2
13031,Bulloch County,2021-02-28,18,8563,11.2
13031,Bulloch County,2021-03-01,137,8700,11.4
13031,Bulloch County,2021-03-02,178,8878,11.7
13031,Bulloch County,2021-03-03,118,8996,11.8
13031,Bulloch County,2021-03-04,137,9133,12
13031,Bulloch County,2021-03-05,205,9338,12.3
13031,Bulloch County,2021-03-06,83,9421,12.4
13031,Bulloch County,2021-03-07,37,9458,12.4
13031,Bulloch County,2021-03-08,285,9743,12.8
13031,Bulloch County,2021-03-09,263,10006,13.1
13031,Bulloch County,2021-03-10,249,10255,13.5
13031,Bulloch County,2021-03-11,170,10425,13.7
13031,Bulloch County,2021-03-12,382,10807,14.2
13031,Bulloch County,2021-03-13,92,10899,14.3
13031,Bulloch County,2021-03-14,71,10970,14.4
13031,Bulloch County,2021-03-15,277,11247,14.8
13031,Bulloch County,2021-03-16,381,11628,15.3
13031,Bulloch County,2021-03-17,276,11904,15.6
13031,Bulloch County,2021-03-18,205,12109,15.9
13031,Bulloch County,2021-03-19,497,12606,16.6
13031,Bulloch County,2021-03-20,63,12669,16.6
13031,Bulloch County,2021-03-21,40,12709,16.7
13031,Bulloch County,2021-03-22,268,12977,17
13031,Bulloch County,2021-03-23,250,13227,17.4
13031,Bulloch County,2021-03-24,353,13580,17.8
13031,Bulloch County,2021-03-25,245,13825,18.2
13031,Bulloch County,2021-03-26,342,14167,18.6
13031,Bulloch County,2021-03-27,95,14262,18.7
13031,Bulloch County,2021-03-28,55,14317,18.8
13031,Bulloch County,2021-03-29,238,14555,19.1
13031,Bulloch County,2021-03-30,320,14875,19.5
13031,Bulloch County,2021-03-31,188,15063,19.8
13031,Bulloch County,2021-04-01,243,15306,20.1
13031,Bulloch County,2021-04-02,551,15857,20.8
13031,Bulloch County,2021-04-03,83,15940,20.9
13031,Bulloch County,2021-04-04,48,15988,21
13031,Bulloch County,2021-04-05,226,16214,21.3
13031,Bulloch County,2021-04-06,193,16407,21.6
13031,Bulloch County,2021-04-07,178,16585,21.8
13031,Bulloch County,2021-04-08,203,16788,22.1
13031,Bulloch County,2021-04-09,183,16971,22.3
13031,Bulloch County,2021-04-10,98,17069,22.4
13031,Bulloch County,2021-04-11,25,17094,22.5
13031,Bulloch County,2021-04-12,153,17247,22.7
13031,Bulloch County,2021-04-13,146,17393,22.8
13031,Bulloch County,2021-04-14,84,17477,23
13031,Bulloch County,2021-04-15,117,17594,23.1
13031,Bulloch County,2021-04-16,141,17735,23.3
13031,Bulloch County,2021-04-17,35,17770,23.3
13031,Bulloch County,2021-04-18,9,17779,23.4
13031,Bulloch County,2021-04-19,62,17841,23.4
13031,Bulloch County,2021-04-20,83,17924,23.5
13031,Bulloch County,2021-04-21,82,18006,23.7
13031,Bulloch County,2021-04-22,98,18104,23.8
13031,Bulloch County,2021-04-23,96,18200,23.9
13031,Bulloch County,2021-04-24,22,18222,23.9
13031,Bulloch County,2021-04-25,5,18227,23.9
13031,Bulloch County,2021-04-26,46,18273,24
13031,Bulloch County,2021-04-27,86,18359,24.1
13031,Bulloch County,2021-04-28,68,18427,24.2
13031,Bulloch County,2021-04-29,76,18503,24.3
13031,Bulloch County,2021-04-30,137,18640,24.5
13031,Bulloch County,2021-05-01,44,18684,24.5
13031,Bulloch County,2021-05-02,6,18690,24.6
13031,Bulloch County,2021-05-03,62,18752,24.6
13031,Bulloch County,2021-05-04,91,18843,24.8
13031,Bulloch County,2021-05-05,87,18930,24.9
13031,Bulloch County,2021-05-06,63,18993,25
13031,Bulloch County,2021-05-07,76,19069,25.1
13031,Bulloch County,2021-05-08,27,19096,25.1
13031,Bulloch County,2021-05-09,4,19100,25.1
13031,Bulloch County,2021-05-10,40,19140,25.1
13031,Bulloch County,2021-05-11,90,19230,25.3
13031,Bulloch County,2021-05-12,52,19282,25.3
13031,Bulloch County,2021-05-13,72,19354,25.4
13031,Bulloch County,2021-05-14,108,19462,25.6
13031,Bulloch County,2021-05-15,72,19534,25.7
13031,Bulloch County,2021-05-16,28,19562,25.7
13031,Bulloch County,2021-05-17,82,19644,25.8
13031,Bulloch County,2021-05-18,97,19741,25.9
13031,Bulloch County,2021-05-19,60,19801,26
13031,Bulloch County,2021-05-20,92,19893,26.1
13031,Bulloch County,2021-05-21,52,19945,26.2
13031,Bulloch County,2021-05-22,33,19978,26.2
13031,Bulloch County,2021-05-23,14,19992,26.3
13031,Bulloch County,2021-05-24,44,20036,26.3
13031,Bulloch County,2021-05-25,64,20100,26.4
13031,Bulloch County,2021-05-26,40,20140,26.5
13031,Bulloch County,2021-05-27,64,20204,26.5
13031,Bulloch County,2021-05-28,64,20268,26.6
13031,Bulloch County,2021-05-29,24,20292,26.7
13031,Bulloch County,2021-05-30,10,20302,26.7
13031,Bulloch County,2021-05-31,3,20305,26.7
13031,Bulloch County,2021-06-01,58,20363,26.8
13031,Bulloch County,2021-06-02,57,20420,26.8
13031,Bulloch County,2021-06-03,64,20484,26.9
13031,Bulloch County,2021-06-04,51,20535,27
13031,Bulloch County,2021-06-05,18,20553,27
13031,Bulloch County,2021-06-06,11,20564,27
13031,Bulloch County,2021-06-07,42,20606,27.1
13031,Bulloch County,2021-06-08,40,20646,27.1
13031,Bulloch County,2021-06-09,30,20676,27.2
13031,Bulloch County,2021-06-10,42,20718,27.2
13031,Bulloch County,2021-06-11,45,20763,27.3
13031,Bulloch County,2021-06-12,26,20789,27.3
13031,Bulloch County,2021-06-13,5,20794,27.3
13031,Bulloch County,2021-06-14,31,20825,27.4
13031,Bulloch County,2021-06-15,37,20862,27.4
13031,Bulloch County,2021-06-16,31,20893,27.4
13031,Bulloch County,2021-06-17,52,20945,27.5
13031,Bulloch County,2021-06-18,31,20976,27.6
13031,Bulloch County,2021-06-19,21,20997,27.6
13031,Bulloch County,2021-06-20,5,21002,27.6
13031,Bulloch County,2021-06-21,47,21049,27.7
13031,Bulloch County,2021-06-22,29,21078,27.7
13031,Bulloch County,2021-06-23,26,21104,27.7
13031,Bulloch County,2021-06-24,38,21142,27.8
13031,Bulloch County,2021-06-25,27,21169,27.8
13031,Bulloch County,2021-06-26,12,21181,27.8
13031,Bulloch County,2021-06-27,4,21185,27.8
13031,Bulloch County,2021-06-28,27,21212,27.9
13031,Bulloch County,2021-06-29,30,21242,27.9
13031,Bulloch County,2021-06-30,38,21280,28
13031,Bulloch County,2021-07-01,34,21314,28
13031,Bulloch County,2021-07-02,14,21328,28
13031,Bulloch County,2021-07-03,9,21337,28
13031,Bulloch County,2021-07-04,3,21340,28
13031,Bulloch County,2021-07-05,13,21353,28.1
13031,Bulloch County,2021-07-06,37,21390,28.1
13031,Bulloch County,2021-07-07,22,21412,28.1
13031,Bulloch County,2021-07-08,41,21453,28.2
13031,Bulloch County,2021-07-09,47,21500,28.2
13031,Bulloch County,2021-07-10,19,21519,28.3
13031,Bulloch County,2021-07-11,7,21526,28.3
13031,Bulloch County,2021-07-12,25,21551,28.3
13031,Bulloch County,2021-07-13,33,21584,28.4
13031,Bulloch County,2021-07-14,44,21628,28.4
13031,Bulloch County,2021-07-15,44,21672,28.5
13031,Bulloch County,2021-07-16,36,21708,28.5
13031,Bulloch County,2021-07-17,26,21734,28.6
13031,Bulloch County,2021-07-18,15,21749,28.6
13031,Bulloch County,2021-07-19,73,21822,28.7
13031,Bulloch County,2021-07-20,66,21888,28.8
13031,Bulloch County,2021-07-21,62,21950,28.8
13031,Bulloch County,2021-07-22,80,22030,28.9
13031,Bulloch County,2021-07-23,84,22114,29.1
13031,Bulloch County,2021-07-24,91,22205,29.2
13031,Bulloch County,2021-07-25,21,22226,29.2
13031,Bulloch County,2021-07-26,90,22316,29.3
13031,Bulloch County,2021-07-27,110,22426,29.5
13031,Bulloch County,2021-07-28,136,22562,29.6
13031,Bulloch County,2021-07-29,125,22687,29.8
13031,Bulloch County,2021-07-30,159,22846,30
13031,Bulloch County,2021-07-31,62,22908,30.1
13031,Bulloch County,2021-08-01,39,22947,30.1
13031,Bulloch County,2021-08-02,103,23050,30.3
13031,Bulloch County,2021-08-03,113,23163,30.4
13031,Bulloch County,2021-08-04,115,23278,30.6
13031,Bulloch County,2021-08-05,129,23407,30.8
13031,Bulloch County,2021-08-06,194,23601,31
13031,Bulloch County,2021-08-07,75,23676,31.1
13031,Bulloch County,2021-08-08,30,23706,31.1
13031,Bulloch County,2021-08-09,120,23826,31.3
13031,Bulloch County,2021-08-10,164,23990,31.5
13031,Bulloch County,2021-08-11,133,24123,31.7
13031,Bulloch County,2021-08-12,165,24288,31.9
13031,Bulloch County,2021-08-13,241,24529,32.2
13031,Bulloch County,2021-08-14,101,24630,32.4
13031,Bulloch County,2021-08-15,40,24670,32.4
13031,Bulloch County,2021-08-16,146,24816,32.6
13031,Bulloch County,2021-08-17,159,24975,32.8
13031,Bulloch County,2021-08-18,121,25096,33
13031,Bulloch County,2021-08-19,143,25239,33.2
13031,Bulloch County,2021-08-20,187,25426,33.4
13031,Bulloch County,2021-08-21,76,25502,33.5
13031,Bulloch County,2021-08-22,13,25515,33.5
13031,Bulloch County,2021-08-23,141,25656,33.7
13031,Bulloch County,2021-08-24,112,25768,33.9
13031,Bulloch County,2021-08-25,119,25887,34
13031,Bulloch County,2021-08-26,179,26066,34.2
13031,Bulloch County,2021-08-27,230,26296,34.5
13031,Bulloch County,2021-08-28,82,26378,34.7
13031,Bulloch County,2021-08-29,21,26399,34.7
13031,Bulloch County,2021-08-30,128,26527,34.8
13031,Bulloch County,2021-08-31,143,26670,35
13031,Bulloch County,2021-09-01,129,26799,35.2
13031,Bulloch County,2021-09-02,118,26917,35.4
13031,Bulloch County,2021-09-03,185,27102,35.6
13031,Bulloch County,2021-09-04,47,27149,35.7
13031,Bulloch County,2021-09-05,19,27168,35.7
13031,Bulloch County,2021-09-06,23,27191,35.7
13031,Bulloch County,2021-09-07,88,27279,35.8
13031,Bulloch County,2021-09-08,90,27369,36
13031,Bulloch County,2021-09-09,74,27443,36.1
13031,Bulloch County,2021-09-10,119,27562,36.2
13031,Bulloch County,2021-09-11,38,27600,36.3
13031,Bulloch County,2021-09-12,17,27617,36.3
13031,Bulloch County,2021-09-13,66,27683,36.4
13031,Bulloch County,2021-09-14,52,27735,36.4
13031,Bulloch County,2021-09-15,40,27775,36.5
13031,Bulloch County,2021-09-16,58,27833,36.6
13031,Bulloch County,2021-09-17,83,27916,36.7
13031,Bulloch County,2021-09-18,71,27987,36.8
13031,Bulloch County,2021-09-19,6,27993,36.8
13031,Bulloch County,2021-09-20,50,28043,36.8
13031,Bulloch County,2021-09-21,58,28101,36.9
13031,Bulloch County,2021-09-22,35,28136,37
13031,Bulloch County,2021-09-23,32,28168,37
13031,Bulloch County,2021-09-24,33,28201,37
13031,Bulloch County,2021-09-25,12,28213,37.1
13031,Bulloch County,2021-09-26,3,28216,37.1
13031,Bulloch County,2021-09-27,18,28234,37.1
13031,Bulloch County,2021-09-28,31,28265,37.1
13031,Bulloch County,2021-09-29,20,28285,37.2
13031,Bulloch County,2021-09-30,18,28303,37.2
13031,Bulloch County,2021-10-01,34,28337,37.2
13031,Bulloch County,2021-10-02,11,28348,37.2
13031,Bulloch County,2021-10-03,2,28350,37.2
13031,Bulloch County,2021-10-04,13,28363,37.3
13031,Bulloch County,2021-10-05,11,28374,37.3
13031,Bulloch County,2021-10-06,23,28397,37.3
13031,Bulloch County,2021-10-07,10,28407,37.3
13033,Burke County,2020-12-17,2,2,0
13033,Burke County,2020-12-18,4,6,0
13033,Burke County,2020-12-19,2,8,0
13033,Burke County,2020-12-20,1,9,0
13033,Burke County,2020-12-21,1,10,0
13033,Burke County,2020-12-22,22,32,0.1
13033,Burke County,2020-12-23,23,55,0.2
13033,Burke County,2020-12-24,5,60,0.3
13033,Burke County,2020-12-26,4,64,0.3
13033,Burke County,2020-12-27,2,66,0.3
13033,Burke County,2020-12-28,50,116,0.5
13033,Burke County,2020-12-29,51,167,0.7
13033,Burke County,2020-12-30,45,212,0.9
13033,Burke County,2020-12-31,22,234,1
13033,Burke County,2021-01-02,1,235,1
13033,Burke County,2021-01-03,4,239,1.1
13033,Burke County,2021-01-04,47,286,1.3
13033,Burke County,2021-01-05,33,319,1.4
13033,Burke County,2021-01-06,56,375,1.7
13033,Burke County,2021-01-07,11,386,1.7
13033,Burke County,2021-01-08,12,398,1.8
13033,Burke County,2021-01-09,5,403,1.8
13033,Burke County,2021-01-10,1,404,1.8
13033,Burke County,2021-01-11,22,426,1.9
13033,Burke County,2021-01-12,43,469,2.1
13033,Burke County,2021-01-13,229,698,3.1
13033,Burke County,2021-01-14,133,831,3.7
13033,Burke County,2021-01-15,64,895,4
13033,Burke County,2021-01-16,3,898,4
13033,Burke County,2021-01-17,1,899,4
13033,Burke County,2021-01-18,12,911,4
13033,Burke County,2021-01-19,33,944,4.2
13033,Burke County,2021-01-20,205,1149,5.1
13033,Burke County,2021-01-21,37,1186,5.3
13033,Burke County,2021-01-22,25,1211,5.4
13033,Burke County,2021-01-23,6,1217,5.4
13033,Burke County,2021-01-25,26,1243,5.5
13033,Burke County,2021-01-26,76,1319,5.9
13033,Burke County,2021-01-27,230,1549,6.9
13033,Burke County,2021-01-28,99,1648,7.3
13033,Burke County,2021-01-29,29,1677,7.4
13033,Burke County,2021-01-30,15,1692,7.5
13033,Burke County,2021-01-31,2,1694,7.5
13033,Burke County,2021-02-01,16,1710,7.6
13033,Burke County,2021-02-02,35,1745,7.7
13033,Burke County,2021-02-03,260,2005,8.9
13033,Burke County,2021-02-04,35,2040,9.1
13033,Burke County,2021-02-05,41,2081,9.2
13033,Burke County,2021-02-06,71,2152,9.6
13033,Burke County,2021-02-07,1,2153,9.6
13033,Burke County,2021-02-08,11,2164,9.6
13033,Burke County,2021-02-09,31,2195,9.7
13033,Burke County,2021-02-10,154,2349,10.4
13033,Burke County,2021-02-11,36,2385,10.6
13033,Burke County,2021-02-12,23,2408,10.7
13033,Burke County,2021-02-13,29,2437,10.8
13033,Burke County,2021-02-14,1,2438,10.8
13033,Burke County,2021-02-15,12,2450,10.9
13033,Burke County,2021-02-16,38,2488,11
13033,Burke County,2021-02-17,43,2531,11.2
13033,Burke County,2021-02-18,5,2536,11.3
13033,Burke County,2021-02-19,11,2547,11.3
13033,Burke County,2021-02-20,1,2548,11.3
13033,Burke County,2021-02-21,1,2549,11.3
13033,Burke County,2021-02-22,11,2560,11.4
13033,Burke County,2021-02-23,14,2574,11.4
13033,Burke County,2021-02-24,57,2631,11.7
13033,Burke County,2021-02-25,33,2664,11.8
13033,Burke County,2021-02-26,24,2688,11.9
13033,Burke County,2021-02-27,11,2699,12
13033,Burke County,2021-02-28,8,2707,12
13033,Burke County,2021-03-01,18,2725,12.1
13033,Burke County,2021-03-02,25,2750,12.2
13033,Burke County,2021-03-03,99,2849,12.7
13033,Burke County,2021-03-04,20,2869,12.7
13033,Burke County,2021-03-05,22,2891,12.8
13033,Burke County,2021-03-06,9,2900,12.9
13033,Burke County,2021-03-07,28,2928,13
13033,Burke County,2021-03-08,32,2960,13.1
13033,Burke County,2021-03-09,24,2984,13.3
13033,Burke County,2021-03-10,174,3158,14
13033,Burke County,2021-03-11,330,3488,15.5
13033,Burke County,2021-03-12,77,3565,15.8
13033,Burke County,2021-03-13,43,3608,16
13033,Burke County,2021-03-14,14,3622,16.1
13033,Burke County,2021-03-15,73,3695,16.4
13033,Burke County,2021-03-16,57,3752,16.7
13033,Burke County,2021-03-17,278,4030,17.9
13033,Burke County,2021-03-18,46,4076,18.1
13033,Burke County,2021-03-19,61,4137,18.4
13033,Burke County,2021-03-20,30,4167,18.5
13033,Burke County,2021-03-21,16,4183,18.6
13033,Burke County,2021-03-22,86,4269,19
13033,Burke County,2021-03-23,65,4334,19.2
13033,Burke County,2021-03-24,206,4540,20.2
13033,Burke County,2021-03-25,112,4652,20.7
13033,Burke County,2021-03-26,66,4718,21
13033,Burke County,2021-03-27,41,4759,21.1
13033,Burke County,2021-03-28,14,4773,21.2
13033,Burke County,2021-03-29,54,4827,21.4
13033,Burke County,2021-03-30,88,4915,21.8
13033,Burke County,2021-03-31,210,5125,22.8
13033,Burke County,2021-04-01,179,5304,23.6
13033,Burke County,2021-04-02,56,5360,23.8
13033,Burke County,2021-04-03,40,5400,24
13033,Burke County,2021-04-04,11,5411,24
13033,Burke County,2021-04-05,66,5477,24.3
13033,Burke County,2021-04-06,52,5529,24.6
13033,Burke County,2021-04-07,134,5663,25.1
13033,Burke County,2021-04-08,95,5758,25.6
13033,Burke County,2021-04-09,51,5809,25.8
13033,Burke County,2021-04-10,64,5873,26.1
13033,Burke County,2021-04-11,14,5887,26.1
13033,Burke County,2021-04-12,30,5917,26.3
13033,Burke County,2021-04-13,55,5972,26.5
13033,Burke County,2021-04-14,71,6043,26.8
13033,Burke County,2021-04-15,60,6103,27.1
13033,Burke County,2021-04-16,51,6154,27.3
13033,Burke County,2021-04-17,13,6167,27.4
13033,Burke County,2021-04-18,5,6172,27.4
13033,Burke County,2021-04-19,26,6198,27.5
13033,Burke County,2021-04-20,36,6234,27.7
13033,Burke County,2021-04-21,72,6306,28
13033,Burke County,2021-04-22,40,6346,28.2
13033,Burke County,2021-04-23,35,6381,28.3
13033,Burke County,2021-04-24,10,6391,28.4
13033,Burke County,2021-04-25,4,6395,28.4
13033,Burke County,2021-04-26,26,6421,28.5
13033,Burke County,2021-04-27,28,6449,28.6
13033,Burke County,2021-04-28,62,6511,28.9
13033,Burke County,2021-04-29,53,6564,29.1
13033,Burke County,2021-04-30,34,6598,29.3
13033,Burke County,2021-05-01,23,6621,29.4
13033,Burke County,2021-05-02,5,6626,29.4
13033,Burke County,2021-05-03,25,6651,29.5
13033,Burke County,2021-05-04,30,6681,29.7
13033,Burke County,2021-05-05,37,6718,29.8
13033,Burke County,2021-05-06,53,6771,30.1
13033,Burke County,2021-05-07,33,6804,30.2
13033,Burke County,2021-05-08,13,6817,30.3
13033,Burke County,2021-05-09,6,6823,30.3
13033,Burke County,2021-05-10,18,6841,30.4
13033,Burke County,2021-05-11,48,6889,30.6
13033,Burke County,2021-05-12,37,6926,30.8
13033,Burke County,2021-05-13,27,6953,30.9
13033,Burke County,2021-05-14,42,6995,31.1
13033,Burke County,2021-05-15,31,7026,31.2
13033,Burke County,2021-05-16,13,7039,31.3
13033,Burke County,2021-05-17,38,7077,31.4
13033,Burke County,2021-05-18,40,7117,31.6
13033,Burke County,2021-05-19,39,7156,31.8
13033,Burke County,2021-05-20,50,7206,32
13033,Burke County,2021-05-21,34,7240,32.1
13033,Burke County,2021-05-22,17,7257,32.2
13033,Burke County,2021-05-23,13,7270,32.3
13033,Burke County,2021-05-24,24,7294,32.4
13033,Burke County,2021-05-25,25,7319,32.5
13033,Burke County,2021-05-26,34,7353,32.7
13033,Burke County,2021-05-27,36,7389,32.8
13033,Burke County,2021-05-28,22,7411,32.9
13033,Burke County,2021-05-29,8,7419,32.9
13033,Burke County,2021-05-30,5,7424,33
13033,Burke County,2021-05-31,1,7425,33
13033,Burke County,2021-06-01,29,7454,33.1
13033,Burke County,2021-06-02,20,7474,33.2
13033,Burke County,2021-06-03,44,7518,33.4
13033,Burke County,2021-06-04,28,7546,33.5
13033,Burke County,2021-06-05,17,7563,33.6
13033,Burke County,2021-06-06,12,7575,33.6
13033,Burke County,2021-06-07,19,7594,33.7
13033,Burke County,2021-06-08,18,7612,33.8
13033,Burke County,2021-06-09,35,7647,34
13033,Burke County,2021-06-10,36,7683,34.1
13033,Burke County,2021-06-11,25,7708,34.2
13033,Burke County,2021-06-12,20,7728,34.3
13033,Burke County,2021-06-13,2,7730,34.3
13033,Burke County,2021-06-14,17,7747,34.4
13033,Burke County,2021-06-15,28,7775,34.5
13033,Burke County,2021-06-16,21,7796,34.6
13033,Burke County,2021-06-17,21,7817,34.7
13033,Burke County,2021-06-18,28,7845,34.8
13033,Burke County,2021-06-19,29,7874,35
13033,Burke County,2021-06-20,1,7875,35
13033,Burke County,2021-06-21,21,7896,35.1
13033,Burke County,2021-06-22,24,7920,35.2
13033,Burke County,2021-06-23,25,7945,35.3
13033,Burke County,2021-06-24,19,7964,35.4
13033,Burke County,2021-06-25,11,7975,35.4
13033,Burke County,2021-06-26,8,7983,35.4
13033,Burke County,2021-06-27,8,7991,35.5
13033,Burke County,2021-06-28,11,8002,35.5
13033,Burke County,2021-06-29,15,8017,35.6
13033,Burke County,2021-06-30,12,8029,35.7
13033,Burke County,2021-07-01,15,8044,35.7
13033,Burke County,2021-07-02,19,8063,35.8
13033,Burke County,2021-07-03,4,8067,35.8
13033,Burke County,2021-07-04,1,8068,35.8
13033,Burke County,2021-07-05,12,8080,35.9
13033,Burke County,2021-07-06,16,8096,36
13033,Burke County,2021-07-07,13,8109,36
13033,Burke County,2021-07-08,15,8124,36.1
13033,Burke County,2021-07-09,11,8135,36.1
13033,Burke County,2021-07-10,12,8147,36.2
13033,Burke County,2021-07-11,6,8153,36.2
13033,Burke County,2021-07-12,11,8164,36.3
13033,Burke County,2021-07-13,15,8179,36.3
13033,Burke County,2021-07-14,28,8207,36.4
13033,Burke County,2021-07-15,26,8233,36.6
13033,Burke County,2021-07-16,13,8246,36.6
13033,Burke County,2021-07-17,6,8252,36.6
13033,Burke County,2021-07-18,5,8257,36.7
13033,Burke County,2021-07-19,19,8276,36.7
13033,Burke County,2021-07-20,28,8304,36.9
13033,Burke County,2021-07-21,30,8334,37
13033,Burke County,2021-07-22,32,8366,37.1
13033,Burke County,2021-07-23,36,8402,37.3
13033,Burke County,2021-07-24,15,8417,37.4
13033,Burke County,2021-07-25,11,8428,37.4
13033,Burke County,2021-07-26,33,8461,37.6
13033,Burke County,2021-07-27,50,8511,37.8
13033,Burke County,2021-07-28,48,8559,38
13033,Burke County,2021-07-29,49,8608,38.2
13033,Burke County,2021-07-30,46,8654,38.4
13033,Burke County,2021-07-31,17,8671,38.5
13033,Burke County,2021-08-01,18,8689,38.6
13033,Burke County,2021-08-02,77,8766,38.9
13033,Burke County,2021-08-03,54,8820,39.2
13033,Burke County,2021-08-04,59,8879,39.4
13033,Burke County,2021-08-05,58,8937,39.7
13033,Burke County,2021-08-06,75,9012,40
13033,Burke County,2021-08-07,52,9064,40.2
13033,Burke County,2021-08-08,24,9088,40.4
13033,Burke County,2021-08-09,56,9144,40.6
13033,Burke County,2021-08-10,80,9224,41
13033,Burke County,2021-08-11,69,9293,41.3
13033,Burke County,2021-08-12,164,9457,42
13033,Burke County,2021-08-13,99,9556,42.4
13033,Burke County,2021-08-14,32,9588,42.6
13033,Burke County,2021-08-15,30,9618,42.7
13033,Burke County,2021-08-16,61,9679,43
13033,Burke County,2021-08-17,55,9734,43.2
13033,Burke County,2021-08-18,78,9812,43.6
13033,Burke County,2021-08-19,52,9864,43.8
13033,Burke County,2021-08-20,64,9928,44.1
13033,Burke County,2021-08-21,17,9945,44.2
13033,Burke County,2021-08-22,8,9953,44.2
13033,Burke County,2021-08-23,49,10002,44.4
13033,Burke County,2021-08-24,44,10046,44.6
13033,Burke County,2021-08-25,53,10099,44.8
13033,Burke County,2021-08-26,45,10144,45
13033,Burke County,2021-08-27,50,10194,45.3
13033,Burke County,2021-08-28,38,10232,45.4
13033,Burke County,2021-08-29,5,10237,45.5
13033,Burke County,2021-08-30,61,10298,45.7
13033,Burke County,2021-08-31,62,10360,46
13033,Burke County,2021-09-01,41,10401,46.2
13033,Burke County,2021-09-02,63,10464,46.5
13033,Burke County,2021-09-03,60,10524,46.7
13033,Burke County,2021-09-04,26,10550,46.8
13033,Burke County,2021-09-05,12,10562,46.9
13033,Burke County,2021-09-06,4,10566,46.9
13033,Burke County,2021-09-07,35,10601,47.1
13033,Burke County,2021-09-08,38,10639,47.2
13033,Burke County,2021-09-09,52,10691,47.5
13033,Burke County,2021-09-10,42,10733,47.7
13033,Burke County,2021-09-11,18,10751,47.7
13033,Burke County,2021-09-12,11,10762,47.8
13033,Burke County,2021-09-13,30,10792,47.9
13033,Burke County,2021-09-14,30,10822,48.1
13033,Burke County,2021-09-15,37,10859,48.2
13033,Burke County,2021-09-16,34,10893,48.4
13033,Burke County,2021-09-17,36,10929,48.5
13033,Burke County,2021-09-18,18,10947,48.6
13033,Burke County,2021-09-19,8,10955,48.6
13033,Burke County,2021-09-20,27,10982,48.8
13033,Burke County,2021-09-21,30,11012,48.9
13033,Burke County,2021-09-22,33,11045,49
13033,Burke County,2021-09-23,27,11072,49.2
13033,Burke County,2021-09-24,36,11108,49.3
13033,Burke County,2021-09-25,5,11113,49.3
13033,Burke County,2021-09-26,5,11118,49.4
13033,Burke County,2021-09-27,19,11137,49.5
13033,Burke County,2021-09-28,13,11150,49.5
13033,Burke County,2021-09-29,19,11169,49.6
13033,Burke County,2021-09-30,19,11188,49.7
13033,Burke County,2021-10-01,11,11199,49.7
13033,Burke County,2021-10-02,5,11204,49.8
13033,Burke County,2021-10-03,6,11210,49.8
13033,Burke County,2021-10-04,6,11216,49.8
13033,Burke County,2021-10-05,5,11221,49.8
13033,Burke County,2021-10-06,23,11244,49.9
13033,Burke County,2021-10-07,8,11252,50
13035,Butts County,2020-12-17,2,2,0
13035,Butts County,2020-12-18,4,6,0
13035,Butts County,2020-12-19,10,16,0.1
13035,Butts County,2020-12-20,2,18,0.1
13035,Butts County,2020-12-21,3,21,0.1
13035,Butts County,2020-12-22,10,31,0.1
13035,Butts County,2020-12-23,10,41,0.2
13035,Butts County,2020-12-27,2,43,0.2
13035,Butts County,2020-12-28,70,113,0.5
13035,Butts County,2020-12-29,24,137,0.6
13035,Butts County,2020-12-30,10,147,0.6
13035,Butts County,2020-12-31,14,161,0.7
13035,Butts County,2021-01-01,7,168,0.7
13035,Butts County,2021-01-02,3,171,0.7
13035,Butts County,2021-01-04,16,187,0.8
13035,Butts County,2021-01-05,10,197,0.8
13035,Butts County,2021-01-06,49,246,1
13035,Butts County,2021-01-07,76,322,1.3
13035,Butts County,2021-01-08,76,398,1.7
13035,Butts County,2021-01-09,7,405,1.7
13035,Butts County,2021-01-10,3,408,1.7
13035,Butts County,2021-01-11,11,419,1.7
13035,Butts County,2021-01-12,27,446,1.9
13035,Butts County,2021-01-13,20,466,1.9
13035,Butts County,2021-01-14,22,488,2
13035,Butts County,2021-01-15,212,700,2.9
13035,Butts County,2021-01-16,19,719,3
13035,Butts County,2021-01-17,30,749,3.1
13035,Butts County,2021-01-18,39,788,3.3
13035,Butts County,2021-01-19,34,822,3.4
13035,Butts County,2021-01-20,35,857,3.6
13035,Butts County,2021-01-21,39,896,3.7
13035,Butts County,2021-01-22,223,1119,4.6
13035,Butts County,2021-01-23,15,1134,4.7
13035,Butts County,2021-01-24,3,1137,4.7
13035,Butts County,2021-01-25,34,1171,4.9
13035,Butts County,2021-01-26,19,1190,4.9
13035,Butts County,2021-01-27,30,1220,5.1
13035,Butts County,2021-01-28,37,1257,5.2
13035,Butts County,2021-01-29,28,1285,5.3
13035,Butts County,2021-01-30,13,1298,5.4
13035,Butts County,2021-01-31,2,1300,5.4
13035,Butts County,2021-02-01,7,1307,5.4
13035,Butts County,2021-02-02,12,1319,5.5
13035,Butts County,2021-02-03,20,1339,5.6
13035,Butts County,2021-02-04,16,1355,5.6
13035,Butts County,2021-02-05,13,1368,5.7
13035,Butts County,2021-02-06,4,1372,5.7
13035,Butts County,2021-02-08,16,1388,5.8
13035,Butts County,2021-02-09,20,1408,5.8
13035,Butts County,2021-02-10,17,1425,5.9
13035,Butts County,2021-02-11,14,1439,6
13035,Butts County,2021-02-12,28,1467,6.1
13035,Butts County,2021-02-13,4,1471,6.1
13035,Butts County,2021-02-14,7,1478,6.1
13035,Butts County,2021-02-15,22,1500,6.2
13035,Butts County,2021-02-16,23,1523,6.3
13035,Butts County,2021-02-17,25,1548,6.4
13035,Butts County,2021-02-18,20,1568,6.5
13035,Butts County,2021-02-19,20,1588,6.6
13035,Butts County,2021-02-20,6,1594,6.6
13035,Butts County,2021-02-21,5,1599,6.6
13035,Butts County,2021-02-22,14,1613,6.7
13035,Butts County,2021-02-23,41,1654,6.9
13035,Butts County,2021-02-24,41,1695,7
13035,Butts County,2021-02-25,76,1771,7.4
13035,Butts County,2021-02-26,108,1879,7.8
13035,Butts County,2021-02-27,10,1889,7.8
13035,Butts County,2021-02-28,7,1896,7.9
13035,Butts County,2021-03-01,22,1918,8
13035,Butts County,2021-03-02,49,1967,8.2
13035,Butts County,2021-03-03,49,2016,8.4
13035,Butts County,2021-03-04,113,2129,8.8
13035,Butts County,2021-03-05,111,2240,9.3
13035,Butts County,2021-03-06,7,2247,9.3
13035,Butts County,2021-03-07,8,2255,9.4
13035,Butts County,2021-03-08,34,2289,9.5
13035,Butts County,2021-03-09,56,2345,9.7
13035,Butts County,2021-03-10,78,2423,10.1
13035,Butts County,2021-03-11,140,2563,10.6
13035,Butts County,2021-03-12,153,2716,11.3
13035,Butts County,2021-03-13,19,2735,11.4
13035,Butts County,2021-03-14,17,2752,11.4
13035,Butts County,2021-03-15,59,2811,11.7
13035,Butts County,2021-03-16,68,2879,12
13035,Butts County,2021-03-17,60,2939,12.2
13035,Butts County,2021-03-18,156,3095,12.8
13035,Butts County,2021-03-19,132,3227,13.4
13035,Butts County,2021-03-20,10,3237,13.4
13035,Butts County,2021-03-21,13,3250,13.5
13035,Butts County,2021-03-22,46,3296,13.7
13035,Butts County,2021-03-23,48,3344,13.9
13035,Butts County,2021-03-24,77,3421,14.2
13035,Butts County,2021-03-25,146,3567,14.8
13035,Butts County,2021-03-26,161,3728,15.5
13035,Butts County,2021-03-27,23,3751,15.6
13035,Butts County,2021-03-28,16,3767,15.6
13035,Butts County,2021-03-29,49,3816,15.8
13035,Butts County,2021-03-30,93,3909,16.2
13035,Butts County,2021-03-31,85,3994,16.6
13035,Butts County,2021-04-01,102,4096,17
13035,Butts County,2021-04-02,65,4161,17.3
13035,Butts County,2021-04-03,31,4192,17.4
13035,Butts County,2021-04-04,17,4209,17.5
13035,Butts County,2021-04-05,61,4270,17.7
13035,Butts County,2021-04-06,86,4356,18.1
13035,Butts County,2021-04-07,69,4425,18.4
13035,Butts County,2021-04-08,64,4489,18.6
13035,Butts County,2021-04-09,78,4567,19
13035,Butts County,2021-04-10,28,4595,19.1
13035,Butts County,2021-04-11,13,4608,19.1
13035,Butts County,2021-04-12,50,4658,19.3
13035,Butts County,2021-04-13,59,4717,19.6
13035,Butts County,2021-04-14,57,4774,19.8
13035,Butts County,2021-04-15,49,4823,20
13035,Butts County,2021-04-16,33,4856,20.2
13035,Butts County,2021-04-17,31,4887,20.3
13035,Butts County,2021-04-18,17,4904,20.4
13035,Butts County,2021-04-19,40,4944,20.5
13035,Butts County,2021-04-20,66,5010,20.8
13035,Butts County,2021-04-21,38,5048,21
13035,Butts County,2021-04-22,106,5154,21.4
13035,Butts County,2021-04-23,43,5197,21.6
13035,Butts County,2021-04-24,11,5208,21.6
13035,Butts County,2021-04-25,8,5216,21.7
13035,Butts County,2021-04-26,30,5246,21.8
13035,Butts County,2021-04-27,35,5281,21.9
13035,Butts County,2021-04-28,47,5328,22.1
13035,Butts County,2021-04-29,53,5381,22.3
13035,Butts County,2021-04-30,59,5440,22.6
13035,Butts County,2021-05-01,30,5470,22.7
13035,Butts County,2021-05-02,17,5487,22.8
13035,Butts County,2021-05-03,22,5509,22.9
13035,Butts County,2021-05-04,29,5538,23
13035,Butts County,2021-05-05,31,5569,23.1
13035,Butts County,2021-05-06,60,5629,23.4
13035,Butts County,2021-05-07,30,5659,23.5
13035,Butts County,2021-05-08,15,5674,23.6
13035,Butts County,2021-05-09,7,5681,23.6
13035,Butts County,2021-05-10,20,5701,23.7
13035,Butts County,2021-05-11,24,5725,23.8
13035,Butts County,2021-05-12,22,5747,23.9
13035,Butts County,2021-05-13,48,5795,24.1
13035,Butts County,2021-05-14,41,5836,24.2
13035,Butts County,2021-05-15,20,5856,24.3
13035,Butts County,2021-05-16,12,5868,24.4
13035,Butts County,2021-05-17,37,5905,24.5
13035,Butts County,2021-05-18,42,5947,24.7
13035,Butts County,2021-05-19,31,5978,24.8
13035,Butts County,2021-05-20,31,6009,24.9
13035,Butts County,2021-05-21,49,6058,25.1
13035,Butts County,2021-05-22,30,6088,25.3
13035,Butts County,2021-05-23,9,6097,25.3
13035,Butts County,2021-05-24,30,6127,25.4
13035,Butts County,2021-05-25,20,6147,25.5
13035,Butts County,2021-05-26,22,6169,25.6
13035,Butts County,2021-05-27,32,6201,25.7
13035,Butts County,2021-05-28,22,6223,25.8
13035,Butts County,2021-05-29,9,6232,25.9
13035,Butts County,2021-05-30,3,6235,25.9
13035,Butts County,2021-05-31,2,6237,25.9
13035,Butts County,2021-06-01,12,6249,25.9
13035,Butts County,2021-06-02,24,6273,26
13035,Butts County,2021-06-03,14,6287,26.1
13035,Butts County,2021-06-04,16,6303,26.2
13035,Butts County,2021-06-05,10,6313,26.2
13035,Butts County,2021-06-06,6,6319,26.2
13035,Butts County,2021-06-07,20,6339,26.3
13035,Butts County,2021-06-08,24,6363,26.4
13035,Butts County,2021-06-09,16,6379,26.5
13035,Butts County,2021-06-10,20,6399,26.6
13035,Butts County,2021-06-11,15,6414,26.6
13035,Butts County,2021-06-12,17,6431,26.7
13035,Butts County,2021-06-13,9,6440,26.7
13035,Butts County,2021-06-14,6,6446,26.8
13035,Butts County,2021-06-15,20,6466,26.8
13035,Butts County,2021-06-16,8,6474,26.9
13035,Butts County,2021-06-17,16,6490,26.9
13035,Butts County,2021-06-18,4,6494,27
13035,Butts County,2021-06-19,11,6505,27
13035,Butts County,2021-06-20,3,6508,27
13035,Butts County,2021-06-21,12,6520,27.1
13035,Butts County,2021-06-22,8,6528,27.1
13035,Butts County,2021-06-23,9,6537,27.1
13035,Butts County,2021-06-24,13,6550,27.2
13035,Butts County,2021-06-25,11,6561,27.2
13035,Butts County,2021-06-26,8,6569,27.3
13035,Butts County,2021-06-27,6,6575,27.3
13035,Butts County,2021-06-28,7,6582,27.3
13035,Butts County,2021-06-29,9,6591,27.4
13035,Butts County,2021-06-30,14,6605,27.4
13035,Butts County,2021-07-01,10,6615,27.5
13035,Butts County,2021-07-02,8,6623,27.5
13035,Butts County,2021-07-03,2,6625,27.5
13035,Butts County,2021-07-05,10,6635,27.5
13035,Butts County,2021-07-06,7,6642,27.6
13035,Butts County,2021-07-07,5,6647,27.6
13035,Butts County,2021-07-08,10,6657,27.6
13035,Butts County,2021-07-09,12,6669,27.7
13035,Butts County,2021-07-10,11,6680,27.7
13035,Butts County,2021-07-11,2,6682,27.7
13035,Butts County,2021-07-12,7,6689,27.8
13035,Butts County,2021-07-13,15,6704,27.8
13035,Butts County,2021-07-14,8,6712,27.9
13035,Butts County,2021-07-15,10,6722,27.9
13035,Butts County,2021-07-16,16,6738,28
13035,Butts County,2021-07-17,17,6755,28
13035,Butts County,2021-07-18,7,6762,28.1
13035,Butts County,2021-07-19,15,6777,28.1
13035,Butts County,2021-07-20,20,6797,28.2
13035,Butts County,2021-07-21,15,6812,28.3
13035,Butts County,2021-07-22,22,6834,28.4
13035,Butts County,2021-07-23,22,6856,28.5
13035,Butts County,2021-07-24,18,6874,28.5
13035,Butts County,2021-07-25,11,6885,28.6
13035,Butts County,2021-07-26,24,6909,28.7
13035,Butts County,2021-07-27,31,6940,28.8
13035,Butts County,2021-07-28,27,6967,28.9
13035,Butts County,2021-07-29,24,6991,29
13035,Butts County,2021-07-30,31,7022,29.1
13035,Butts County,2021-07-31,20,7042,29.2
13035,Butts County,2021-08-01,9,7051,29.3
13035,Butts County,2021-08-02,28,7079,29.4
13035,Butts County,2021-08-03,30,7109,29.5
13035,Butts County,2021-08-04,23,7132,29.6
13035,Butts County,2021-08-05,23,7155,29.7
13035,Butts County,2021-08-06,56,7211,29.9
13035,Butts County,2021-08-07,23,7234,30
13035,Butts County,2021-08-08,19,7253,30.1
13035,Butts County,2021-08-09,31,7284,30.2
13035,Butts County,2021-08-10,54,7338,30.5
13035,Butts County,2021-08-11,32,7370,30.6
13035,Butts County,2021-08-12,32,7402,30.7
13035,Butts County,2021-08-13,33,7435,30.9
13035,Butts County,2021-08-14,26,7461,31
13035,Butts County,2021-08-15,11,7472,31
13035,Butts County,2021-08-16,31,7503,31.1
13035,Butts County,2021-08-17,35,7538,31.3
13035,Butts County,2021-08-18,38,7576,31.4
13035,Butts County,2021-08-19,43,7619,31.6
13035,Butts County,2021-08-20,60,7679,31.9
13035,Butts County,2021-08-21,27,7706,32
13035,Butts County,2021-08-22,9,7715,32
13035,Butts County,2021-08-23,26,7741,32.1
13035,Butts County,2021-08-24,36,7777,32.3
13035,Butts County,2021-08-25,35,7812,32.4
13035,Butts County,2021-08-26,49,7861,32.6
13035,Butts County,2021-08-27,44,7905,32.8
13035,Butts County,2021-08-28,32,7937,32.9
13035,Butts County,2021-08-29,11,7948,33
13035,Butts County,2021-08-30,33,7981,33.1
13035,Butts County,2021-08-31,36,8017,33.3
13035,Butts County,2021-09-01,41,8058,33.4
13035,Butts County,2021-09-02,33,8091,33.6
13035,Butts County,2021-09-03,41,8132,33.8
13035,Butts County,2021-09-04,22,8154,33.8
13035,Butts County,2021-09-05,15,8169,33.9
13035,Butts County,2021-09-06,3,8172,33.9
13035,Butts County,2021-09-07,39,8211,34.1
13035,Butts County,2021-09-08,28,8239,34.2
13035,Butts County,2021-09-09,34,8273,34.3
13035,Butts County,2021-09-10,33,8306,34.5
13035,Butts County,2021-09-11,26,8332,34.6
13035,Butts County,2021-09-12,10,8342,34.6
13035,Butts County,2021-09-13,23,8365,34.7
13035,Butts County,2021-09-14,26,8391,34.8
13035,Butts County,2021-09-15,26,8417,34.9
13035,Butts County,2021-09-16,25,8442,35
13035,Butts County,2021-09-17,31,8473,35.2
13035,Butts County,2021-09-18,16,8489,35.2
13035,Butts County,2021-09-19,9,8498,35.3
13035,Butts County,2021-09-20,9,8507,35.3
13035,Butts County,2021-09-21,28,8535,35.4
13035,Butts County,2021-09-22,18,8553,35.5
13035,Butts County,2021-09-23,8,8561,35.5
13035,Butts County,2021-09-24,19,8580,35.6
13035,Butts County,2021-09-25,8,8588,35.6
13035,Butts County,2021-09-26,3,8591,35.7
13035,Butts County,2021-09-27,7,8598,35.7
13035,Butts County,2021-09-28,11,8609,35.7
13035,Butts County,2021-09-29,8,8617,35.8
13035,Butts County,2021-09-30,7,8624,35.8
13035,Butts County,2021-10-01,16,8640,35.9
13035,Butts County,2021-10-02,5,8645,35.9
13035,Butts County,2021-10-04,6,8651,35.9
13035,Butts County,2021-10-05,3,8654,35.9
13035,Butts County,2021-10-06,6,8660,35.9
13035,Butts County,2021-10-07,1,8661,36
13037,Calhoun County,2020-12-17,4,4,0.1
13037,Calhoun County,2020-12-18,6,10,0.2
13037,Calhoun County,2020-12-19,1,11,0.2
13037,Calhoun County,2020-12-20,1,12,0.2
13037,Calhoun County,2020-12-21,1,13,0.2
13037,Calhoun County,2020-12-22,2,15,0.2
13037,Calhoun County,2020-12-23,15,30,0.5
13037,Calhoun County,2020-12-24,5,35,0.5
13037,Calhoun County,2020-12-26,1,36,0.6
13037,Calhoun County,2020-12-28,14,50,0.8
13037,Calhoun County,2020-12-29,40,90,1.4
13037,Calhoun County,2020-12-30,7,97,1.5
13037,Calhoun County,2020-12-31,28,125,2
13037,Calhoun County,2021-01-01,1,126,2
13037,Calhoun County,2021-01-02,1,127,2
13037,Calhoun County,2021-01-04,11,138,2.2
13037,Calhoun County,2021-01-05,6,144,2.3
13037,Calhoun County,2021-01-06,17,161,2.5
13037,Calhoun County,2021-01-07,10,171,2.7
13037,Calhoun County,2021-01-08,17,188,3
13037,Calhoun County,2021-01-10,1,189,3
13037,Calhoun County,2021-01-11,39,228,3.6
13037,Calhoun County,2021-01-12,46,274,4.3
13037,Calhoun County,2021-01-13,122,396,6.2
13037,Calhoun County,2021-01-14,27,423,6.6
13037,Calhoun County,2021-01-15,19,442,6.9
13037,Calhoun County,2021-01-16,7,449,7.1
13037,Calhoun County,2021-01-18,33,482,7.6
13037,Calhoun County,2021-01-19,32,514,8.1
13037,Calhoun County,2021-01-20,41,555,8.7
13037,Calhoun County,2021-01-21,110,665,10.4
13037,Calhoun County,2021-01-22,15,680,10.7
13037,Calhoun County,2021-01-23,6,686,10.8
13037,Calhoun County,2021-01-25,29,715,11.2
13037,Calhoun County,2021-01-26,19,734,11.5
13037,Calhoun County,2021-01-27,27,761,12
13037,Calhoun County,2021-01-28,33,794,12.5
13037,Calhoun County,2021-01-29,9,803,12.6
13037,Calhoun County,2021-01-30,3,806,12.7
13037,Calhoun County,2021-01-31,1,807,12.7
13037,Calhoun County,2021-02-01,23,830,13
13037,Calhoun County,2021-02-02,25,855,13.4
13037,Calhoun County,2021-02-03,23,878,13.8
13037,Calhoun County,2021-02-04,85,963,15.1
13037,Calhoun County,2021-02-05,7,970,15.2
13037,Calhoun County,2021-02-06,1,971,15.3
13037,Calhoun County,2021-02-08,22,993,15.6
13037,Calhoun County,2021-02-09,14,1007,15.8
13037,Calhoun County,2021-02-10,36,1043,16.4
13037,Calhoun County,2021-02-11,15,1058,16.6
13037,Calhoun County,2021-02-12,6,1064,16.7
13037,Calhoun County,2021-02-13,2,1066,16.7
13037,Calhoun County,2021-02-14,3,1069,16.8
13037,Calhoun County,2021-02-15,4,1073,16.9
13037,Calhoun County,2021-02-16,16,1089,17.1
13037,Calhoun County,2021-02-17,15,1104,17.3
13037,Calhoun County,2021-02-18,15,1119,17.6
13037,Calhoun County,2021-02-19,5,1124,17.7
13037,Calhoun County,2021-02-20,1,1125,17.7
13037,Calhoun County,2021-02-21,1,1126,17.7
13037,Calhoun County,2021-02-22,4,1130,17.8
13037,Calhoun County,2021-02-23,17,1147,18
13037,Calhoun County,2021-02-24,44,1191,18.7
13037,Calhoun County,2021-02-25,16,1207,19
13037,Calhoun County,2021-02-26,6,1213,19.1
13037,Calhoun County,2021-02-27,2,1215,19.1
13037,Calhoun County,2021-03-01,15,1230,19.3
13037,Calhoun County,2021-03-02,9,1239,19.5
13037,Calhoun County,2021-03-03,12,1251,19.7
13037,Calhoun County,2021-03-04,16,1267,19.9
13037,Calhoun County,2021-03-05,30,1297,20.4
13037,Calhoun County,2021-03-07,1,1298,20.4
13037,Calhoun County,2021-03-08,18,1316,20.7
13037,Calhoun County,2021-03-09,9,1325,20.8
13037,Calhoun County,2021-03-10,72,1397,21.9
13037,Calhoun County,2021-03-11,26,1423,22.4
13037,Calhoun County,2021-03-12,13,1436,22.6
13037,Calhoun County,2021-03-13,7,1443,22.7
13037,Calhoun County,2021-03-14,2,1445,22.7
13037,Calhoun County,2021-03-15,44,1489,23.4
13037,Calhoun County,2021-03-16,19,1508,23.7
13037,Calhoun County,2021-03-17,69,1577,24.8
13037,Calhoun County,2021-03-18,12,1589,25
13037,Calhoun County,2021-03-19,17,1606,25.2
13037,Calhoun County,2021-03-20,1,1607,25.2
13037,Calhoun County,2021-03-21,1,1608,25.3
13037,Calhoun County,2021-03-22,15,1623,25.5
13037,Calhoun County,2021-03-23,12,1635,25.7
13037,Calhoun County,2021-03-24,50,1685,26.5
13037,Calhoun County,2021-03-25,13,1698,26.7
13037,Calhoun County,2021-03-26,8,1706,26.8
13037,Calhoun County,2021-03-28,1,1707,26.8
13037,Calhoun County,2021-03-29,16,1723,27.1
13037,Calhoun County,2021-03-30,21,1744,27.4
13037,Calhoun County,2021-03-31,22,1766,27.7
13037,Calhoun County,2021-04-01,44,1810,28.4
13037,Calhoun County,2021-04-02,18,1828,28.7
13037,Calhoun County,2021-04-03,1,1829,28.7
13037,Calhoun County,2021-04-04,1,1830,28.8
13037,Calhoun County,2021-04-05,4,1834,28.8
13037,Calhoun County,2021-04-06,30,1864,29.3
13037,Calhoun County,2021-04-07,29,1893,29.7
13037,Calhoun County,2021-04-08,21,1914,30.1
13037,Calhoun County,2021-04-09,12,1926,30.3
13037,Calhoun County,2021-04-10,3,1929,30.3
13037,Calhoun County,2021-04-12,10,1939,30.5
13037,Calhoun County,2021-04-13,24,1963,30.8
13037,Calhoun County,2021-04-14,3,1966,30.9
13037,Calhoun County,2021-04-15,21,1987,31.2
13037,Calhoun County,2021-04-16,10,1997,31.4
13037,Calhoun County,2021-04-18,2,1999,31.4
13037,Calhoun County,2021-04-19,9,2008,31.5
13037,Calhoun County,2021-04-20,14,2022,31.8
13037,Calhoun County,2021-04-21,8,2030,31.9
13037,Calhoun County,2021-04-22,6,2036,32
13037,Calhoun County,2021-04-23,8,2044,32.1
13037,Calhoun County,2021-04-24,1,2045,32.1
13037,Calhoun County,2021-04-25,1,2046,32.1
13037,Calhoun County,2021-04-26,2,2048,32.2
13037,Calhoun County,2021-04-27,12,2060,32.4
13037,Calhoun County,2021-04-28,5,2065,32.4
13037,Calhoun County,2021-04-29,11,2076,32.6
13037,Calhoun County,2021-04-30,15,2091,32.9
13037,Calhoun County,2021-05-01,1,2092,32.9
13037,Calhoun County,2021-05-02,1,2093,32.9
13037,Calhoun County,2021-05-03,4,2097,32.9
13037,Calhoun County,2021-05-04,6,2103,33
13037,Calhoun County,2021-05-05,8,2111,33.2
13037,Calhoun County,2021-05-06,13,2124,33.4
13037,Calhoun County,2021-05-07,3,2127,33.4
13037,Calhoun County,2021-05-08,1,2128,33.4
13037,Calhoun County,2021-05-10,5,2133,33.5
13037,Calhoun County,2021-05-11,5,2138,33.6
13037,Calhoun County,2021-05-12,3,2141,33.6
13037,Calhoun County,2021-05-13,13,2154,33.8
13037,Calhoun County,2021-05-14,4,2158,33.9
13037,Calhoun County,2021-05-15,1,2159,33.9
13037,Calhoun County,2021-05-16,1,2160,33.9
13037,Calhoun County,2021-05-17,2,2162,34
13037,Calhoun County,2021-05-18,8,2170,34.1
13037,Calhoun County,2021-05-19,1,2171,34.1
13037,Calhoun County,2021-05-20,11,2182,34.3
13037,Calhoun County,2021-05-21,6,2188,34.4
13037,Calhoun County,2021-05-22,2,2190,34.4
13037,Calhoun County,2021-05-23,1,2191,34.4
13037,Calhoun County,2021-05-24,4,2195,34.5
13037,Calhoun County,2021-05-25,2,2197,34.5
13037,Calhoun County,2021-05-26,5,2202,34.6
13037,Calhoun County,2021-05-27,6,2208,34.7
13037,Calhoun County,2021-05-28,6,2214,34.8
13037,Calhoun County,2021-05-29,1,2215,34.8
13037,Calhoun County,2021-05-30,1,2216,34.8
13037,Calhoun County,2021-06-01,6,2222,34.9
13037,Calhoun County,2021-06-02,12,2234,35.1
13037,Calhoun County,2021-06-03,15,2249,35.3
13037,Calhoun County,2021-06-04,4,2253,35.4
13037,Calhoun County,2021-06-05,1,2254,35.4
13037,Calhoun County,2021-06-07,3,2257,35.5
13037,Calhoun County,2021-06-08,11,2268,35.6
13037,Calhoun County,2021-06-09,3,2271,35.7
13037,Calhoun County,2021-06-10,6,2277,35.8
13037,Calhoun County,2021-06-11,3,2280,35.8
13037,Calhoun County,2021-06-12,4,2284,35.9
13037,Calhoun County,2021-06-14,7,2291,36
13037,Calhoun County,2021-06-15,3,2294,36
13037,Calhoun County,2021-06-16,5,2299,36.1
13037,Calhoun County,2021-06-17,2,2301,36.2
13037,Calhoun County,2021-06-18,3,2304,36.2
13037,Calhoun County,2021-06-19,2,2306,36.2
13037,Calhoun County,2021-06-21,1,2307,36.2
13037,Calhoun County,2021-06-22,2,2309,36.3
13037,Calhoun County,2021-06-23,6,2315,36.4
13037,Calhoun County,2021-06-24,4,2319,36.4
13037,Calhoun County,2021-06-25,1,2320,36.4
13037,Calhoun County,2021-06-26,2,2322,36.5
13037,Calhoun County,2021-06-27,3,2325,36.5
13037,Calhoun County,2021-06-28,2,2327,36.6
13037,Calhoun County,2021-06-29,8,2335,36.7
13037,Calhoun County,2021-06-30,3,2338,36.7
13037,Calhoun County,2021-07-01,4,2342,36.8
13037,Calhoun County,2021-07-02,2,2344,36.8
13037,Calhoun County,2021-07-03,2,2346,36.9
13037,Calhoun County,2021-07-06,8,2354,37
13037,Calhoun County,2021-07-07,8,2362,37.1
13037,Calhoun County,2021-07-08,10,2372,37.3
13037,Calhoun County,2021-07-09,2,2374,37.3
13037,Calhoun County,2021-07-11,1,2375,37.3
13037,Calhoun County,2021-07-12,4,2379,37.4
13037,Calhoun County,2021-07-13,8,2387,37.5
13037,Calhoun County,2021-07-14,10,2397,37.7
13037,Calhoun County,2021-07-15,3,2400,37.7
13037,Calhoun County,2021-07-16,1,2401,37.7
13037,Calhoun County,2021-07-18,1,2402,37.7
13037,Calhoun County,2021-07-19,6,2408,37.8
13037,Calhoun County,2021-07-20,2,2410,37.9
13037,Calhoun County,2021-07-21,6,2416,38
13037,Calhoun County,2021-07-22,3,2419,38
13037,Calhoun County,2021-07-23,1,2420,38
13037,Calhoun County,2021-07-24,7,2427,38.1
13037,Calhoun County,2021-07-25,1,2428,38.1
13037,Calhoun County,2021-07-26,21,2449,38.5
13037,Calhoun County,2021-07-27,5,2454,38.6
13037,Calhoun County,2021-07-28,25,2479,38.9
13037,Calhoun County,2021-07-29,11,2490,39.1
13037,Calhoun County,2021-07-30,13,2503,39.3
13037,Calhoun County,2021-07-31,4,2507,39.4
13037,Calhoun County,2021-08-01,2,2509,39.4
13037,Calhoun County,2021-08-02,14,2523,39.6
13037,Calhoun County,2021-08-03,17,2540,39.9
13037,Calhoun County,2021-08-04,36,2576,40.5
13037,Calhoun County,2021-08-05,11,2587,40.6
13037,Calhoun County,2021-08-06,21,2608,41
13037,Calhoun County,2021-08-07,5,2613,41.1
13037,Calhoun County,2021-08-08,8,2621,41.2
13037,Calhoun County,2021-08-09,17,2638,41.4
13037,Calhoun County,2021-08-10,23,2661,41.8
13037,Calhoun County,2021-08-11,28,2689,42.2
13037,Calhoun County,2021-08-12,18,2707,42.5
13037,Calhoun County,2021-08-13,22,2729,42.9
13037,Calhoun County,2021-08-14,3,2732,42.9
13037,Calhoun County,2021-08-15,3,2735,43
13037,Calhoun County,2021-08-16,18,2753,43.3
13037,Calhoun County,2021-08-17,11,2764,43.4
13037,Calhoun County,2021-08-18,34,2798,44
13037,Calhoun County,2021-08-19,34,2832,44.5
13037,Calhoun County,2021-08-20,15,2847,44.7
13037,Calhoun County,2021-08-21,6,2853,44.8
13037,Calhoun County,2021-08-22,3,2856,44.9
13037,Calhoun County,2021-08-23,17,2873,45.1
13037,Calhoun County,2021-08-24,11,2884,45.3
13037,Calhoun County,2021-08-25,20,2904,45.6
13037,Calhoun County,2021-08-26,20,2924,45.9
13037,Calhoun County,2021-08-27,14,2938,46.2
13037,Calhoun County,2021-08-28,3,2941,46.2
13037,Calhoun County,2021-08-29,4,2945,46.3
13037,Calhoun County,2021-08-30,16,2961,46.5
13037,Calhoun County,2021-08-31,5,2966,46.6
13037,Calhoun County,2021-09-01,14,2980,46.8
13037,Calhoun County,2021-09-02,12,2992,47
13037,Calhoun County,2021-09-03,7,2999,47.1
13037,Calhoun County,2021-09-04,2,3001,47.1
13037,Calhoun County,2021-09-05,4,3005,47.2
13037,Calhoun County,2021-09-07,13,3018,47.4
13037,Calhoun County,2021-09-08,9,3027,47.6
13037,Calhoun County,2021-09-09,9,3036,47.7
13037,Calhoun County,2021-09-10,4,3040,47.8
13037,Calhoun County,2021-09-11,4,3044,47.8
13037,Calhoun County,2021-09-12,4,3048,47.9
13037,Calhoun County,2021-09-13,13,3061,48.1
13037,Calhoun County,2021-09-14,11,3072,48.3
13037,Calhoun County,2021-09-15,12,3084,48.5
13037,Calhoun County,2021-09-16,7,3091,48.6
13037,Calhoun County,2021-09-17,14,3105,48.8
13037,Calhoun County,2021-09-19,5,3110,48.9
13037,Calhoun County,2021-09-20,1,3111,48.9
13037,Calhoun County,2021-09-21,8,3119,49
13037,Calhoun County,2021-09-22,4,3123,49.1
13037,Calhoun County,2021-09-23,6,3129,49.2
13037,Calhoun County,2021-09-24,6,3135,49.3
13037,Calhoun County,2021-09-26,2,3137,49.3
13037,Calhoun County,2021-09-27,2,3139,49.3
13037,Calhoun County,2021-09-28,3,3142,49.4
13037,Calhoun County,2021-09-29,3,3145,49.4
13037,Calhoun County,2021-09-30,7,3152,49.5
13037,Calhoun County,2021-10-01,5,3157,49.6
13037,Calhoun County,2021-10-02,1,3158,49.6
13037,Calhoun County,2021-10-04,1,3159,49.6
13037,Calhoun County,2021-10-05,3,3162,49.7
13037,Calhoun County,2021-10-06,3,3165,49.7
13037,Calhoun County,2021-10-07,1,3166,49.7
13039,Camden County,2020-12-15,2,2,0
13039,Camden County,2020-12-16,2,4,0
13039,Camden County,2020-12-17,11,15,0
13039,Camden County,2020-12-18,24,39,0.1
13039,Camden County,2020-12-21,12,51,0.1
13039,Camden County,2020-12-22,82,133,0.2
13039,Camden County,2020-12-23,16,149,0.3
13039,Camden County,2020-12-24,5,154,0.3
13039,Camden County,2020-12-27,1,155,0.3
13039,Camden County,2020-12-28,22,177,0.3
13039,Camden County,2020-12-29,25,202,0.4
13039,Camden County,2020-12-30,24,226,0.4
13039,Camden County,2020-12-31,14,240,0.5
13039,Camden County,2021-01-01,1,241,0.5
13039,Camden County,2021-01-02,1,242,0.5
13039,Camden County,2021-01-03,1,243,0.5
13039,Camden County,2021-01-04,11,254,0.5
13039,Camden County,2021-01-05,60,314,0.6
13039,Camden County,2021-01-06,29,343,0.6
13039,Camden County,2021-01-07,38,381,0.7
13039,Camden County,2021-01-08,37,418,0.8
13039,Camden County,2021-01-09,1,419,0.8
13039,Camden County,2021-01-10,2,421,0.8
13039,Camden County,2021-01-11,204,625,1.2
13039,Camden County,2021-01-12,29,654,1.2
13039,Camden County,2021-01-13,41,695,1.3
13039,Camden County,2021-01-14,148,843,1.6
13039,Camden County,2021-01-15,199,1042,2
13039,Camden County,2021-01-16,184,1226,2.3
13039,Camden County,2021-01-17,5,1231,2.3
13039,Camden County,2021-01-18,673,1904,3.6
13039,Camden County,2021-01-19,34,1938,3.6
13039,Camden County,2021-01-20,49,1987,3.7
13039,Camden County,2021-01-21,267,2254,4.2
13039,Camden County,2021-01-22,552,2806,5.3
13039,Camden County,2021-01-23,17,2823,5.3
13039,Camden County,2021-01-24,2,2825,5.3
13039,Camden County,2021-01-25,150,2975,5.6
13039,Camden County,2021-01-26,476,3451,6.5
13039,Camden County,2021-01-27,69,3520,6.6
13039,Camden County,2021-01-28,151,3671,6.9
13039,Camden County,2021-01-29,336,4007,7.5
13039,Camden County,2021-01-30,15,4022,7.6
13039,Camden County,2021-01-31,11,4033,7.6
13039,Camden County,2021-02-01,256,4289,8.1
13039,Camden County,2021-02-02,96,4385,8.2
13039,Camden County,2021-02-03,21,4406,8.3
13039,Camden County,2021-02-04,133,4539,8.5
13039,Camden County,2021-02-05,18,4557,8.6
13039,Camden County,2021-02-06,5,4562,8.6
13039,Camden County,2021-02-07,1,4563,8.6
13039,Camden County,2021-02-08,140,4703,8.8
13039,Camden County,2021-02-09,140,4843,9.1
13039,Camden County,2021-02-10,60,4903,9.2
13039,Camden County,2021-02-11,65,4968,9.3
13039,Camden County,2021-02-12,19,4987,9.4
13039,Camden County,2021-02-13,14,5001,9.4
13039,Camden County,2021-02-15,138,5139,9.7
13039,Camden County,2021-02-16,190,5329,10
13039,Camden County,2021-02-17,45,5374,10.1
13039,Camden County,2021-02-18,28,5402,10.1
13039,Camden County,2021-02-19,21,5423,10.2
13039,Camden County,2021-02-20,135,5558,10.4
13039,Camden County,2021-02-21,2,5560,10.4
13039,Camden County,2021-02-22,153,5713,10.7
13039,Camden County,2021-02-23,184,5897,11.1
13039,Camden County,2021-02-24,41,5938,11.2
13039,Camden County,2021-02-25,68,6006,11.3
13039,Camden County,2021-02-26,24,6030,11.3
13039,Camden County,2021-02-27,42,6072,11.4
13039,Camden County,2021-02-28,15,6087,11.4
13039,Camden County,2021-03-01,192,6279,11.8
13039,Camden County,2021-03-02,183,6462,12.1
13039,Camden County,2021-03-03,35,6497,12.2
13039,Camden County,2021-03-04,41,6538,12.3
13039,Camden County,2021-03-05,315,6853,12.9
13039,Camden County,2021-03-06,19,6872,12.9
13039,Camden County,2021-03-07,13,6885,12.9
13039,Camden County,2021-03-08,323,7208,13.5
13039,Camden County,2021-03-09,205,7413,13.9
13039,Camden County,2021-03-10,57,7470,14
13039,Camden County,2021-03-11,60,7530,14.1
13039,Camden County,2021-03-12,188,7718,14.5
13039,Camden County,2021-03-13,224,7942,14.9
13039,Camden County,2021-03-14,35,7977,15
13039,Camden County,2021-03-15,414,8391,15.8
13039,Camden County,2021-03-16,235,8626,16.2
13039,Camden County,2021-03-17,65,8691,16.3
13039,Camden County,2021-03-18,81,8772,16.5
13039,Camden County,2021-03-19,235,9007,16.9
13039,Camden County,2021-03-20,24,9031,17
13039,Camden County,2021-03-21,16,9047,17
13039,Camden County,2021-03-22,310,9357,17.6
13039,Camden County,2021-03-23,228,9585,18
13039,Camden County,2021-03-24,105,9690,18.2
13039,Camden County,2021-03-25,136,9826,18.5
13039,Camden County,2021-03-26,246,10072,18.9
13039,Camden County,2021-03-27,37,10109,19
13039,Camden County,2021-03-28,41,10150,19.1
13039,Camden County,2021-03-29,392,10542,19.8
13039,Camden County,2021-03-30,246,10788,20.3
13039,Camden County,2021-03-31,122,10910,20.5
13039,Camden County,2021-04-01,153,11063,20.8
13039,Camden County,2021-04-02,272,11335,21.3
13039,Camden County,2021-04-03,41,11376,21.4
13039,Camden County,2021-04-04,30,11406,21.4
13039,Camden County,2021-04-05,252,11658,21.9
13039,Camden County,2021-04-06,204,11862,22.3
13039,Camden County,2021-04-07,81,11943,22.4
13039,Camden County,2021-04-08,119,12062,22.7
13039,Camden County,2021-04-09,195,12257,23
13039,Camden County,2021-04-10,51,12308,23.1
13039,Camden County,2021-04-11,10,12318,23.1
13039,Camden County,2021-04-12,191,12509,23.5
13039,Camden County,2021-04-13,94,12603,23.7
13039,Camden County,2021-04-14,53,12656,23.8
13039,Camden County,2021-04-15,45,12701,23.9
13039,Camden County,2021-04-16,85,12786,24
13039,Camden County,2021-04-17,19,12805,24.1
13039,Camden County,2021-04-18,13,12818,24.1
13039,Camden County,2021-04-19,91,12909,24.3
13039,Camden County,2021-04-20,70,12979,24.4
13039,Camden County,2021-04-21,48,13027,24.5
13039,Camden County,2021-04-22,47,13074,24.6
13039,Camden County,2021-04-23,43,13117,24.6
13039,Camden County,2021-04-24,101,13218,24.8
13039,Camden County,2021-04-25,8,13226,24.8
13039,Camden County,2021-04-26,122,13348,25.1
13039,Camden County,2021-04-27,53,13401,25.2
13039,Camden County,2021-04-28,22,13423,25.2
13039,Camden County,2021-04-29,51,13474,25.3
13039,Camden County,2021-04-30,41,13515,25.4
13039,Camden County,2021-05-01,26,13541,25.4
13039,Camden County,2021-05-02,11,13552,25.5
13039,Camden County,2021-05-03,36,13588,25.5
13039,Camden County,2021-05-04,51,13639,25.6
13039,Camden County,2021-05-05,29,13668,25.7
13039,Camden County,2021-05-06,48,13716,25.8
13039,Camden County,2021-05-07,30,13746,25.8
13039,Camden County,2021-05-08,30,13776,25.9
13039,Camden County,2021-05-09,17,13793,25.9
13039,Camden County,2021-05-10,73,13866,26
13039,Camden County,2021-05-11,45,13911,26.1
13039,Camden County,2021-05-12,33,13944,26.2
13039,Camden County,2021-05-13,41,13985,26.3
13039,Camden County,2021-05-14,48,14033,26.4
13039,Camden County,2021-05-15,45,14078,26.4
13039,Camden County,2021-05-16,34,14112,26.5
13039,Camden County,2021-05-17,140,14252,26.8
13039,Camden County,2021-05-18,84,14336,26.9
13039,Camden County,2021-05-19,64,14400,27.1
13039,Camden County,2021-05-20,70,14470,27.2
13039,Camden County,2021-05-21,61,14531,27.3
13039,Camden County,2021-05-22,49,14580,27.4
13039,Camden County,2021-05-23,23,14603,27.4
13039,Camden County,2021-05-24,48,14651,27.5
13039,Camden County,2021-05-25,51,14702,27.6
13039,Camden County,2021-05-26,86,14788,27.8
13039,Camden County,2021-05-27,56,14844,27.9
13039,Camden County,2021-05-28,30,14874,27.9
13039,Camden County,2021-05-29,17,14891,28
13039,Camden County,2021-05-30,17,14908,28
13039,Camden County,2021-05-31,5,14913,28
13039,Camden County,2021-06-01,34,14947,28.1
13039,Camden County,2021-06-02,29,14976,28.1
13039,Camden County,2021-06-03,70,15046,28.3
13039,Camden County,2021-06-04,43,15089,28.3
13039,Camden County,2021-06-05,25,15114,28.4
13039,Camden County,2021-06-06,15,15129,28.4
13039,Camden County,2021-06-07,53,15182,28.5
13039,Camden County,2021-06-08,35,15217,28.6
13039,Camden County,2021-06-09,24,15241,28.6
13039,Camden County,2021-06-10,42,15283,28.7
13039,Camden County,2021-06-11,17,15300,28.7
13039,Camden County,2021-06-12,38,15338,28.8
13039,Camden County,2021-06-13,6,15344,28.8
13039,Camden County,2021-06-14,53,15397,28.9
13039,Camden County,2021-06-15,25,15422,29
13039,Camden County,2021-06-16,32,15454,29
13039,Camden County,2021-06-17,44,15498,29.1
13039,Camden County,2021-06-18,34,15532,29.2
13039,Camden County,2021-06-19,10,15542,29.2
13039,Camden County,2021-06-20,5,15547,29.2
13039,Camden County,2021-06-21,40,15587,29.3
13039,Camden County,2021-06-22,24,15611,29.3
13039,Camden County,2021-06-23,30,15641,29.4
13039,Camden County,2021-06-24,31,15672,29.4
13039,Camden County,2021-06-25,27,15699,29.5
13039,Camden County,2021-06-26,18,15717,29.5
13039,Camden County,2021-06-27,13,15730,29.6
13039,Camden County,2021-06-28,41,15771,29.6
13039,Camden County,2021-06-29,33,15804,29.7
13039,Camden County,2021-06-30,52,15856,29.8
13039,Camden County,2021-07-01,33,15889,29.8
13039,Camden County,2021-07-02,26,15915,29.9
13039,Camden County,2021-07-03,21,15936,29.9
13039,Camden County,2021-07-04,1,15937,29.9
13039,Camden County,2021-07-05,20,15957,30
13039,Camden County,2021-07-06,25,15982,30
13039,Camden County,2021-07-07,9,15991,30
13039,Camden County,2021-07-08,21,16012,30.1
13039,Camden County,2021-07-09,34,16046,30.1
13039,Camden County,2021-07-10,25,16071,30.2
13039,Camden County,2021-07-11,18,16089,30.2
13039,Camden County,2021-07-12,34,16123,30.3
13039,Camden County,2021-07-13,26,16149,30.3
13039,Camden County,2021-07-14,43,16192,30.4
13039,Camden County,2021-07-15,77,16269,30.6
13039,Camden County,2021-07-16,89,16358,30.7
13039,Camden County,2021-07-17,45,16403,30.8
13039,Camden County,2021-07-18,27,16430,30.9
13039,Camden County,2021-07-19,122,16552,31.1
13039,Camden County,2021-07-20,77,16629,31.2
13039,Camden County,2021-07-21,76,16705,31.4
13039,Camden County,2021-07-22,115,16820,31.6
13039,Camden County,2021-07-23,79,16899,31.7
13039,Camden County,2021-07-24,52,16951,31.8
13039,Camden County,2021-07-25,45,16996,31.9
13039,Camden County,2021-07-26,151,17147,32.2
13039,Camden County,2021-07-27,120,17267,32.4
13039,Camden County,2021-07-28,128,17395,32.7
13039,Camden County,2021-07-29,153,17548,33
13039,Camden County,2021-07-30,118,17666,33.2
13039,Camden County,2021-07-31,68,17734,33.3
13039,Camden County,2021-08-01,49,17783,33.4
13039,Camden County,2021-08-02,137,17920,33.7
13039,Camden County,2021-08-03,98,18018,33.8
13039,Camden County,2021-08-04,131,18149,34.1
13039,Camden County,2021-08-05,131,18280,34.3
13039,Camden County,2021-08-06,123,18403,34.6
13039,Camden County,2021-08-07,50,18453,34.7
13039,Camden County,2021-08-08,46,18499,34.8
13039,Camden County,2021-08-09,114,18613,35
13039,Camden County,2021-08-10,96,18709,35.1
13039,Camden County,2021-08-11,84,18793,35.3
13039,Camden County,2021-08-12,161,18954,35.6
13039,Camden County,2021-08-13,97,19051,35.8
13039,Camden County,2021-08-14,72,19123,35.9
13039,Camden County,2021-08-15,20,19143,36
13039,Camden County,2021-08-16,130,19273,36.2
13039,Camden County,2021-08-17,80,19353,36.4
13039,Camden County,2021-08-18,115,19468,36.6
13039,Camden County,2021-08-19,129,19597,36.8
13039,Camden County,2021-08-20,89,19686,37
13039,Camden County,2021-08-21,27,19713,37
13039,Camden County,2021-08-22,36,19749,37.1
13039,Camden County,2021-08-23,85,19834,37.3
13039,Camden County,2021-08-24,69,19903,37.4
13039,Camden County,2021-08-25,83,19986,37.5
13039,Camden County,2021-08-26,148,20134,37.8
13039,Camden County,2021-08-27,93,20227,38
13039,Camden County,2021-08-28,44,20271,38.1
13039,Camden County,2021-08-29,18,20289,38.1
13039,Camden County,2021-08-30,78,20367,38.3
13039,Camden County,2021-08-31,66,20433,38.4
13039,Camden County,2021-09-01,88,20521,38.6
13039,Camden County,2021-09-02,63,20584,38.7
13039,Camden County,2021-09-03,92,20676,38.8
13039,Camden County,2021-09-04,38,20714,38.9
13039,Camden County,2021-09-05,36,20750,39
13039,Camden County,2021-09-06,7,20757,39
13039,Camden County,2021-09-07,62,20819,39.1
13039,Camden County,2021-09-08,68,20887,39.2
13039,Camden County,2021-09-09,47,20934,39.3
13039,Camden County,2021-09-10,66,21000,39.5
13039,Camden County,2021-09-11,26,21026,39.5
13039,Camden County,2021-09-12,22,21048,39.5
13039,Camden County,2021-09-13,60,21108,39.7
13039,Camden County,2021-09-14,55,21163,39.8
13039,Camden County,2021-09-15,24,21187,39.8
13039,Camden County,2021-09-16,53,21240,39.9
13039,Camden County,2021-09-17,49,21289,40
13039,Camden County,2021-09-18,26,21315,40
13039,Camden County,2021-09-19,12,21327,40.1
13039,Camden County,2021-09-20,31,21358,40.1
13039,Camden County,2021-09-21,46,21404,40.2
13039,Camden County,2021-09-22,26,21430,40.3
13039,Camden County,2021-09-23,34,21464,40.3
13039,Camden County,2021-09-24,18,21482,40.4
13039,Camden County,2021-09-25,19,21501,40.4
13039,Camden County,2021-09-26,7,21508,40.4
13039,Camden County,2021-09-27,23,21531,40.4
13039,Camden County,2021-09-28,19,21550,40.5
13039,Camden County,2021-09-29,28,21578,40.5
13039,Camden County,2021-09-30,21,21599,40.6
13039,Camden County,2021-10-01,30,21629,40.6
13039,Camden County,2021-10-02,5,21634,40.6
13039,Camden County,2021-10-03,6,21640,40.7
13039,Camden County,2021-10-04,15,21655,40.7
13039,Camden County,2021-10-05,12,21667,40.7
13039,Camden County,2021-10-06,33,21700,40.8
13039,Camden County,2021-10-07,15,21715,40.8
13043,Candler County,2020-12-17,1,1,0
13043,Candler County,2020-12-18,1,2,0
13043,Candler County,2020-12-21,1,3,0
13043,Candler County,2020-12-22,5,8,0.1
13043,Candler County,2020-12-23,8,16,0.1
13043,Candler County,2020-12-24,2,18,0.2
13043,Candler County,2020-12-27,28,46,0.4
13043,Candler County,2020-12-28,12,58,0.5
13043,Candler County,2020-12-29,12,70,0.6
13043,Candler County,2020-12-30,11,81,0.7
13043,Candler County,2020-12-31,4,85,0.8
13043,Candler County,2021-01-01,3,88,0.8
13043,Candler County,2021-01-04,35,123,1.1
13043,Candler County,2021-01-05,17,140,1.3
13043,Candler County,2021-01-06,36,176,1.6
13043,Candler County,2021-01-07,17,193,1.8
13043,Candler County,2021-01-08,23,216,2
13043,Candler County,2021-01-09,2,218,2
13043,Candler County,2021-01-10,2,220,2
13043,Candler County,2021-01-11,67,287,2.7
13043,Candler County,2021-01-12,96,383,3.5
13043,Candler County,2021-01-13,40,423,3.9
13043,Candler County,2021-01-14,54,477,4.4
13043,Candler County,2021-01-15,36,513,4.7
13043,Candler County,2021-01-16,15,528,4.9
13043,Candler County,2021-01-17,10,538,5
13043,Candler County,2021-01-18,42,580,5.4
13043,Candler County,2021-01-19,47,627,5.8
13043,Candler County,2021-01-20,60,687,6.4
13043,Candler County,2021-01-21,129,816,7.5
13043,Candler County,2021-01-22,80,896,8.3
13043,Candler County,2021-01-23,12,908,8.4
13043,Candler County,2021-01-25,36,944,8.7
13043,Candler County,2021-01-26,32,976,9
13043,Candler County,2021-01-27,17,993,9.2
13043,Candler County,2021-01-28,43,1036,9.6
13043,Candler County,2021-01-29,24,1060,9.8
13043,Candler County,2021-01-30,5,1065,9.9
13043,Candler County,2021-02-01,19,1084,10
13043,Candler County,2021-02-02,43,1127,10.4
13043,Candler County,2021-02-03,11,1138,10.5
13043,Candler County,2021-02-04,12,1150,10.6
13043,Candler County,2021-02-05,98,1248,11.5
13043,Candler County,2021-02-08,22,1270,11.7
13043,Candler County,2021-02-09,46,1316,12.2
13043,Candler County,2021-02-10,53,1369,12.7
13043,Candler County,2021-02-11,4,1373,12.7
13043,Candler County,2021-02-12,23,1396,12.9
13043,Candler County,2021-02-13,17,1413,13.1
13043,Candler County,2021-02-15,12,1425,13.2
13043,Candler County,2021-02-16,13,1438,13.3
13043,Candler County,2021-02-17,8,1446,13.4
13043,Candler County,2021-02-18,25,1471,13.6
13043,Candler County,2021-02-19,34,1505,13.9
13043,Candler County,2021-02-20,1,1506,13.9
13043,Candler County,2021-02-21,1,1507,13.9
13043,Candler County,2021-02-22,10,1517,14
13043,Candler County,2021-02-23,9,1526,14.1
13043,Candler County,2021-02-24,10,1536,14.2
13043,Candler County,2021-02-25,37,1573,14.5
13043,Candler County,2021-02-26,36,1609,14.9
13043,Candler County,2021-02-27,5,1614,14.9
13043,Candler County,2021-03-01,22,1636,15.1
13043,Candler County,2021-03-02,10,1646,15.2
13043,Candler County,2021-03-03,9,1655,15.3
13043,Candler County,2021-03-04,17,1672,15.5
13043,Candler County,2021-03-05,36,1708,15.8
13043,Candler County,2021-03-06,4,1712,15.8
13043,Candler County,2021-03-07,2,1714,15.9
13043,Candler County,2021-03-08,14,1728,16
13043,Candler County,2021-03-09,34,1762,16.3
13043,Candler County,2021-03-10,28,1790,16.6
13043,Candler County,2021-03-11,30,1820,16.8
13043,Candler County,2021-03-12,65,1885,17.4
13043,Candler County,2021-03-13,23,1908,17.6
13043,Candler County,2021-03-14,2,1910,17.7
13043,Candler County,2021-03-15,71,1981,18.3
13043,Candler County,2021-03-16,45,2026,18.7
13043,Candler County,2021-03-17,54,2080,19.2
13043,Candler County,2021-03-18,33,2113,19.5
13043,Candler County,2021-03-19,87,2200,20.3
13043,Candler County,2021-03-20,4,2204,20.4
13043,Candler County,2021-03-21,6,2210,20.4
13043,Candler County,2021-03-22,32,2242,20.7
13043,Candler County,2021-03-23,26,2268,21
13043,Candler County,2021-03-24,26,2294,21.2
13043,Candler County,2021-03-25,30,2324,21.5
13043,Candler County,2021-03-26,78,2402,22.2
13043,Candler County,2021-03-27,47,2449,22.7
13043,Candler County,2021-03-28,8,2457,22.7
13043,Candler County,2021-03-29,41,2498,23.1
13043,Candler County,2021-03-30,21,2519,23.3
13043,Candler County,2021-03-31,31,2550,23.6
13043,Candler County,2021-04-01,35,2585,23.9
13043,Candler County,2021-04-02,49,2634,24.4
13043,Candler County,2021-04-03,8,2642,24.4
13043,Candler County,2021-04-04,1,2643,24.4
13043,Candler County,2021-04-05,52,2695,24.9
13043,Candler County,2021-04-06,37,2732,25.3
13043,Candler County,2021-04-07,35,2767,25.6
13043,Candler County,2021-04-08,36,2803,25.9
13043,Candler County,2021-04-09,25,2828,26.2
13043,Candler County,2021-04-10,8,2836,26.2
13043,Candler County,2021-04-11,4,2840,26.3
13043,Candler County,2021-04-12,23,2863,26.5
13043,Candler County,2021-04-13,14,2877,26.6
13043,Candler County,2021-04-14,9,2886,26.7
13043,Candler County,2021-04-15,18,2904,26.9
13043,Candler County,2021-04-16,30,2934,27.1
13043,Candler County,2021-04-17,7,2941,27.2
13043,Candler County,2021-04-18,1,2942,27.2
13043,Candler County,2021-04-19,7,2949,27.3
13043,Candler County,2021-04-20,64,3013,27.9
13043,Candler County,2021-04-21,7,3020,27.9
13043,Candler County,2021-04-22,12,3032,28
13043,Candler County,2021-04-23,11,3043,28.1
13043,Candler County,2021-04-24,5,3048,28.2
13043,Candler County,2021-04-25,7,3055,28.3
13043,Candler County,2021-04-26,8,3063,28.3
13043,Candler County,2021-04-27,7,3070,28.4
13043,Candler County,2021-04-28,11,3081,28.5
13043,Candler County,2021-04-29,10,3091,28.6
13043,Candler County,2021-04-30,34,3125,28.9
13043,Candler County,2021-05-01,29,3154,29.2
13043,Candler County,2021-05-03,4,3158,29.2
13043,Candler County,2021-05-04,12,3170,29.3
13043,Candler County,2021-05-05,10,3180,29.4
13043,Candler County,2021-05-06,9,3189,29.5
13043,Candler County,2021-05-07,22,3211,29.7
13043,Candler County,2021-05-08,2,3213,29.7
13043,Candler County,2021-05-09,2,3215,29.7
13043,Candler County,2021-05-10,5,3220,29.8
13043,Candler County,2021-05-11,26,3246,30
13043,Candler County,2021-05-12,8,3254,30.1
13043,Candler County,2021-05-13,10,3264,30.2
13043,Candler County,2021-05-14,19,3283,30.4
13043,Candler County,2021-05-15,7,3290,30.4
13043,Candler County,2021-05-16,1,3291,30.4
13043,Candler County,2021-05-17,8,3299,30.5
13043,Candler County,2021-05-18,34,3333,30.8
13043,Candler County,2021-05-19,6,3339,30.9
13043,Candler County,2021-05-20,20,3359,31.1
13043,Candler County,2021-05-21,13,3372,31.2
13043,Candler County,2021-05-22,4,3376,31.2
13043,Candler County,2021-05-23,2,3378,31.2
13043,Candler County,2021-05-24,4,3382,31.3
13043,Candler County,2021-05-25,4,3386,31.3
13043,Candler County,2021-05-26,14,3400,31.4
13043,Candler County,2021-05-27,9,3409,31.5
13043,Candler County,2021-05-28,12,3421,31.6
13043,Candler County,2021-05-29,6,3427,31.7
13043,Candler County,2021-05-31,1,3428,31.7
13043,Candler County,2021-06-01,13,3441,31.8
13043,Candler County,2021-06-02,4,3445,31.9
13043,Candler County,2021-06-03,10,3455,32
13043,Candler County,2021-06-04,9,3464,32
13043,Candler County,2021-06-05,1,3465,32
13043,Candler County,2021-06-06,2,3467,32.1
13043,Candler County,2021-06-07,8,3475,32.1
13043,Candler County,2021-06-08,7,3482,32.2
13043,Candler County,2021-06-09,6,3488,32.3
13043,Candler County,2021-06-10,6,3494,32.3
13043,Candler County,2021-06-11,9,3503,32.4
13043,Candler County,2021-06-12,6,3509,32.5
13043,Candler County,2021-06-14,2,3511,32.5
13043,Candler County,2021-06-15,7,3518,32.5
13043,Candler County,2021-06-16,4,3522,32.6
13043,Candler County,2021-06-17,19,3541,32.8
13043,Candler County,2021-06-18,5,3546,32.8
13043,Candler County,2021-06-19,8,3554,32.9
13043,Candler County,2021-06-20,1,3555,32.9
13043,Candler County,2021-06-21,6,3561,32.9
13043,Candler County,2021-06-22,7,3568,33
13043,Candler County,2021-06-23,14,3582,33.1
13043,Candler County,2021-06-24,6,3588,33.2
13043,Candler County,2021-06-25,10,3598,33.3
13043,Candler County,2021-06-27,2,3600,33.3
13043,Candler County,2021-06-28,12,3612,33.4
13043,Candler County,2021-06-29,6,3618,33.5
13043,Candler County,2021-06-30,3,3621,33.5
13043,Candler County,2021-07-01,6,3627,33.5
13043,Candler County,2021-07-02,6,3633,33.6
13043,Candler County,2021-07-03,5,3638,33.6
13043,Candler County,2021-07-05,2,3640,33.7
13043,Candler County,2021-07-07,4,3644,33.7
13043,Candler County,2021-07-08,4,3648,33.7
13043,Candler County,2021-07-09,7,3655,33.8
13043,Candler County,2021-07-10,2,3657,33.8
13043,Candler County,2021-07-11,3,3660,33.9
13043,Candler County,2021-07-12,4,3664,33.9
13043,Candler County,2021-07-13,2,3666,33.9
13043,Candler County,2021-07-14,2,3668,33.9
13043,Candler County,2021-07-15,4,3672,34
13043,Candler County,2021-07-16,6,3678,34
13043,Candler County,2021-07-17,1,3679,34
13043,Candler County,2021-07-19,18,3697,34.2
13043,Candler County,2021-07-20,9,3706,34.3
13043,Candler County,2021-07-21,4,3710,34.3
13043,Candler County,2021-07-22,11,3721,34.4
13043,Candler County,2021-07-23,20,3741,34.6
13043,Candler County,2021-07-24,5,3746,34.6
13043,Candler County,2021-07-25,3,3749,34.7
13043,Candler County,2021-07-26,16,3765,34.8
13043,Candler County,2021-07-27,7,3772,34.9
13043,Candler County,2021-07-28,14,3786,35
13043,Candler County,2021-07-29,50,3836,35.5
13043,Candler County,2021-07-30,36,3872,35.8
13043,Candler County,2021-07-31,9,3881,35.9
13043,Candler County,2021-08-01,3,3884,35.9
13043,Candler County,2021-08-02,11,3895,36
13043,Candler County,2021-08-03,17,3912,36.2
13043,Candler County,2021-08-04,14,3926,36.3
13043,Candler County,2021-08-05,20,3946,36.5
13043,Candler County,2021-08-06,41,3987,36.9
13043,Candler County,2021-08-07,13,4000,37
13043,Candler County,2021-08-08,3,4003,37
13043,Candler County,2021-08-09,20,4023,37.2
13043,Candler County,2021-08-10,22,4045,37.4
13043,Candler County,2021-08-11,33,4078,37.7
13043,Candler County,2021-08-12,35,4113,38
13043,Candler County,2021-08-13,51,4164,38.5
13043,Candler County,2021-08-14,11,4175,38.6
13043,Candler County,2021-08-15,9,4184,38.7
13043,Candler County,2021-08-16,30,4214,39
13043,Candler County,2021-08-17,30,4244,39.3
13043,Candler County,2021-08-18,28,4272,39.5
13043,Candler County,2021-08-19,21,4293,39.7
13043,Candler County,2021-08-20,58,4351,40.2
13043,Candler County,2021-08-21,5,4356,40.3
13043,Candler County,2021-08-22,4,4360,40.3
13043,Candler County,2021-08-23,12,4372,40.4
13043,Candler County,2021-08-24,19,4391,40.6
13043,Candler County,2021-08-25,27,4418,40.9
13043,Candler County,2021-08-26,23,4441,41.1
13043,Candler County,2021-08-27,64,4505,41.7
13043,Candler County,2021-08-28,18,4523,41.8
13043,Candler County,2021-08-29,1,4524,41.8
13043,Candler County,2021-08-30,17,4541,42
13043,Candler County,2021-08-31,26,4567,42.2
13043,Candler County,2021-09-01,20,4587,42.4
13043,Candler County,2021-09-02,14,4601,42.6
13043,Candler County,2021-09-03,33,4634,42.9
13043,Candler County,2021-09-04,12,4646,43
13043,Candler County,2021-09-05,5,4651,43
13043,Candler County,2021-09-07,10,4661,43.1
13043,Candler County,2021-09-08,16,4677,43.3
13043,Candler County,2021-09-09,9,4686,43.3
13043,Candler County,2021-09-10,17,4703,43.5
13043,Candler County,2021-09-11,7,4710,43.6
13043,Candler County,2021-09-13,7,4717,43.6
13043,Candler County,2021-09-14,10,4727,43.7
13043,Candler County,2021-09-15,16,4743,43.9
13043,Candler County,2021-09-16,11,4754,44
13043,Candler County,2021-09-17,10,4764,44.1
13043,Candler County,2021-09-18,3,4767,44.1
13043,Candler County,2021-09-19,2,4769,44.1
13043,Candler County,2021-09-20,7,4776,44.2
13043,Candler County,2021-09-21,5,4781,44.2
13043,Candler County,2021-09-22,7,4788,44.3
13043,Candler County,2021-09-23,7,4795,44.3
13043,Candler County,2021-09-24,3,4798,44.4
13043,Candler County,2021-09-25,2,4800,44.4
13043,Candler County,2021-09-27,5,4805,44.4
13043,Candler County,2021-09-28,3,4808,44.5
13043,Candler County,2021-09-29,4,4812,44.5
13043,Candler County,2021-09-30,1,4813,44.5
13043,Candler County,2021-10-01,2,4815,44.5
13043,Candler County,2021-10-03,1,4816,44.5
13043,Candler County,2021-10-04,3,4819,44.6
13043,Candler County,2021-10-05,5,4824,44.6
13043,Candler County,2021-10-06,3,4827,44.6
13045,Carroll County,2020-12-16,1,1,0
13045,Carroll County,2020-12-18,8,9,0
13045,Carroll County,2020-12-19,3,12,0
13045,Carroll County,2020-12-20,4,16,0
13045,Carroll County,2020-12-21,19,35,0
13045,Carroll County,2020-12-22,167,202,0.2
13045,Carroll County,2020-12-23,273,475,0.4
13045,Carroll County,2020-12-24,47,522,0.4
13045,Carroll County,2020-12-26,6,528,0.5
13045,Carroll County,2020-12-27,10,538,0.5
13045,Carroll County,2020-12-28,151,689,0.6
13045,Carroll County,2020-12-29,155,844,0.7
13045,Carroll County,2020-12-30,70,914,0.8
13045,Carroll County,2020-12-31,135,1049,0.9
13045,Carroll County,2021-01-01,7,1056,0.9
13045,Carroll County,2021-01-02,7,1063,0.9
13045,Carroll County,2021-01-03,73,1136,1
13045,Carroll County,2021-01-04,213,1349,1.2
13045,Carroll County,2021-01-05,126,1475,1.3
13045,Carroll County,2021-01-06,82,1557,1.3
13045,Carroll County,2021-01-07,244,1801,1.5
13045,Carroll County,2021-01-08,78,1879,1.6
13045,Carroll County,2021-01-09,21,1900,1.6
13045,Carroll County,2021-01-10,69,1969,1.7
13045,Carroll County,2021-01-11,86,2055,1.8
13045,Carroll County,2021-01-12,1018,3073,2.6
13045,Carroll County,2021-01-13,247,3320,2.8
13045,Carroll County,2021-01-14,365,3685,3.1
13045,Carroll County,2021-01-15,235,3920,3.3
13045,Carroll County,2021-01-16,134,4054,3.5
13045,Carroll County,2021-01-17,34,4088,3.5
13045,Carroll County,2021-01-18,494,4582,3.9
13045,Carroll County,2021-01-19,565,5147,4.4
13045,Carroll County,2021-01-20,742,5889,5
13045,Carroll County,2021-01-21,267,6156,5.3
13045,Carroll County,2021-01-22,195,6351,5.4
13045,Carroll County,2021-01-23,88,6439,5.5
13045,Carroll County,2021-01-24,32,6471,5.5
13045,Carroll County,2021-01-25,161,6632,5.7
13045,Carroll County,2021-01-26,139,6771,5.8
13045,Carroll County,2021-01-27,1063,7834,6.7
13045,Carroll County,2021-01-28,279,8113,6.9
13045,Carroll County,2021-01-29,121,8234,7
13045,Carroll County,2021-01-30,30,8264,7.1
13045,Carroll County,2021-01-31,29,8293,7.1
13045,Carroll County,2021-02-01,96,8389,7.2
13045,Carroll County,2021-02-02,139,8528,7.3
13045,Carroll County,2021-02-03,188,8716,7.4
13045,Carroll County,2021-02-04,178,8894,7.6
13045,Carroll County,2021-02-05,99,8993,7.7
13045,Carroll County,2021-02-06,28,9021,7.7
13045,Carroll County,2021-02-07,5,9026,7.7
13045,Carroll County,2021-02-08,31,9057,7.7
13045,Carroll County,2021-02-09,119,9176,7.8
13045,Carroll County,2021-02-10,122,9298,7.9
13045,Carroll County,2021-02-11,65,9363,8
13045,Carroll County,2021-02-12,51,9414,8
13045,Carroll County,2021-02-13,38,9452,8.1
13045,Carroll County,2021-02-14,15,9467,8.1
13045,Carroll County,2021-02-15,58,9525,8.1
13045,Carroll County,2021-02-16,52,9577,8.2
13045,Carroll County,2021-02-17,441,10018,8.5
13045,Carroll County,2021-02-18,86,10104,8.6
13045,Carroll County,2021-02-19,55,10159,8.7
13045,Carroll County,2021-02-20,16,10175,8.7
13045,Carroll County,2021-02-21,8,10183,8.7
13045,Carroll County,2021-02-22,51,10234,8.7
13045,Carroll County,2021-02-23,454,10688,9.1
13045,Carroll County,2021-02-24,140,10828,9.2
13045,Carroll County,2021-02-25,95,10923,9.3
13045,Carroll County,2021-02-26,117,11040,9.4
13045,Carroll County,2021-02-27,47,11087,9.5
13045,Carroll County,2021-02-28,87,11174,9.5
13045,Carroll County,2021-03-01,111,11285,9.6
13045,Carroll County,2021-03-02,380,11665,10
13045,Carroll County,2021-03-03,175,11840,10.1
13045,Carroll County,2021-03-04,155,11995,10.2
13045,Carroll County,2021-03-05,183,12178,10.4
13045,Carroll County,2021-03-06,64,12242,10.4
13045,Carroll County,2021-03-07,69,12311,10.5
13045,Carroll County,2021-03-08,199,12510,10.7
13045,Carroll County,2021-03-09,273,12783,10.9
13045,Carroll County,2021-03-10,1109,13892,11.9
13045,Carroll County,2021-03-11,182,14074,12
13045,Carroll County,2021-03-12,295,14369,12.3
13045,Carroll County,2021-03-13,138,14507,12.4
13045,Carroll County,2021-03-14,57,14564,12.4
13045,Carroll County,2021-03-15,285,14849,12.7
13045,Carroll County,2021-03-16,774,15623,13.3
13045,Carroll County,2021-03-17,662,16285,13.9
13045,Carroll County,2021-03-18,294,16579,14.1
13045,Carroll County,2021-03-19,375,16954,14.5
13045,Carroll County,2021-03-20,137,17091,14.6
13045,Carroll County,2021-03-21,114,17205,14.7
13045,Carroll County,2021-03-22,307,17512,14.9
13045,Carroll County,2021-03-23,339,17851,15.2
13045,Carroll County,2021-03-24,360,18211,15.5
13045,Carroll County,2021-03-25,396,18607,15.9
13045,Carroll County,2021-03-26,427,19034,16.2
13045,Carroll County,2021-03-27,184,19218,16.4
13045,Carroll County,2021-03-28,134,19352,16.5
13045,Carroll County,2021-03-29,275,19627,16.7
13045,Carroll County,2021-03-30,1378,21005,17.9
13045,Carroll County,2021-03-31,863,21868,18.7
13045,Carroll County,2021-04-01,670,22538,19.2
13045,Carroll County,2021-04-02,296,22834,19.5
13045,Carroll County,2021-04-03,142,22976,19.6
13045,Carroll County,2021-04-04,139,23115,19.7
13045,Carroll County,2021-04-05,269,23384,20
13045,Carroll County,2021-04-06,442,23826,20.3
13045,Carroll County,2021-04-07,526,24352,20.8
13045,Carroll County,2021-04-08,472,24824,21.2
13045,Carroll County,2021-04-09,298,25122,21.4
13045,Carroll County,2021-04-10,224,25346,21.6
13045,Carroll County,2021-04-11,144,25490,21.8
13045,Carroll County,2021-04-12,321,25811,22
13045,Carroll County,2021-04-13,273,26084,22.3
13045,Carroll County,2021-04-14,516,26600,22.7
13045,Carroll County,2021-04-15,307,26907,23
13045,Carroll County,2021-04-16,200,27107,23.1
13045,Carroll County,2021-04-17,326,27433,23.4
13045,Carroll County,2021-04-18,66,27499,23.5
13045,Carroll County,2021-04-19,144,27643,23.6
13045,Carroll County,2021-04-20,263,27906,23.8
13045,Carroll County,2021-04-21,257,28163,24
13045,Carroll County,2021-04-22,349,28512,24.3
13045,Carroll County,2021-04-23,254,28766,24.5
13045,Carroll County,2021-04-24,84,28850,24.6
13045,Carroll County,2021-04-25,45,28895,24.7
13045,Carroll County,2021-04-26,177,29072,24.8
13045,Carroll County,2021-04-27,413,29485,25.2
13045,Carroll County,2021-04-28,422,29907,25.5
13045,Carroll County,2021-04-29,184,30091,25.7
13045,Carroll County,2021-04-30,226,30317,25.9
13045,Carroll County,2021-05-01,108,30425,26
13045,Carroll County,2021-05-02,65,30490,26
13045,Carroll County,2021-05-03,125,30615,26.1
13045,Carroll County,2021-05-04,145,30760,26.2
13045,Carroll County,2021-05-05,171,30931,26.4
13045,Carroll County,2021-05-06,163,31094,26.5
13045,Carroll County,2021-05-07,219,31313,26.7
13045,Carroll County,2021-05-08,114,31427,26.8
13045,Carroll County,2021-05-09,53,31480,26.9
13045,Carroll County,2021-05-10,65,31545,26.9
13045,Carroll County,2021-05-11,140,31685,27
13045,Carroll County,2021-05-12,118,31803,27.1
13045,Carroll County,2021-05-13,132,31935,27.3
13045,Carroll County,2021-05-14,199,32134,27.4
13045,Carroll County,2021-05-15,207,32341,27.6
13045,Carroll County,2021-05-16,85,32426,27.7
13045,Carroll County,2021-05-17,147,32573,27.8
13045,Carroll County,2021-05-18,169,32742,27.9
13045,Carroll County,2021-05-19,247,32989,28.2
13045,Carroll County,2021-05-20,172,33161,28.3
13045,Carroll County,2021-05-21,195,33356,28.5
13045,Carroll County,2021-05-22,103,33459,28.6
13045,Carroll County,2021-05-23,56,33515,28.6
13045,Carroll County,2021-05-24,127,33642,28.7
13045,Carroll County,2021-05-25,91,33733,28.8
13045,Carroll County,2021-05-26,113,33846,28.9
13045,Carroll County,2021-05-27,89,33935,29
13045,Carroll County,2021-05-28,126,34061,29.1
13045,Carroll County,2021-05-29,74,34135,29.1
13045,Carroll County,2021-05-30,31,34166,29.2
13045,Carroll County,2021-05-31,17,34183,29.2
13045,Carroll County,2021-06-01,80,34263,29.2
13045,Carroll County,2021-06-02,101,34364,29.3
13045,Carroll County,2021-06-03,89,34453,29.4
13045,Carroll County,2021-06-04,106,34559,29.5
13045,Carroll County,2021-06-05,68,34627,29.5
13045,Carroll County,2021-06-06,33,34660,29.6
13045,Carroll County,2021-06-07,69,34729,29.6
13045,Carroll County,2021-06-08,84,34813,29.7
13045,Carroll County,2021-06-09,72,34885,29.8
13045,Carroll County,2021-06-10,86,34971,29.8
13045,Carroll County,2021-06-11,91,35062,29.9
13045,Carroll County,2021-06-12,50,35112,30
13045,Carroll County,2021-06-13,17,35129,30
13045,Carroll County,2021-06-14,77,35206,30
13045,Carroll County,2021-06-15,54,35260,30.1
13045,Carroll County,2021-06-16,65,35325,30.1
13045,Carroll County,2021-06-17,81,35406,30.2
13045,Carroll County,2021-06-18,81,35487,30.3
13045,Carroll County,2021-06-19,57,35544,30.3
13045,Carroll County,2021-06-20,14,35558,30.3
13045,Carroll County,2021-06-21,59,35617,30.4
13045,Carroll County,2021-06-22,76,35693,30.5
13045,Carroll County,2021-06-23,70,35763,30.5
13045,Carroll County,2021-06-24,41,35804,30.6
13045,Carroll County,2021-06-25,82,35886,30.6
13045,Carroll County,2021-06-26,48,35934,30.7
13045,Carroll County,2021-06-27,17,35951,30.7
13045,Carroll County,2021-06-28,47,35998,30.7
13045,Carroll County,2021-06-29,59,36057,30.8
13045,Carroll County,2021-06-30,45,36102,30.8
13045,Carroll County,2021-07-01,46,36148,30.8
13045,Carroll County,2021-07-02,74,36222,30.9
13045,Carroll County,2021-07-03,41,36263,30.9
13045,Carroll County,2021-07-04,1,36264,30.9
13045,Carroll County,2021-07-05,32,36296,31
13045,Carroll County,2021-07-06,61,36357,31
13045,Carroll County,2021-07-07,109,36466,31.1
13045,Carroll County,2021-07-08,48,36514,31.2
13045,Carroll County,2021-07-09,66,36580,31.2
13045,Carroll County,2021-07-10,43,36623,31.3
13045,Carroll County,2021-07-11,20,36643,31.3
13045,Carroll County,2021-07-12,56,36699,31.3
13045,Carroll County,2021-07-13,61,36760,31.4
13045,Carroll County,2021-07-14,65,36825,31.4
13045,Carroll County,2021-07-15,95,36920,31.5
13045,Carroll County,2021-07-16,85,37005,31.6
13045,Carroll County,2021-07-17,63,37068,31.6
13045,Carroll County,2021-07-18,41,37109,31.7
13045,Carroll County,2021-07-19,89,37198,31.7
13045,Carroll County,2021-07-20,91,37289,31.8
13045,Carroll County,2021-07-21,96,37385,31.9
13045,Carroll County,2021-07-22,118,37503,32
13045,Carroll County,2021-07-23,128,37631,32.1
13045,Carroll County,2021-07-24,93,37724,32.2
13045,Carroll County,2021-07-25,91,37815,32.3
13045,Carroll County,2021-07-26,143,37958,32.4
13045,Carroll County,2021-07-27,150,38108,32.5
13045,Carroll County,2021-07-28,128,38236,32.6
13045,Carroll County,2021-07-29,172,38408,32.8
13045,Carroll County,2021-07-30,277,38685,33
13045,Carroll County,2021-07-31,116,38801,33.1
13045,Carroll County,2021-08-01,89,38890,33.2
13045,Carroll County,2021-08-02,171,39061,33.3
13045,Carroll County,2021-08-03,199,39260,33.5
13045,Carroll County,2021-08-04,176,39436,33.7
13045,Carroll County,2021-08-05,165,39601,33.8
13045,Carroll County,2021-08-06,220,39821,34
13045,Carroll County,2021-08-07,136,39957,34.1
13045,Carroll County,2021-08-08,74,40031,34.2
13045,Carroll County,2021-08-09,180,40211,34.3
13045,Carroll County,2021-08-10,224,40435,34.5
13045,Carroll County,2021-08-11,145,40580,34.6
13045,Carroll County,2021-08-12,182,40762,34.8
13045,Carroll County,2021-08-13,266,41028,35
13045,Carroll County,2021-08-14,118,41146,35.1
13045,Carroll County,2021-08-15,70,41216,35.2
13045,Carroll County,2021-08-16,175,41391,35.3
13045,Carroll County,2021-08-17,154,41545,35.5
13045,Carroll County,2021-08-18,165,41710,35.6
13045,Carroll County,2021-08-19,173,41883,35.7
13045,Carroll County,2021-08-20,252,42135,36
13045,Carroll County,2021-08-21,148,42283,36.1
13045,Carroll County,2021-08-22,82,42365,36.2
13045,Carroll County,2021-08-23,191,42556,36.3
13045,Carroll County,2021-08-24,161,42717,36.5
13045,Carroll County,2021-08-25,207,42924,36.6
13045,Carroll County,2021-08-26,265,43189,36.9
13045,Carroll County,2021-08-27,248,43437,37.1
13045,Carroll County,2021-08-28,123,43560,37.2
13045,Carroll County,2021-08-29,75,43635,37.2
13045,Carroll County,2021-08-30,166,43801,37.4
13045,Carroll County,2021-08-31,120,43921,37.5
13045,Carroll County,2021-09-01,314,44235,37.7
13045,Carroll County,2021-09-02,132,44367,37.9
13045,Carroll County,2021-09-03,196,44563,38
13045,Carroll County,2021-09-04,110,44673,38.1
13045,Carroll County,2021-09-05,84,44757,38.2
13045,Carroll County,2021-09-06,31,44788,38.2
13045,Carroll County,2021-09-07,114,44902,38.3
13045,Carroll County,2021-09-08,164,45066,38.5
13045,Carroll County,2021-09-09,149,45215,38.6
13045,Carroll County,2021-09-10,186,45401,38.7
13045,Carroll County,2021-09-11,103,45504,38.8
13045,Carroll County,2021-09-12,61,45565,38.9
13045,Carroll County,2021-09-13,127,45692,39
13045,Carroll County,2021-09-14,111,45803,39.1
13045,Carroll County,2021-09-15,105,45908,39.2
13045,Carroll County,2021-09-16,124,46032,39.3
13045,Carroll County,2021-09-17,131,46163,39.4
13045,Carroll County,2021-09-18,73,46236,39.5
13045,Carroll County,2021-09-19,46,46282,39.5
13045,Carroll County,2021-09-20,81,46363,39.6
13045,Carroll County,2021-09-21,80,46443,39.6
13045,Carroll County,2021-09-22,71,46514,39.7
13045,Carroll County,2021-09-23,55,46569,39.7
13045,Carroll County,2021-09-24,69,46638,39.8
13045,Carroll County,2021-09-25,39,46677,39.8
13045,Carroll County,2021-09-26,24,46701,39.9
13045,Carroll County,2021-09-27,36,46737,39.9
13045,Carroll County,2021-09-28,44,46781,39.9
13045,Carroll County,2021-09-29,45,46826,40
13045,Carroll County,2021-09-30,38,46864,40
13045,Carroll County,2021-10-01,49,46913,40
13045,Carroll County,2021-10-02,26,46939,40.1
13045,Carroll County,2021-10-03,19,46958,40.1
13045,Carroll County,2021-10-04,16,46974,40.1
13045,Carroll County,2021-10-05,44,47018,40.1
13045,Carroll County,2021-10-06,33,47051,40.2
13045,Carroll County,2021-10-07,24,47075,40.2
13047,Catoosa County,2020-12-17,1,1,0
13047,Catoosa County,2020-12-18,37,38,0.1
13047,Catoosa County,2020-12-19,2,40,0.1
13047,Catoosa County,2020-12-20,7,47,0.1
13047,Catoosa County,2020-12-21,40,87,0.1
13047,Catoosa County,2020-12-22,39,126,0.2
13047,Catoosa County,2020-12-23,25,151,0.2
13047,Catoosa County,2020-12-24,3,154,0.2
13047,Catoosa County,2020-12-26,1,155,0.2
13047,Catoosa County,2020-12-27,3,158,0.2
13047,Catoosa County,2020-12-28,59,217,0.3
13047,Catoosa County,2020-12-29,35,252,0.4
13047,Catoosa County,2020-12-30,38,290,0.4
13047,Catoosa County,2020-12-31,16,306,0.5
13047,Catoosa County,2021-01-01,3,309,0.5
13047,Catoosa County,2021-01-03,38,347,0.5
13047,Catoosa County,2021-01-04,40,387,0.6
13047,Catoosa County,2021-01-05,48,435,0.7
13047,Catoosa County,2021-01-06,50,485,0.7
13047,Catoosa County,2021-01-07,46,531,0.8
13047,Catoosa County,2021-01-08,82,613,0.9
13047,Catoosa County,2021-01-09,20,633,0.9
13047,Catoosa County,2021-01-10,4,637,1
13047,Catoosa County,2021-01-11,100,737,1.1
13047,Catoosa County,2021-01-12,198,935,1.4
13047,Catoosa County,2021-01-13,364,1299,1.9
13047,Catoosa County,2021-01-14,438,1737,2.6
13047,Catoosa County,2021-01-15,317,2054,3.1
13047,Catoosa County,2021-01-16,45,2099,3.1
13047,Catoosa County,2021-01-17,12,2111,3.2
13047,Catoosa County,2021-01-18,475,2586,3.9
13047,Catoosa County,2021-01-19,352,2938,4.4
13047,Catoosa County,2021-01-20,429,3367,5
13047,Catoosa County,2021-01-21,265,3632,5.4
13047,Catoosa County,2021-01-22,37,3669,5.5
13047,Catoosa County,2021-01-23,11,3680,5.5
13047,Catoosa County,2021-01-24,6,3686,5.5
13047,Catoosa County,2021-01-25,56,3742,5.6
13047,Catoosa County,2021-01-26,306,4048,6.1
13047,Catoosa County,2021-01-27,692,4740,7.1
13047,Catoosa County,2021-01-28,864,5604,8.4
13047,Catoosa County,2021-01-29,74,5678,8.5
13047,Catoosa County,2021-01-30,6,5684,8.5
13047,Catoosa County,2021-01-31,1,5685,8.5
13047,Catoosa County,2021-02-01,223,5908,8.9
13047,Catoosa County,2021-02-02,123,6031,9
13047,Catoosa County,2021-02-03,847,6878,10.3
13047,Catoosa County,2021-02-04,130,7008,10.5
13047,Catoosa County,2021-02-05,63,7071,10.6
13047,Catoosa County,2021-02-06,1,7072,10.6
13047,Catoosa County,2021-02-07,3,7075,10.6
13047,Catoosa County,2021-02-08,106,7181,10.8
13047,Catoosa County,2021-02-09,26,7207,10.8
13047,Catoosa County,2021-02-10,349,7556,11.3
13047,Catoosa County,2021-02-11,37,7593,11.4
13047,Catoosa County,2021-02-12,16,7609,11.4
13047,Catoosa County,2021-02-13,6,7615,11.4
13047,Catoosa County,2021-02-14,6,7621,11.4
13047,Catoosa County,2021-02-15,195,7816,11.7
13047,Catoosa County,2021-02-16,27,7843,11.8
13047,Catoosa County,2021-02-17,22,7865,11.8
13047,Catoosa County,2021-02-18,26,7891,11.8
13047,Catoosa County,2021-02-19,23,7914,11.9
13047,Catoosa County,2021-02-20,6,7920,11.9
13047,Catoosa County,2021-02-21,1,7921,11.9
13047,Catoosa County,2021-02-22,25,7946,11.9
13047,Catoosa County,2021-02-23,19,7965,11.9
13047,Catoosa County,2021-02-24,126,8091,12.1
13047,Catoosa County,2021-02-25,143,8234,12.3
13047,Catoosa County,2021-02-26,54,8288,12.4
13047,Catoosa County,2021-02-27,8,8296,12.4
13047,Catoosa County,2021-02-28,15,8311,12.5
13047,Catoosa County,2021-03-01,39,8350,12.5
13047,Catoosa County,2021-03-02,224,8574,12.9
13047,Catoosa County,2021-03-03,519,9093,13.6
13047,Catoosa County,2021-03-04,161,9254,13.9
13047,Catoosa County,2021-03-05,78,9332,14
13047,Catoosa County,2021-03-06,12,9344,14
13047,Catoosa County,2021-03-07,18,9362,14
13047,Catoosa County,2021-03-08,95,9457,14.2
13047,Catoosa County,2021-03-09,205,9662,14.5
13047,Catoosa County,2021-03-10,922,10584,15.9
13047,Catoosa County,2021-03-11,264,10848,16.3
13047,Catoosa County,2021-03-12,170,11018,16.5
13047,Catoosa County,2021-03-13,20,11038,16.5
13047,Catoosa County,2021-03-14,18,11056,16.6
13047,Catoosa County,2021-03-15,114,11170,16.7
13047,Catoosa County,2021-03-16,121,11291,16.9
13047,Catoosa County,2021-03-17,667,11958,17.9
13047,Catoosa County,2021-03-18,607,12565,18.8
13047,Catoosa County,2021-03-19,102,12667,19
13047,Catoosa County,2021-03-20,32,12699,19
13047,Catoosa County,2021-03-21,25,12724,19.1
13047,Catoosa County,2021-03-22,108,12832,19.2
13047,Catoosa County,2021-03-23,97,12929,19.4
13047,Catoosa County,2021-03-24,616,13545,20.3
13047,Catoosa County,2021-03-25,392,13937,20.9
13047,Catoosa County,2021-03-26,558,14495,21.7
13047,Catoosa County,2021-03-27,35,14530,21.8
13047,Catoosa County,2021-03-28,53,14583,21.9
13047,Catoosa County,2021-03-29,125,14708,22.1
13047,Catoosa County,2021-03-30,191,14899,22.3
13047,Catoosa County,2021-03-31,411,15310,23
13047,Catoosa County,2021-04-01,611,15921,23.9
13047,Catoosa County,2021-04-02,137,16058,24.1
13047,Catoosa County,2021-04-03,30,16088,24.1
13047,Catoosa County,2021-04-04,46,16134,24.2
13047,Catoosa County,2021-04-05,138,16272,24.4
13047,Catoosa County,2021-04-06,126,16398,24.6
13047,Catoosa County,2021-04-07,193,16591,24.9
13047,Catoosa County,2021-04-08,305,16896,25.3
13047,Catoosa County,2021-04-09,168,17064,25.6
13047,Catoosa County,2021-04-10,218,17282,25.9
13047,Catoosa County,2021-04-11,41,17323,26
13047,Catoosa County,2021-04-12,111,17434,26.1
13047,Catoosa County,2021-04-13,71,17505,26.2
13047,Catoosa County,2021-04-14,117,17622,26.4
13047,Catoosa County,2021-04-15,70,17692,26.5
13047,Catoosa County,2021-04-16,90,17782,26.7
13047,Catoosa County,2021-04-17,13,17795,26.7
13047,Catoosa County,2021-04-18,20,17815,26.7
13047,Catoosa County,2021-04-19,49,17864,26.8
13047,Catoosa County,2021-04-20,61,17925,26.9
13047,Catoosa County,2021-04-21,186,18111,27.2
13047,Catoosa County,2021-04-22,127,18238,27.3
13047,Catoosa County,2021-04-23,116,18354,27.5
13047,Catoosa County,2021-04-24,39,18393,27.6
13047,Catoosa County,2021-04-25,11,18404,27.6
13047,Catoosa County,2021-04-26,57,18461,27.7
13047,Catoosa County,2021-04-27,48,18509,27.7
13047,Catoosa County,2021-04-28,74,18583,27.9
13047,Catoosa County,2021-04-29,115,18698,28
13047,Catoosa County,2021-04-30,91,18789,28.2
13047,Catoosa County,2021-05-01,29,18818,28.2
13047,Catoosa County,2021-05-02,18,18836,28.2
13047,Catoosa County,2021-05-03,57,18893,28.3
13047,Catoosa County,2021-05-04,53,18946,28.4
13047,Catoosa County,2021-05-05,59,19005,28.5
13047,Catoosa County,2021-05-06,127,19132,28.7
13047,Catoosa County,2021-05-07,61,19193,28.8
13047,Catoosa County,2021-05-08,33,19226,28.8
13047,Catoosa County,2021-05-09,11,19237,28.8
13047,Catoosa County,2021-05-10,39,19276,28.9
13047,Catoosa County,2021-05-11,45,19321,29
13047,Catoosa County,2021-05-12,46,19367,29
13047,Catoosa County,2021-05-13,175,19542,29.3
13047,Catoosa County,2021-05-14,75,19617,29.4
13047,Catoosa County,2021-05-15,53,19670,29.5
13047,Catoosa County,2021-05-16,36,19706,29.5
13047,Catoosa County,2021-05-17,69,19775,29.6
13047,Catoosa County,2021-05-18,65,19840,29.7
13047,Catoosa County,2021-05-19,51,19891,29.8
13047,Catoosa County,2021-05-20,84,19975,29.9
13047,Catoosa County,2021-05-21,62,20037,30
13047,Catoosa County,2021-05-22,282,20319,30.5
13047,Catoosa County,2021-05-23,33,20352,30.5
13047,Catoosa County,2021-05-24,48,20400,30.6
13047,Catoosa County,2021-05-25,55,20455,30.7
13047,Catoosa County,2021-05-26,45,20500,30.7
13047,Catoosa County,2021-05-27,45,20545,30.8
13047,Catoosa County,2021-05-28,35,20580,30.9
13047,Catoosa County,2021-05-29,32,20612,30.9
13047,Catoosa County,2021-05-30,15,20627,30.9
13047,Catoosa County,2021-05-31,10,20637,30.9
13047,Catoosa County,2021-06-01,35,20672,31
13047,Catoosa County,2021-06-02,27,20699,31
13047,Catoosa County,2021-06-03,62,20761,31.1
13047,Catoosa County,2021-06-04,46,20807,31.2
13047,Catoosa County,2021-06-05,23,20830,31.2
13047,Catoosa County,2021-06-06,9,20839,31.2
13047,Catoosa County,2021-06-07,20,20859,31.3
13047,Catoosa County,2021-06-08,26,20885,31.3
13047,Catoosa County,2021-06-09,21,20906,31.3
13047,Catoosa County,2021-06-10,46,20952,31.4
13047,Catoosa County,2021-06-11,48,21000,31.5
13047,Catoosa County,2021-06-12,19,21019,31.5
13047,Catoosa County,2021-06-13,5,21024,31.5
13047,Catoosa County,2021-06-14,45,21069,31.6
13047,Catoosa County,2021-06-15,33,21102,31.6
13047,Catoosa County,2021-06-16,32,21134,31.7
13047,Catoosa County,2021-06-17,63,21197,31.8
13047,Catoosa County,2021-06-18,39,21236,31.8
13047,Catoosa County,2021-06-19,17,21253,31.9
13047,Catoosa County,2021-06-20,7,21260,31.9
13047,Catoosa County,2021-06-21,19,21279,31.9
13047,Catoosa County,2021-06-22,30,21309,31.9
13047,Catoosa County,2021-06-23,27,21336,32
13047,Catoosa County,2021-06-24,41,21377,32
13047,Catoosa County,2021-06-25,34,21411,32.1
13047,Catoosa County,2021-06-26,17,21428,32.1
13047,Catoosa County,2021-06-27,7,21435,32.1
13047,Catoosa County,2021-06-28,23,21458,32.2
13047,Catoosa County,2021-06-29,14,21472,32.2
13047,Catoosa County,2021-06-30,23,21495,32.2
13047,Catoosa County,2021-07-01,56,21551,32.3
13047,Catoosa County,2021-07-02,33,21584,32.4
13047,Catoosa County,2021-07-03,15,21599,32.4
13047,Catoosa County,2021-07-04,4,21603,32.4
13047,Catoosa County,2021-07-05,6,21609,32.4
13047,Catoosa County,2021-07-06,22,21631,32.4
13047,Catoosa County,2021-07-07,12,21643,32.4
13047,Catoosa County,2021-07-08,45,21688,32.5
13047,Catoosa County,2021-07-09,33,21721,32.6
13047,Catoosa County,2021-07-10,14,21735,32.6
13047,Catoosa County,2021-07-11,8,21743,32.6
13047,Catoosa County,2021-07-12,20,21763,32.6
13047,Catoosa County,2021-07-13,17,21780,32.7
13047,Catoosa County,2021-07-14,37,21817,32.7
13047,Catoosa County,2021-07-15,59,21876,32.8
13047,Catoosa County,2021-07-16,38,21914,32.9
13047,Catoosa County,2021-07-17,22,21936,32.9
13047,Catoosa County,2021-07-18,17,21953,32.9
13047,Catoosa County,2021-07-19,29,21982,33
13047,Catoosa County,2021-07-20,51,22033,33
13047,Catoosa County,2021-07-21,33,22066,33.1
13047,Catoosa County,2021-07-22,141,22207,33.3
13047,Catoosa County,2021-07-23,74,22281,33.4
13047,Catoosa County,2021-07-24,55,22336,33.5
13047,Catoosa County,2021-07-25,30,22366,33.5
13047,Catoosa County,2021-07-26,61,22427,33.6
13047,Catoosa County,2021-07-27,70,22497,33.7
13047,Catoosa County,2021-07-28,62,22559,33.8
13047,Catoosa County,2021-07-29,134,22693,34
13047,Catoosa County,2021-07-30,86,22779,34.2
13047,Catoosa County,2021-07-31,52,22831,34.2
13047,Catoosa County,2021-08-01,43,22874,34.3
13047,Catoosa County,2021-08-02,67,22941,34.4
13047,Catoosa County,2021-08-03,67,23008,34.5
13047,Catoosa County,2021-08-04,83,23091,34.6
13047,Catoosa County,2021-08-05,168,23259,34.9
13047,Catoosa County,2021-08-06,97,23356,35
13047,Catoosa County,2021-08-07,70,23426,35.1
13047,Catoosa County,2021-08-08,56,23482,35.2
13047,Catoosa County,2021-08-09,77,23559,35.3
13047,Catoosa County,2021-08-10,94,23653,35.5
13047,Catoosa County,2021-08-11,84,23737,35.6
13047,Catoosa County,2021-08-12,171,23908,35.8
13047,Catoosa County,2021-08-13,129,24037,36
13047,Catoosa County,2021-08-14,77,24114,36.2
13047,Catoosa County,2021-08-15,62,24176,36.2
13047,Catoosa County,2021-08-16,88,24264,36.4
13047,Catoosa County,2021-08-17,109,24373,36.5
13047,Catoosa County,2021-08-18,77,24450,36.7
13047,Catoosa County,2021-08-19,190,24640,36.9
13047,Catoosa County,2021-08-20,126,24766,37.1
13047,Catoosa County,2021-08-21,86,24852,37.3
13047,Catoosa County,2021-08-22,45,24897,37.3
13047,Catoosa County,2021-08-23,84,24981,37.5
13047,Catoosa County,2021-08-24,114,25095,37.6
13047,Catoosa County,2021-08-25,89,25184,37.8
13047,Catoosa County,2021-08-26,152,25336,38
13047,Catoosa County,2021-08-27,81,25417,38.1
13047,Catoosa County,2021-08-28,88,25505,38.2
13047,Catoosa County,2021-08-29,40,25545,38.3
13047,Catoosa County,2021-08-30,69,25614,38.4
13047,Catoosa County,2021-08-31,71,25685,38.5
13047,Catoosa County,2021-09-01,76,25761,38.6
13047,Catoosa County,2021-09-02,114,25875,38.8
13047,Catoosa County,2021-09-03,83,25958,38.9
13047,Catoosa County,2021-09-04,57,26015,39
13047,Catoosa County,2021-09-05,45,26060,39.1
13047,Catoosa County,2021-09-06,12,26072,39.1
13047,Catoosa County,2021-09-07,71,26143,39.2
13047,Catoosa County,2021-09-08,61,26204,39.3
13047,Catoosa County,2021-09-09,109,26313,39.4
13047,Catoosa County,2021-09-10,81,26394,39.6
13047,Catoosa County,2021-09-11,37,26431,39.6
13047,Catoosa County,2021-09-12,39,26470,39.7
13047,Catoosa County,2021-09-13,50,26520,39.8
13047,Catoosa County,2021-09-14,42,26562,39.8
13047,Catoosa County,2021-09-15,51,26613,39.9
13047,Catoosa County,2021-09-16,79,26692,40
13047,Catoosa County,2021-09-17,59,26751,40.1
13047,Catoosa County,2021-09-18,43,26794,40.2
13047,Catoosa County,2021-09-19,26,26820,40.2
13047,Catoosa County,2021-09-20,35,26855,40.3
13047,Catoosa County,2021-09-21,31,26886,40.3
13047,Catoosa County,2021-09-22,34,26920,40.4
13047,Catoosa County,2021-09-23,37,26957,40.4
13047,Catoosa County,2021-09-24,28,26985,40.5
13047,Catoosa County,2021-09-25,20,27005,40.5
13047,Catoosa County,2021-09-26,10,27015,40.5
13047,Catoosa County,2021-09-27,21,27036,40.5
13047,Catoosa County,2021-09-28,12,27048,40.6
13047,Catoosa County,2021-09-29,22,27070,40.6
13047,Catoosa County,2021-09-30,30,27100,40.6
13047,Catoosa County,2021-10-01,15,27115,40.7
13047,Catoosa County,2021-10-02,10,27125,40.7
13047,Catoosa County,2021-10-03,15,27140,40.7
13047,Catoosa County,2021-10-04,7,27147,40.7
13047,Catoosa County,2021-10-05,3,27150,40.7
13047,Catoosa County,2021-10-06,19,27169,40.7
13047,Catoosa County,2021-10-07,9,27178,40.7
13049,Charlton County,2020-12-16,1,1,0
13049,Charlton County,2020-12-18,1,2,0
13049,Charlton County,2020-12-20,1,3,0
13049,Charlton County,2020-12-22,6,9,0.1
13049,Charlton County,2020-12-24,1,10,0.1
13049,Charlton County,2020-12-28,2,12,0.1
13049,Charlton County,2020-12-29,1,13,0.1
13049,Charlton County,2020-12-30,2,15,0.1
13049,Charlton County,2020-12-31,1,16,0.1
13049,Charlton County,2021-01-03,1,17,0.1
13049,Charlton County,2021-01-04,1,18,0.1
13049,Charlton County,2021-01-05,4,22,0.2
13049,Charlton County,2021-01-06,5,27,0.2
13049,Charlton County,2021-01-07,17,44,0.3
13049,Charlton County,2021-01-08,5,49,0.4
13049,Charlton County,2021-01-10,1,50,0.4
13049,Charlton County,2021-01-11,11,61,0.5
13049,Charlton County,2021-01-12,7,68,0.5
13049,Charlton County,2021-01-13,23,91,0.7
13049,Charlton County,2021-01-14,5,96,0.7
13049,Charlton County,2021-01-15,13,109,0.8
13049,Charlton County,2021-01-16,28,137,1.1
13049,Charlton County,2021-01-18,29,166,1.3
13049,Charlton County,2021-01-19,2,168,1.3
13049,Charlton County,2021-01-20,23,191,1.5
13049,Charlton County,2021-01-21,33,224,1.7
13049,Charlton County,2021-01-22,30,254,1.9
13049,Charlton County,2021-01-23,1,255,2
13049,Charlton County,2021-01-24,2,257,2
13049,Charlton County,2021-01-25,9,266,2
13049,Charlton County,2021-01-26,11,277,2.1
13049,Charlton County,2021-01-27,23,300,2.3
13049,Charlton County,2021-01-28,3,303,2.3
13049,Charlton County,2021-01-29,18,321,2.5
13049,Charlton County,2021-01-30,15,336,2.6
13049,Charlton County,2021-02-01,16,352,2.7
13049,Charlton County,2021-02-02,1,353,2.7
13049,Charlton County,2021-02-03,27,380,2.9
13049,Charlton County,2021-02-04,7,387,3
13049,Charlton County,2021-02-05,11,398,3.1
13049,Charlton County,2021-02-06,2,400,3.1
13049,Charlton County,2021-02-08,16,416,3.2
13049,Charlton County,2021-02-09,8,424,3.3
13049,Charlton County,2021-02-10,24,448,3.4
13049,Charlton County,2021-02-11,5,453,3.5
13049,Charlton County,2021-02-12,23,476,3.7
13049,Charlton County,2021-02-13,19,495,3.8
13049,Charlton County,2021-02-15,34,529,4.1
13049,Charlton County,2021-02-16,8,537,4.1
13049,Charlton County,2021-02-17,42,579,4.4
13049,Charlton County,2021-02-18,2,581,4.5
13049,Charlton County,2021-02-19,11,592,4.5
13049,Charlton County,2021-02-20,12,604,4.6
13049,Charlton County,2021-02-22,27,631,4.8
13049,Charlton County,2021-02-23,23,654,5
13049,Charlton County,2021-02-24,31,685,5.3
13049,Charlton County,2021-02-25,8,693,5.3
13049,Charlton County,2021-02-26,4,697,5.3
13049,Charlton County,2021-02-27,3,700,5.4
13049,Charlton County,2021-03-01,13,713,5.5
13049,Charlton County,2021-03-02,31,744,5.7
13049,Charlton County,2021-03-03,5,749,5.7
13049,Charlton County,2021-03-04,22,771,5.9
13049,Charlton County,2021-03-05,29,800,6.1
13049,Charlton County,2021-03-06,5,805,6.2
13049,Charlton County,2021-03-07,3,808,6.2
13049,Charlton County,2021-03-08,27,835,6.4
13049,Charlton County,2021-03-09,13,848,6.5
13049,Charlton County,2021-03-10,22,870,6.7
13049,Charlton County,2021-03-11,45,915,7
13049,Charlton County,2021-03-12,54,969,7.4
13049,Charlton County,2021-03-13,3,972,7.5
13049,Charlton County,2021-03-14,7,979,7.5
13049,Charlton County,2021-03-15,36,1015,7.8
13049,Charlton County,2021-03-16,39,1054,8.1
13049,Charlton County,2021-03-17,11,1065,8.2
13049,Charlton County,2021-03-18,34,1099,8.4
13049,Charlton County,2021-03-19,14,1113,8.5
13049,Charlton County,2021-03-20,2,1115,8.6
13049,Charlton County,2021-03-21,4,1119,8.6
13049,Charlton County,2021-03-22,25,1144,8.8
13049,Charlton County,2021-03-23,31,1175,9
13049,Charlton County,2021-03-24,30,1205,9.2
13049,Charlton County,2021-03-25,53,1258,9.6
13049,Charlton County,2021-03-26,25,1283,9.8
13049,Charlton County,2021-03-27,6,1289,9.9
13049,Charlton County,2021-03-28,4,1293,9.9
13049,Charlton County,2021-03-29,40,1333,10.2
13049,Charlton County,2021-03-30,30,1363,10.5
13049,Charlton County,2021-03-31,21,1384,10.6
13049,Charlton County,2021-04-01,38,1422,10.9
13049,Charlton County,2021-04-02,24,1446,11.1
13049,Charlton County,2021-04-03,8,1454,11.2
13049,Charlton County,2021-04-04,2,1456,11.2
13049,Charlton County,2021-04-05,8,1464,11.2
13049,Charlton County,2021-04-06,30,1494,11.5
13049,Charlton County,2021-04-07,15,1509,11.6
13049,Charlton County,2021-04-08,47,1556,11.9
13049,Charlton County,2021-04-09,16,1572,12.1
13049,Charlton County,2021-04-10,7,1579,12.1
13049,Charlton County,2021-04-11,5,1584,12.1
13049,Charlton County,2021-04-12,17,1601,12.3
13049,Charlton County,2021-04-13,27,1628,12.5
13049,Charlton County,2021-04-14,10,1638,12.6
13049,Charlton County,2021-04-15,28,1666,12.8
13049,Charlton County,2021-04-16,8,1674,12.8
13049,Charlton County,2021-04-17,2,1676,12.9
13049,Charlton County,2021-04-19,4,1680,12.9
13049,Charlton County,2021-04-20,16,1696,13
13049,Charlton County,2021-04-21,11,1707,13.1
13049,Charlton County,2021-04-22,20,1727,13.2
13049,Charlton County,2021-04-23,5,1732,13.3
13049,Charlton County,2021-04-24,6,1738,13.3
13049,Charlton County,2021-04-26,12,1750,13.4
13049,Charlton County,2021-04-27,10,1760,13.5
13049,Charlton County,2021-04-28,6,1766,13.5
13049,Charlton County,2021-04-29,21,1787,13.7
13049,Charlton County,2021-04-30,12,1799,13.8
13049,Charlton County,2021-05-01,3,1802,13.8
13049,Charlton County,2021-05-02,1,1803,13.8
13049,Charlton County,2021-05-03,12,1815,13.9
13049,Charlton County,2021-05-04,8,1823,14
13049,Charlton County,2021-05-05,8,1831,14
13049,Charlton County,2021-05-06,15,1846,14.2
13049,Charlton County,2021-05-07,2,1848,14.2
13049,Charlton County,2021-05-08,3,1851,14.2
13049,Charlton County,2021-05-10,5,1856,14.2
13049,Charlton County,2021-05-11,11,1867,14.3
13049,Charlton County,2021-05-12,7,1874,14.4
13049,Charlton County,2021-05-13,11,1885,14.5
13049,Charlton County,2021-05-14,3,1888,14.5
13049,Charlton County,2021-05-15,2,1890,14.5
13049,Charlton County,2021-05-17,7,1897,14.5
13049,Charlton County,2021-05-18,17,1914,14.7
13049,Charlton County,2021-05-19,7,1921,14.7
13049,Charlton County,2021-05-20,16,1937,14.9
13049,Charlton County,2021-05-21,4,1941,14.9
13049,Charlton County,2021-05-22,5,1946,14.9
13049,Charlton County,2021-05-23,1,1947,14.9
13049,Charlton County,2021-05-24,5,1952,15
13049,Charlton County,2021-05-25,9,1961,15
13049,Charlton County,2021-05-26,6,1967,15.1
13049,Charlton County,2021-05-27,10,1977,15.2
13049,Charlton County,2021-05-28,5,1982,15.2
13049,Charlton County,2021-05-29,3,1985,15.2
13049,Charlton County,2021-05-30,2,1987,15.2
13049,Charlton County,2021-06-01,8,1995,15.3
13049,Charlton County,2021-06-02,3,1998,15.3
13049,Charlton County,2021-06-03,12,2010,15.4
13049,Charlton County,2021-06-04,3,2013,15.4
13049,Charlton County,2021-06-07,6,2019,15.5
13049,Charlton County,2021-06-08,10,2029,15.6
13049,Charlton County,2021-06-09,3,2032,15.6
13049,Charlton County,2021-06-10,6,2038,15.6
13049,Charlton County,2021-06-11,2,2040,15.6
13049,Charlton County,2021-06-12,2,2042,15.7
13049,Charlton County,2021-06-14,1,2043,15.7
13049,Charlton County,2021-06-15,3,2046,15.7
13049,Charlton County,2021-06-17,6,2052,15.7
13049,Charlton County,2021-06-18,4,2056,15.8
13049,Charlton County,2021-06-19,3,2059,15.8
13049,Charlton County,2021-06-20,4,2063,15.8
13049,Charlton County,2021-06-21,2,2065,15.8
13049,Charlton County,2021-06-22,4,2069,15.9
13049,Charlton County,2021-06-23,1,2070,15.9
13049,Charlton County,2021-06-24,1,2071,15.9
13049,Charlton County,2021-06-25,1,2072,15.9
13049,Charlton County,2021-06-28,6,2078,15.9
13049,Charlton County,2021-06-29,6,2084,16
13049,Charlton County,2021-06-30,9,2093,16.1
13049,Charlton County,2021-07-02,2,2095,16.1
13049,Charlton County,2021-07-06,2,2097,16.1
13049,Charlton County,2021-07-07,3,2100,16.1
13049,Charlton County,2021-07-08,4,2104,16.1
13049,Charlton County,2021-07-09,6,2110,16.2
13049,Charlton County,2021-07-10,1,2111,16.2
13049,Charlton County,2021-07-11,2,2113,16.2
13049,Charlton County,2021-07-12,6,2119,16.3
13049,Charlton County,2021-07-13,9,2128,16.3
13049,Charlton County,2021-07-14,9,2137,16.4
13049,Charlton County,2021-07-15,10,2147,16.5
13049,Charlton County,2021-07-16,6,2153,16.5
13049,Charlton County,2021-07-17,1,2154,16.5
13049,Charlton County,2021-07-18,2,2156,16.5
13049,Charlton County,2021-07-19,9,2165,16.6
13049,Charlton County,2021-07-20,21,2186,16.8
13049,Charlton County,2021-07-21,14,2200,16.9
13049,Charlton County,2021-07-22,29,2229,17.1
13049,Charlton County,2021-07-23,13,2242,17.2
13049,Charlton County,2021-07-24,2,2244,17.2
13049,Charlton County,2021-07-25,3,2247,17.2
13049,Charlton County,2021-07-26,28,2275,17.4
13049,Charlton County,2021-07-27,54,2329,17.9
13049,Charlton County,2021-07-28,34,2363,18.1
13049,Charlton County,2021-07-29,44,2407,18.5
13049,Charlton County,2021-07-30,39,2446,18.8
13049,Charlton County,2021-07-31,3,2449,18.8
13049,Charlton County,2021-08-01,3,2452,18.8
13049,Charlton County,2021-08-02,36,2488,19.1
13049,Charlton County,2021-08-03,47,2535,19.4
13049,Charlton County,2021-08-04,23,2558,19.6
13049,Charlton County,2021-08-05,16,2574,19.7
13049,Charlton County,2021-08-06,26,2600,19.9
13049,Charlton County,2021-08-07,7,2607,20
13049,Charlton County,2021-08-08,8,2615,20.1
13049,Charlton County,2021-08-09,21,2636,20.2
13049,Charlton County,2021-08-10,13,2649,20.3
13049,Charlton County,2021-08-11,18,2667,20.5
13049,Charlton County,2021-08-12,37,2704,20.7
13049,Charlton County,2021-08-13,42,2746,21.1
13049,Charlton County,2021-08-14,7,2753,21.1
13049,Charlton County,2021-08-15,1,2754,21.1
13049,Charlton County,2021-08-16,23,2777,21.3
13049,Charlton County,2021-08-17,25,2802,21.5
13049,Charlton County,2021-08-18,18,2820,21.6
13049,Charlton County,2021-08-19,30,2850,21.9
13049,Charlton County,2021-08-20,23,2873,22
13049,Charlton County,2021-08-21,6,2879,22.1
13049,Charlton County,2021-08-22,4,2883,22.1
13049,Charlton County,2021-08-23,28,2911,22.3
13049,Charlton County,2021-08-24,21,2932,22.5
13049,Charlton County,2021-08-25,18,2950,22.6
13049,Charlton County,2021-08-26,15,2965,22.7
13049,Charlton County,2021-08-27,23,2988,22.9
13049,Charlton County,2021-08-28,13,3001,23
13049,Charlton County,2021-08-29,2,3003,23
13049,Charlton County,2021-08-30,16,3019,23.2
13049,Charlton County,2021-08-31,10,3029,23.2
13049,Charlton County,2021-09-01,18,3047,23.4
13049,Charlton County,2021-09-02,6,3053,23.4
13049,Charlton County,2021-09-03,19,3072,23.6
13049,Charlton County,2021-09-04,1,3073,23.6
13049,Charlton County,2021-09-05,2,3075,23.6
13049,Charlton County,2021-09-06,17,3092,23.7
13049,Charlton County,2021-09-07,10,3102,23.8
13049,Charlton County,2021-09-08,5,3107,23.8
13049,Charlton County,2021-09-09,10,3117,23.9
13049,Charlton County,2021-09-10,17,3134,24
13049,Charlton County,2021-09-11,4,3138,24.1
13049,Charlton County,2021-09-12,2,3140,24.1
13049,Charlton County,2021-09-13,9,3149,24.1
13049,Charlton County,2021-09-14,2,3151,24.2
13049,Charlton County,2021-09-15,4,3155,24.2
13049,Charlton County,2021-09-16,9,3164,24.3
13049,Charlton County,2021-09-17,9,3173,24.3
13049,Charlton County,2021-09-20,4,3177,24.4
13049,Charlton County,2021-09-21,2,3179,24.4
13049,Charlton County,2021-09-22,1,3180,24.4
13049,Charlton County,2021-09-23,4,3184,24.4
13049,Charlton County,2021-09-24,9,3193,24.5
13049,Charlton County,2021-09-25,6,3199,24.5
13049,Charlton County,2021-09-26,1,3200,24.5
13049,Charlton County,2021-09-28,1,3201,24.5
13049,Charlton County,2021-09-29,5,3206,24.6
13049,Charlton County,2021-09-30,3,3209,24.6
13049,Charlton County,2021-10-01,3,3212,24.6
13049,Charlton County,2021-10-04,3,3215,24.7
13049,Charlton County,2021-10-05,4,3219,24.7
13049,Charlton County,2021-10-06,2,3221,24.7
13049,Charlton County,2021-10-07,3,3224,24.7
13051,Chatham County,2020-12-12,1,1,0
13051,Chatham County,2020-12-14,4,5,0
13051,Chatham County,2020-12-15,80,85,0
13051,Chatham County,2020-12-16,372,457,0.2
13051,Chatham County,2020-12-17,227,684,0.2
13051,Chatham County,2020-12-18,898,1582,0.5
13051,Chatham County,2020-12-19,167,1749,0.6
13051,Chatham County,2020-12-20,38,1787,0.6
13051,Chatham County,2020-12-21,390,2177,0.8
13051,Chatham County,2020-12-22,411,2588,0.9
13051,Chatham County,2020-12-23,409,2997,1
13051,Chatham County,2020-12-24,54,3051,1.1
13051,Chatham County,2020-12-26,8,3059,1.1
13051,Chatham County,2020-12-27,33,3092,1.1
13051,Chatham County,2020-12-28,242,3334,1.2
13051,Chatham County,2020-12-29,342,3676,1.3
13051,Chatham County,2020-12-30,561,4237,1.5
13051,Chatham County,2020-12-31,172,4409,1.5
13051,Chatham County,2021-01-01,52,4461,1.5
13051,Chatham County,2021-01-02,30,4491,1.6
13051,Chatham County,2021-01-03,20,4511,1.6
13051,Chatham County,2021-01-04,236,4747,1.6
13051,Chatham County,2021-01-05,319,5066,1.8
13051,Chatham County,2021-01-06,670,5736,2
13051,Chatham County,2021-01-07,593,6329,2.2
13051,Chatham County,2021-01-08,507,6836,2.4
13051,Chatham County,2021-01-09,512,7348,2.5
13051,Chatham County,2021-01-10,124,7472,2.6
13051,Chatham County,2021-01-11,1218,8690,3
13051,Chatham County,2021-01-12,1010,9700,3.4
13051,Chatham County,2021-01-13,1171,10871,3.8
13051,Chatham County,2021-01-14,1804,12675,4.4
13051,Chatham County,2021-01-15,1188,13863,4.8
13051,Chatham County,2021-01-16,582,14445,5
13051,Chatham County,2021-01-17,478,14923,5.2
13051,Chatham County,2021-01-18,1357,16280,5.6
13051,Chatham County,2021-01-19,1516,17796,6.2
13051,Chatham County,2021-01-20,1528,19324,6.7
13051,Chatham County,2021-01-21,1714,21038,7.3
13051,Chatham County,2021-01-22,1138,22176,7.7
13051,Chatham County,2021-01-23,532,22708,7.9
13051,Chatham County,2021-01-24,330,23038,8
13051,Chatham County,2021-01-25,1113,24151,8.4
13051,Chatham County,2021-01-26,1065,25216,8.7
13051,Chatham County,2021-01-27,1029,26245,9.1
13051,Chatham County,2021-01-28,1599,27844,9.7
13051,Chatham County,2021-01-29,1880,29724,10.3
13051,Chatham County,2021-01-30,612,30336,10.5
13051,Chatham County,2021-01-31,374,30710,10.6
13051,Chatham County,2021-02-01,1527,32237,11.2
13051,Chatham County,2021-02-02,1178,33415,11.6
13051,Chatham County,2021-02-03,649,34064,11.8
13051,Chatham County,2021-02-04,1190,35254,12.2
13051,Chatham County,2021-02-05,914,36168,12.5
13051,Chatham County,2021-02-06,632,36800,12.8
13051,Chatham County,2021-02-07,74,36874,12.8
13051,Chatham County,2021-02-08,609,37483,13
13051,Chatham County,2021-02-09,914,38397,13.3
13051,Chatham County,2021-02-10,376,38773,13.4
13051,Chatham County,2021-02-11,712,39485,13.7
13051,Chatham County,2021-02-12,989,40474,14
13051,Chatham County,2021-02-13,456,40930,14.2
13051,Chatham County,2021-02-14,69,40999,14.2
13051,Chatham County,2021-02-15,640,41639,14.4
13051,Chatham County,2021-02-16,822,42461,14.7
13051,Chatham County,2021-02-17,692,43153,15
13051,Chatham County,2021-02-18,1040,44193,15.3
13051,Chatham County,2021-02-19,671,44864,15.6
13051,Chatham County,2021-02-20,254,45118,15.6
13051,Chatham County,2021-02-21,34,45152,15.7
13051,Chatham County,2021-02-22,564,45716,15.8
13051,Chatham County,2021-02-23,757,46473,16.1
13051,Chatham County,2021-02-24,743,47216,16.4
13051,Chatham County,2021-02-25,940,48156,16.7
13051,Chatham County,2021-02-26,594,48750,16.9
13051,Chatham County,2021-02-27,209,48959,17
13051,Chatham County,2021-02-28,128,49087,17
13051,Chatham County,2021-03-01,781,49868,17.3
13051,Chatham County,2021-03-02,1112,50980,17.7
13051,Chatham County,2021-03-03,689,51669,17.9
13051,Chatham County,2021-03-04,902,52571,18.2
13051,Chatham County,2021-03-05,616,53187,18.4
13051,Chatham County,2021-03-06,232,53419,18.5
13051,Chatham County,2021-03-07,219,53638,18.6
13051,Chatham County,2021-03-08,1166,54804,19
13051,Chatham County,2021-03-09,1320,56124,19.5
13051,Chatham County,2021-03-10,1112,57236,19.8
13051,Chatham County,2021-03-11,1348,58584,20.3
13051,Chatham County,2021-03-12,928,59512,20.6
13051,Chatham County,2021-03-13,2149,61661,21.4
13051,Chatham County,2021-03-14,296,61957,21.5
13051,Chatham County,2021-03-15,1481,63438,22
13051,Chatham County,2021-03-16,2148,65586,22.7
13051,Chatham County,2021-03-17,1347,66933,23.2
13051,Chatham County,2021-03-18,1660,68593,23.8
13051,Chatham County,2021-03-19,1452,70045,24.3
13051,Chatham County,2021-03-20,1152,71197,24.7
13051,Chatham County,2021-03-21,410,71607,24.8
13051,Chatham County,2021-03-22,1513,73120,25.3
13051,Chatham County,2021-03-23,2246,75366,26.1
13051,Chatham County,2021-03-24,2148,77514,26.9
13051,Chatham County,2021-03-25,2799,80313,27.8
13051,Chatham County,2021-03-26,1728,82041,28.4
13051,Chatham County,2021-03-27,1262,83303,28.9
13051,Chatham County,2021-03-28,365,83668,29
13051,Chatham County,2021-03-29,1426,85094,29.5
13051,Chatham County,2021-03-30,2642,87736,30.4
13051,Chatham County,2021-03-31,1928,89664,31.1
13051,Chatham County,2021-04-01,1938,91602,31.8
13051,Chatham County,2021-04-02,1140,92742,32.1
13051,Chatham County,2021-04-03,561,93303,32.3
13051,Chatham County,2021-04-04,209,93512,32.4
13051,Chatham County,2021-04-05,997,94509,32.8
13051,Chatham County,2021-04-06,1446,95955,33.3
13051,Chatham County,2021-04-07,1315,97270,33.7
13051,Chatham County,2021-04-08,1765,99035,34.3
13051,Chatham County,2021-04-09,1027,100062,34.7
13051,Chatham County,2021-04-10,623,100685,34.9
13051,Chatham County,2021-04-11,183,100868,35
13051,Chatham County,2021-04-12,710,101578,35.2
13051,Chatham County,2021-04-13,955,102533,35.5
13051,Chatham County,2021-04-14,840,103373,35.8
13051,Chatham County,2021-04-15,1109,104482,36.2
13051,Chatham County,2021-04-16,581,105063,36.4
13051,Chatham County,2021-04-17,459,105522,36.6
13051,Chatham County,2021-04-18,98,105620,36.6
13051,Chatham County,2021-04-19,364,105984,36.7
13051,Chatham County,2021-04-20,555,106539,36.9
13051,Chatham County,2021-04-21,553,107092,37.1
13051,Chatham County,2021-04-22,682,107774,37.4
13051,Chatham County,2021-04-23,537,108311,37.5
13051,Chatham County,2021-04-24,295,108606,37.6
13051,Chatham County,2021-04-25,81,108687,37.7
13051,Chatham County,2021-04-26,422,109109,37.8
13051,Chatham County,2021-04-27,462,109571,38
13051,Chatham County,2021-04-28,485,110056,38.1
13051,Chatham County,2021-04-29,600,110656,38.4
13051,Chatham County,2021-04-30,521,111177,38.5
13051,Chatham County,2021-05-01,379,111556,38.7
13051,Chatham County,2021-05-02,122,111678,38.7
13051,Chatham County,2021-05-03,350,112028,38.8
13051,Chatham County,2021-05-04,489,112517,39
13051,Chatham County,2021-05-05,433,112950,39.2
13051,Chatham County,2021-05-06,451,113401,39.3
13051,Chatham County,2021-05-07,423,113824,39.5
13051,Chatham County,2021-05-08,249,114073,39.5
13051,Chatham County,2021-05-09,82,114155,39.6
13051,Chatham County,2021-05-10,226,114381,39.6
13051,Chatham County,2021-05-11,437,114818,39.8
13051,Chatham County,2021-05-12,412,115230,39.9
13051,Chatham County,2021-05-13,485,115715,40.1
13051,Chatham County,2021-05-14,624,116339,40.3
13051,Chatham County,2021-05-15,562,116901,40.5
13051,Chatham County,2021-05-16,202,117103,40.6
13051,Chatham County,2021-05-17,553,117656,40.8
13051,Chatham County,2021-05-18,497,118153,41
13051,Chatham County,2021-05-19,469,118622,41.1
13051,Chatham County,2021-05-20,495,119117,41.3
13051,Chatham County,2021-05-21,477,119594,41.5
13051,Chatham County,2021-05-22,347,119941,41.6
13051,Chatham County,2021-05-23,161,120102,41.6
13051,Chatham County,2021-05-24,403,120505,41.8
13051,Chatham County,2021-05-25,384,120889,41.9
13051,Chatham County,2021-05-26,329,121218,42
13051,Chatham County,2021-05-27,458,121676,42.2
13051,Chatham County,2021-05-28,331,122007,42.3
13051,Chatham County,2021-05-29,135,122142,42.3
13051,Chatham County,2021-05-30,82,122224,42.4
13051,Chatham County,2021-05-31,32,122256,42.4
13051,Chatham County,2021-06-01,436,122692,42.5
13051,Chatham County,2021-06-02,335,123027,42.6
13051,Chatham County,2021-06-03,327,123354,42.8
13051,Chatham County,2021-06-04,311,123665,42.9
13051,Chatham County,2021-06-05,180,123845,42.9
13051,Chatham County,2021-06-06,119,123964,43
13051,Chatham County,2021-06-07,320,124284,43.1
13051,Chatham County,2021-06-08,308,124592,43.2
13051,Chatham County,2021-06-09,242,124834,43.3
13051,Chatham County,2021-06-10,295,125129,43.4
13051,Chatham County,2021-06-11,228,125357,43.5
13051,Chatham County,2021-06-12,162,125519,43.5
13051,Chatham County,2021-06-13,35,125554,43.5
13051,Chatham County,2021-06-14,227,125781,43.6
13051,Chatham County,2021-06-15,244,126025,43.7
13051,Chatham County,2021-06-16,227,126252,43.8
13051,Chatham County,2021-06-17,326,126578,43.9
13051,Chatham County,2021-06-18,236,126814,44
13051,Chatham County,2021-06-19,154,126968,44
13051,Chatham County,2021-06-20,89,127057,44
13051,Chatham County,2021-06-21,267,127324,44.1
13051,Chatham County,2021-06-22,210,127534,44.2
13051,Chatham County,2021-06-23,283,127817,44.3
13051,Chatham County,2021-06-24,258,128075,44.4
13051,Chatham County,2021-06-25,249,128324,44.5
13051,Chatham County,2021-06-26,117,128441,44.5
13051,Chatham County,2021-06-27,71,128512,44.5
13051,Chatham County,2021-06-28,208,128720,44.6
13051,Chatham County,2021-06-29,189,128909,44.7
13051,Chatham County,2021-06-30,187,129096,44.7
13051,Chatham County,2021-07-01,248,129344,44.8
13051,Chatham County,2021-07-02,220,129564,44.9
13051,Chatham County,2021-07-03,137,129701,45
13051,Chatham County,2021-07-04,8,129709,45
13051,Chatham County,2021-07-05,147,129856,45
13051,Chatham County,2021-07-06,175,130031,45.1
13051,Chatham County,2021-07-07,189,130220,45.1
13051,Chatham County,2021-07-08,219,130439,45.2
13051,Chatham County,2021-07-09,255,130694,45.3
13051,Chatham County,2021-07-10,162,130856,45.4
13051,Chatham County,2021-07-11,91,130947,45.4
13051,Chatham County,2021-07-12,255,131202,45.5
13051,Chatham County,2021-07-13,167,131369,45.5
13051,Chatham County,2021-07-14,215,131584,45.6
13051,Chatham County,2021-07-15,304,131888,45.7
13051,Chatham County,2021-07-16,307,132195,45.8
13051,Chatham County,2021-07-17,170,132365,45.9
13051,Chatham County,2021-07-18,123,132488,45.9
13051,Chatham County,2021-07-19,351,132839,46
13051,Chatham County,2021-07-20,339,133178,46.2
13051,Chatham County,2021-07-21,338,133516,46.3
13051,Chatham County,2021-07-22,374,133890,46.4
13051,Chatham County,2021-07-23,501,134391,46.6
13051,Chatham County,2021-07-24,491,134882,46.8
13051,Chatham County,2021-07-25,189,135071,46.8
13051,Chatham County,2021-07-26,516,135587,47
13051,Chatham County,2021-07-27,624,136211,47.2
13051,Chatham County,2021-07-28,600,136811,47.4
13051,Chatham County,2021-07-29,519,137330,47.6
13051,Chatham County,2021-07-30,585,137915,47.8
13051,Chatham County,2021-07-31,370,138285,47.9
13051,Chatham County,2021-08-01,201,138486,48
13051,Chatham County,2021-08-02,467,138953,48.2
13051,Chatham County,2021-08-03,512,139465,48.3
13051,Chatham County,2021-08-04,476,139941,48.5
13051,Chatham County,2021-08-05,568,140509,48.7
13051,Chatham County,2021-08-06,646,141155,48.9
13051,Chatham County,2021-08-07,480,141635,49.1
13051,Chatham County,2021-08-08,257,141892,49.2
13051,Chatham County,2021-08-09,489,142381,49.4
13051,Chatham County,2021-08-10,628,143009,49.6
13051,Chatham County,2021-08-11,614,143623,49.8
13051,Chatham County,2021-08-12,661,144284,50
13051,Chatham County,2021-08-13,679,144963,50.2
13051,Chatham County,2021-08-14,448,145411,50.4
13051,Chatham County,2021-08-15,259,145670,50.5
13051,Chatham County,2021-08-16,516,146186,50.7
13051,Chatham County,2021-08-17,523,146709,50.9
13051,Chatham County,2021-08-18,563,147272,51
13051,Chatham County,2021-08-19,569,147841,51.2
13051,Chatham County,2021-08-20,519,148360,51.4
13051,Chatham County,2021-08-21,431,148791,51.6
13051,Chatham County,2021-08-22,209,149000,51.6
13051,Chatham County,2021-08-23,437,149437,51.8
13051,Chatham County,2021-08-24,428,149865,51.9
13051,Chatham County,2021-08-25,469,150334,52.1
13051,Chatham County,2021-08-26,511,150845,52.3
13051,Chatham County,2021-08-27,502,151347,52.5
13051,Chatham County,2021-08-28,294,151641,52.6
13051,Chatham County,2021-08-29,229,151870,52.6
13051,Chatham County,2021-08-30,398,152268,52.8
13051,Chatham County,2021-08-31,367,152635,52.9
13051,Chatham County,2021-09-01,480,153115,53.1
13051,Chatham County,2021-09-02,413,153528,53.2
13051,Chatham County,2021-09-03,485,154013,53.4
13051,Chatham County,2021-09-04,247,154260,53.5
13051,Chatham County,2021-09-05,158,154418,53.5
13051,Chatham County,2021-09-06,87,154505,53.6
13051,Chatham County,2021-09-07,286,154791,53.7
13051,Chatham County,2021-09-08,339,155130,53.8
13051,Chatham County,2021-09-09,349,155479,53.9
13051,Chatham County,2021-09-10,351,155830,54
13051,Chatham County,2021-09-11,230,156060,54.1
13051,Chatham County,2021-09-12,152,156212,54.1
13051,Chatham County,2021-09-13,381,156593,54.3
13051,Chatham County,2021-09-14,333,156926,54.4
13051,Chatham County,2021-09-15,303,157229,54.5
13051,Chatham County,2021-09-16,261,157490,54.6
13051,Chatham County,2021-09-17,292,157782,54.7
13051,Chatham County,2021-09-18,161,157943,54.7
13051,Chatham County,2021-09-19,97,158040,54.8
13051,Chatham County,2021-09-20,214,158254,54.9
13051,Chatham County,2021-09-21,200,158454,54.9
13051,Chatham County,2021-09-22,187,158641,55
13051,Chatham County,2021-09-23,191,158832,55.1
13051,Chatham County,2021-09-24,147,158979,55.1
13051,Chatham County,2021-09-25,89,159068,55.1
13051,Chatham County,2021-09-26,62,159130,55.2
13051,Chatham County,2021-09-27,108,159238,55.2
13051,Chatham County,2021-09-28,110,159348,55.2
13051,Chatham County,2021-09-29,125,159473,55.3
13051,Chatham County,2021-09-30,146,159619,55.3
13051,Chatham County,2021-10-01,126,159745,55.4
13051,Chatham County,2021-10-02,79,159824,55.4
13051,Chatham County,2021-10-03,52,159876,55.4
13051,Chatham County,2021-10-04,81,159957,55.4
13051,Chatham County,2021-10-05,59,160016,55.5
13051,Chatham County,2021-10-06,80,160096,55.5
13051,Chatham County,2021-10-07,69,160165,55.5
13053,Chattahoochee County,2020-12-21,1,1,0
13053,Chattahoochee County,2020-12-22,1,2,0
13053,Chattahoochee County,2020-12-23,3,5,0
13053,Chattahoochee County,2020-12-24,1,6,0.1
13053,Chattahoochee County,2020-12-26,2,8,0.1
13053,Chattahoochee County,2020-12-28,1,9,0.1
13053,Chattahoochee County,2020-12-29,9,18,0.2
13053,Chattahoochee County,2020-12-30,8,26,0.2
13053,Chattahoochee County,2020-12-31,3,29,0.3
13053,Chattahoochee County,2021-01-04,10,39,0.4
13053,Chattahoochee County,2021-01-05,4,43,0.4
13053,Chattahoochee County,2021-01-06,3,46,0.4
13053,Chattahoochee County,2021-01-07,7,53,0.5
13053,Chattahoochee County,2021-01-08,3,56,0.5
13053,Chattahoochee County,2021-01-09,1,57,0.5
13053,Chattahoochee County,2021-01-11,4,61,0.6
13053,Chattahoochee County,2021-01-12,26,87,0.8
13053,Chattahoochee County,2021-01-13,3,90,0.9
13053,Chattahoochee County,2021-01-14,3,93,0.9
13053,Chattahoochee County,2021-01-15,5,98,0.9
13053,Chattahoochee County,2021-01-16,5,103,1
13053,Chattahoochee County,2021-01-18,4,107,1
13053,Chattahoochee County,2021-01-19,25,132,1.3
13053,Chattahoochee County,2021-01-20,2,134,1.3
13053,Chattahoochee County,2021-01-21,9,143,1.4
13053,Chattahoochee County,2021-01-23,4,147,1.4
13053,Chattahoochee County,2021-01-25,2,149,1.4
13053,Chattahoochee County,2021-01-26,31,180,1.7
13053,Chattahoochee County,2021-01-28,1,181,1.7
13053,Chattahoochee County,2021-01-29,3,184,1.7
13053,Chattahoochee County,2021-02-01,7,191,1.8
13053,Chattahoochee County,2021-02-03,1,192,1.8
13053,Chattahoochee County,2021-02-04,3,195,1.8
13053,Chattahoochee County,2021-02-05,3,198,1.9
13053,Chattahoochee County,2021-02-08,1,199,1.9
13053,Chattahoochee County,2021-02-09,3,202,1.9
13053,Chattahoochee County,2021-02-10,1,203,1.9
13053,Chattahoochee County,2021-02-11,5,208,2
13053,Chattahoochee County,2021-02-12,6,214,2
13053,Chattahoochee County,2021-02-13,1,215,2
13053,Chattahoochee County,2021-02-15,5,220,2.1
13053,Chattahoochee County,2021-02-16,7,227,2.1
13053,Chattahoochee County,2021-02-17,2,229,2.2
13053,Chattahoochee County,2021-02-18,4,233,2.2
13053,Chattahoochee County,2021-02-19,3,236,2.2
13053,Chattahoochee County,2021-02-21,1,237,2.2
13053,Chattahoochee County,2021-02-22,1,238,2.3
13053,Chattahoochee County,2021-02-23,99,337,3.2
13053,Chattahoochee County,2021-02-24,11,348,3.3
13053,Chattahoochee County,2021-02-25,2,350,3.3
13053,Chattahoochee County,2021-02-26,14,364,3.4
13053,Chattahoochee County,2021-02-27,1,365,3.5
13053,Chattahoochee County,2021-02-28,1,366,3.5
13053,Chattahoochee County,2021-03-01,1,367,3.5
13053,Chattahoochee County,2021-03-02,3,370,3.5
13053,Chattahoochee County,2021-03-03,7,377,3.6
13053,Chattahoochee County,2021-03-04,5,382,3.6
13053,Chattahoochee County,2021-03-05,10,392,3.7
13053,Chattahoochee County,2021-03-06,1,393,3.7
13053,Chattahoochee County,2021-03-08,2,395,3.7
13053,Chattahoochee County,2021-03-09,8,403,3.8
13053,Chattahoochee County,2021-03-10,5,408,3.9
13053,Chattahoochee County,2021-03-11,32,440,4.2
13053,Chattahoochee County,2021-03-12,8,448,4.2
13053,Chattahoochee County,2021-03-13,2,450,4.3
13053,Chattahoochee County,2021-03-14,3,453,4.3
13053,Chattahoochee County,2021-03-15,8,461,4.4
13053,Chattahoochee County,2021-03-16,43,504,4.8
13053,Chattahoochee County,2021-03-17,11,515,4.9
13053,Chattahoochee County,2021-03-18,8,523,5
13053,Chattahoochee County,2021-03-19,15,538,5.1
13053,Chattahoochee County,2021-03-20,6,544,5.2
13053,Chattahoochee County,2021-03-21,4,548,5.2
13053,Chattahoochee County,2021-03-22,11,559,5.3
13053,Chattahoochee County,2021-03-23,25,584,5.5
13053,Chattahoochee County,2021-03-24,13,597,5.7
13053,Chattahoochee County,2021-03-25,40,637,6
13053,Chattahoochee County,2021-03-26,32,669,6.3
13053,Chattahoochee County,2021-03-27,6,675,6.4
13053,Chattahoochee County,2021-03-28,2,677,6.4
13053,Chattahoochee County,2021-03-29,27,704,6.7
13053,Chattahoochee County,2021-03-30,26,730,6.9
13053,Chattahoochee County,2021-03-31,16,746,7.1
13053,Chattahoochee County,2021-04-01,22,768,7.3
13053,Chattahoochee County,2021-04-02,34,802,7.6
13053,Chattahoochee County,2021-04-03,5,807,7.6
13053,Chattahoochee County,2021-04-04,1,808,7.7
13053,Chattahoochee County,2021-04-05,23,831,7.9
13053,Chattahoochee County,2021-04-06,79,910,8.6
13053,Chattahoochee County,2021-04-07,18,928,8.8
13053,Chattahoochee County,2021-04-08,19,947,9
13053,Chattahoochee County,2021-04-09,45,992,9.4
13053,Chattahoochee County,2021-04-10,4,996,9.4
13053,Chattahoochee County,2021-04-11,3,999,9.5
13053,Chattahoochee County,2021-04-12,15,1014,9.6
13053,Chattahoochee County,2021-04-13,14,1028,9.7
13053,Chattahoochee County,2021-04-14,5,1033,9.8
13053,Chattahoochee County,2021-04-15,13,1046,9.9
13053,Chattahoochee County,2021-04-16,13,1059,10
13053,Chattahoochee County,2021-04-17,6,1065,10.1
13053,Chattahoochee County,2021-04-19,10,1075,10.2
13053,Chattahoochee County,2021-04-20,14,1089,10.3
13053,Chattahoochee County,2021-04-21,6,1095,10.4
13053,Chattahoochee County,2021-04-22,7,1102,10.4
13053,Chattahoochee County,2021-04-23,11,1113,10.5
13053,Chattahoochee County,2021-04-24,3,1116,10.6
13053,Chattahoochee County,2021-04-25,2,1118,10.6
13053,Chattahoochee County,2021-04-26,11,1129,10.7
13053,Chattahoochee County,2021-04-27,15,1144,10.8
13053,Chattahoochee County,2021-04-28,13,1157,11
13053,Chattahoochee County,2021-04-29,11,1168,11.1
13053,Chattahoochee County,2021-04-30,11,1179,11.2
13053,Chattahoochee County,2021-05-01,7,1186,11.2
13053,Chattahoochee County,2021-05-02,1,1187,11.2
13053,Chattahoochee County,2021-05-03,8,1195,11.3
13053,Chattahoochee County,2021-05-04,9,1204,11.4
13053,Chattahoochee County,2021-05-05,7,1211,11.5
13053,Chattahoochee County,2021-05-06,6,1217,11.5
13053,Chattahoochee County,2021-05-07,6,1223,11.6
13053,Chattahoochee County,2021-05-08,30,1253,11.9
13053,Chattahoochee County,2021-05-09,1,1254,11.9
13053,Chattahoochee County,2021-05-10,2,1256,11.9
13053,Chattahoochee County,2021-05-11,7,1263,12
13053,Chattahoochee County,2021-05-12,151,1414,13.4
13053,Chattahoochee County,2021-05-13,22,1436,13.6
13053,Chattahoochee County,2021-05-14,10,1446,13.7
13053,Chattahoochee County,2021-05-15,9,1455,13.8
13053,Chattahoochee County,2021-05-16,13,1468,13.9
13053,Chattahoochee County,2021-05-17,14,1482,14
13053,Chattahoochee County,2021-05-18,19,1501,14.2
13053,Chattahoochee County,2021-05-19,5,1506,14.3
13053,Chattahoochee County,2021-05-20,13,1519,14.4
13053,Chattahoochee County,2021-05-21,6,1525,14.4
13053,Chattahoochee County,2021-05-22,9,1534,14.5
13053,Chattahoochee County,2021-05-23,6,1540,14.6
13053,Chattahoochee County,2021-05-24,2,1542,14.6
13053,Chattahoochee County,2021-05-25,5,1547,14.6
13053,Chattahoochee County,2021-05-26,4,1551,14.7
13053,Chattahoochee County,2021-05-27,5,1556,14.7
13053,Chattahoochee County,2021-05-28,9,1565,14.8
13053,Chattahoochee County,2021-05-29,2,1567,14.8
13053,Chattahoochee County,2021-05-30,2,1569,14.9
13053,Chattahoochee County,2021-05-31,1,1570,14.9
13053,Chattahoochee County,2021-06-01,10,1580,15
13053,Chattahoochee County,2021-06-02,4,1584,15
13053,Chattahoochee County,2021-06-03,3,1587,15
13053,Chattahoochee County,2021-06-04,2,1589,15
13053,Chattahoochee County,2021-06-05,2,1591,15.1
13053,Chattahoochee County,2021-06-06,1,1592,15.1
13053,Chattahoochee County,2021-06-07,5,1597,15.1
13053,Chattahoochee County,2021-06-08,8,1605,15.2
13053,Chattahoochee County,2021-06-09,2,1607,15.2
13053,Chattahoochee County,2021-06-10,6,1613,15.3
13053,Chattahoochee County,2021-06-11,2,1615,15.3
13053,Chattahoochee County,2021-06-12,2,1617,15.3
13053,Chattahoochee County,2021-06-14,5,1622,15.4
13053,Chattahoochee County,2021-06-15,5,1627,15.4
13053,Chattahoochee County,2021-06-16,4,1631,15.4
13053,Chattahoochee County,2021-06-17,2,1633,15.5
13053,Chattahoochee County,2021-06-18,2,1635,15.5
13053,Chattahoochee County,2021-06-19,3,1638,15.5
13053,Chattahoochee County,2021-06-20,3,1641,15.5
13053,Chattahoochee County,2021-06-21,2,1643,15.6
13053,Chattahoochee County,2021-06-22,11,1654,15.7
13053,Chattahoochee County,2021-06-23,6,1660,15.7
13053,Chattahoochee County,2021-06-24,4,1664,15.8
13053,Chattahoochee County,2021-06-25,5,1669,15.8
13053,Chattahoochee County,2021-06-26,11,1680,15.9
13053,Chattahoochee County,2021-06-28,4,1684,15.9
13053,Chattahoochee County,2021-06-29,8,1692,16
13053,Chattahoochee County,2021-06-30,5,1697,16.1
13053,Chattahoochee County,2021-07-01,9,1706,16.2
13053,Chattahoochee County,2021-07-02,1,1707,16.2
13053,Chattahoochee County,2021-07-03,1,1708,16.2
13053,Chattahoochee County,2021-07-05,5,1713,16.2
13053,Chattahoochee County,2021-07-06,9,1722,16.3
13053,Chattahoochee County,2021-07-07,2,1724,16.3
13053,Chattahoochee County,2021-07-08,3,1727,16.4
13053,Chattahoochee County,2021-07-09,155,1882,17.8
13053,Chattahoochee County,2021-07-10,4,1886,17.9
13053,Chattahoochee County,2021-07-11,2,1888,17.9
13053,Chattahoochee County,2021-07-12,3,1891,17.9
13053,Chattahoochee County,2021-07-13,7,1898,18
13053,Chattahoochee County,2021-07-14,1,1899,18
13053,Chattahoochee County,2021-07-15,1,1900,18
13053,Chattahoochee County,2021-07-16,8,1908,18.1
13053,Chattahoochee County,2021-07-17,2,1910,18.1
13053,Chattahoochee County,2021-07-18,2,1912,18.1
13053,Chattahoochee County,2021-07-19,10,1922,18.2
13053,Chattahoochee County,2021-07-20,6,1928,18.3
13053,Chattahoochee County,2021-07-21,12,1940,18.4
13053,Chattahoochee County,2021-07-22,9,1949,18.5
13053,Chattahoochee County,2021-07-23,4,1953,18.5
13053,Chattahoochee County,2021-07-24,3,1956,18.5
13053,Chattahoochee County,2021-07-25,1,1957,18.5
13053,Chattahoochee County,2021-07-26,6,1963,18.6
13053,Chattahoochee County,2021-07-27,11,1974,18.7
13053,Chattahoochee County,2021-07-28,9,1983,18.8
13053,Chattahoochee County,2021-07-29,10,1993,18.9
13053,Chattahoochee County,2021-07-30,11,2004,19
13053,Chattahoochee County,2021-07-31,4,2008,19
13053,Chattahoochee County,2021-08-01,3,2011,19
13053,Chattahoochee County,2021-08-02,4,2015,19.1
13053,Chattahoochee County,2021-08-03,6,2021,19.1
13053,Chattahoochee County,2021-08-04,6,2027,19.2
13053,Chattahoochee County,2021-08-05,7,2034,19.3
13053,Chattahoochee County,2021-08-06,10,2044,19.4
13053,Chattahoochee County,2021-08-07,1,2045,19.4
13053,Chattahoochee County,2021-08-08,3,2048,19.4
13053,Chattahoochee County,2021-08-09,7,2055,19.5
13053,Chattahoochee County,2021-08-10,3,2058,19.5
13053,Chattahoochee County,2021-08-11,9,2067,19.6
13053,Chattahoochee County,2021-08-12,13,2080,19.7
13053,Chattahoochee County,2021-08-13,8,2088,19.8
13053,Chattahoochee County,2021-08-14,10,2098,19.9
13053,Chattahoochee County,2021-08-15,3,2101,19.9
13053,Chattahoochee County,2021-08-16,13,2114,20
13053,Chattahoochee County,2021-08-17,11,2125,20.1
13053,Chattahoochee County,2021-08-18,6,2131,20.2
13053,Chattahoochee County,2021-08-19,12,2143,20.3
13053,Chattahoochee County,2021-08-20,6,2149,20.4
13053,Chattahoochee County,2021-08-21,7,2156,20.4
13053,Chattahoochee County,2021-08-22,1,2157,20.4
13053,Chattahoochee County,2021-08-23,10,2167,20.5
13053,Chattahoochee County,2021-08-24,14,2181,20.7
13053,Chattahoochee County,2021-08-25,7,2188,20.7
13053,Chattahoochee County,2021-08-26,1,2189,20.7
13053,Chattahoochee County,2021-08-27,12,2201,20.8
13053,Chattahoochee County,2021-08-28,9,2210,20.9
13053,Chattahoochee County,2021-08-29,2,2212,20.9
13053,Chattahoochee County,2021-08-30,7,2219,21
13053,Chattahoochee County,2021-08-31,11,2230,21.1
13053,Chattahoochee County,2021-09-01,4,2234,21.2
13053,Chattahoochee County,2021-09-02,11,2245,21.3
13053,Chattahoochee County,2021-09-03,8,2253,21.3
13053,Chattahoochee County,2021-09-04,5,2258,21.4
13053,Chattahoochee County,2021-09-05,1,2259,21.4
13053,Chattahoochee County,2021-09-06,1,2260,21.4
13053,Chattahoochee County,2021-09-07,6,2266,21.5
13053,Chattahoochee County,2021-09-08,6,2272,21.5
13053,Chattahoochee County,2021-09-09,3,2275,21.5
13053,Chattahoochee County,2021-09-10,7,2282,21.6
13053,Chattahoochee County,2021-09-11,10,2292,21.7
13053,Chattahoochee County,2021-09-12,3,2295,21.7
13053,Chattahoochee County,2021-09-13,2,2297,21.8
13053,Chattahoochee County,2021-09-14,13,2310,21.9
13053,Chattahoochee County,2021-09-15,2,2312,21.9
13053,Chattahoochee County,2021-09-16,5,2317,21.9
13053,Chattahoochee County,2021-09-17,10,2327,22
13053,Chattahoochee County,2021-09-18,1,2328,22
13053,Chattahoochee County,2021-09-19,2,2330,22.1
13053,Chattahoochee County,2021-09-20,8,2338,22.1
13053,Chattahoochee County,2021-09-21,6,2344,22.2
13053,Chattahoochee County,2021-09-22,2,2346,22.2
13053,Chattahoochee County,2021-09-23,5,2351,22.3
13053,Chattahoochee County,2021-09-24,5,2356,22.3
13053,Chattahoochee County,2021-09-25,5,2361,22.4
13053,Chattahoochee County,2021-09-26,3,2364,22.4
13053,Chattahoochee County,2021-09-27,1,2365,22.4
13053,Chattahoochee County,2021-09-28,4,2369,22.4
13053,Chattahoochee County,2021-09-29,5,2374,22.5
13053,Chattahoochee County,2021-09-30,2,2376,22.5
13053,Chattahoochee County,2021-10-01,3,2379,22.5
13053,Chattahoochee County,2021-10-03,1,2380,22.5
13053,Chattahoochee County,2021-10-04,3,2383,22.6
13053,Chattahoochee County,2021-10-05,2,2385,22.6
13053,Chattahoochee County,2021-10-06,1,2386,22.6
13055,Chattooga County,2020-12-18,4,4,0
13055,Chattooga County,2020-12-20,4,8,0
13055,Chattooga County,2020-12-21,16,24,0.1
13055,Chattooga County,2020-12-22,11,35,0.1
13055,Chattooga County,2020-12-23,25,60,0.2
13055,Chattooga County,2020-12-26,2,62,0.2
13055,Chattooga County,2020-12-27,2,64,0.3
13055,Chattooga County,2020-12-28,31,95,0.4
13055,Chattooga County,2020-12-29,29,124,0.5
13055,Chattooga County,2020-12-30,41,165,0.7
13055,Chattooga County,2020-12-31,54,219,0.9
13055,Chattooga County,2021-01-01,3,222,0.9
13055,Chattooga County,2021-01-02,5,227,0.9
13055,Chattooga County,2021-01-03,11,238,1
13055,Chattooga County,2021-01-04,87,325,1.3
13055,Chattooga County,2021-01-05,63,388,1.6
13055,Chattooga County,2021-01-06,57,445,1.8
13055,Chattooga County,2021-01-07,81,526,2.1
13055,Chattooga County,2021-01-08,56,582,2.3
13055,Chattooga County,2021-01-09,1,583,2.3
13055,Chattooga County,2021-01-10,8,591,2.4
13055,Chattooga County,2021-01-11,191,782,3.2
13055,Chattooga County,2021-01-12,211,993,4
13055,Chattooga County,2021-01-13,141,1134,4.6
13055,Chattooga County,2021-01-14,264,1398,5.6
13055,Chattooga County,2021-01-15,124,1522,6.1
13055,Chattooga County,2021-01-16,4,1526,6.2
13055,Chattooga County,2021-01-18,53,1579,6.4
13055,Chattooga County,2021-01-19,161,1740,7
13055,Chattooga County,2021-01-20,166,1906,7.7
13055,Chattooga County,2021-01-21,184,2090,8.4
13055,Chattooga County,2021-01-22,80,2170,8.7
13055,Chattooga County,2021-01-23,1,2171,8.7
13055,Chattooga County,2021-01-25,134,2305,9.3
13055,Chattooga County,2021-01-26,101,2406,9.7
13055,Chattooga County,2021-01-27,98,2504,10.1
13055,Chattooga County,2021-01-28,90,2594,10.5
13055,Chattooga County,2021-01-29,57,2651,10.7
13055,Chattooga County,2021-01-30,1,2652,10.7
13055,Chattooga County,2021-02-01,82,2734,11
13055,Chattooga County,2021-02-02,56,2790,11.2
13055,Chattooga County,2021-02-03,116,2906,11.7
13055,Chattooga County,2021-02-04,103,3009,12.1
13055,Chattooga County,2021-02-05,43,3052,12.3
13055,Chattooga County,2021-02-06,2,3054,12.3
13055,Chattooga County,2021-02-08,37,3091,12.5
13055,Chattooga County,2021-02-09,14,3105,12.5
13055,Chattooga County,2021-02-10,29,3134,12.6
13055,Chattooga County,2021-02-11,29,3163,12.7
13055,Chattooga County,2021-02-12,16,3179,12.8
13055,Chattooga County,2021-02-13,4,3183,12.8
13055,Chattooga County,2021-02-14,1,3184,12.8
13055,Chattooga County,2021-02-15,34,3218,13
13055,Chattooga County,2021-02-16,4,3222,13
13055,Chattooga County,2021-02-17,18,3240,13.1
13055,Chattooga County,2021-02-18,23,3263,13.2
13055,Chattooga County,2021-02-19,52,3315,13.4
13055,Chattooga County,2021-02-21,1,3316,13.4
13055,Chattooga County,2021-02-22,18,3334,13.4
13055,Chattooga County,2021-02-23,21,3355,13.5
13055,Chattooga County,2021-02-24,16,3371,13.6
13055,Chattooga County,2021-02-25,64,3435,13.8
13055,Chattooga County,2021-02-26,33,3468,14
13055,Chattooga County,2021-02-27,6,3474,14
13055,Chattooga County,2021-02-28,5,3479,14
13055,Chattooga County,2021-03-01,50,3529,14.2
13055,Chattooga County,2021-03-02,33,3562,14.4
13055,Chattooga County,2021-03-03,21,3583,14.4
13055,Chattooga County,2021-03-04,28,3611,14.6
13055,Chattooga County,2021-03-05,44,3655,14.7
13055,Chattooga County,2021-03-06,11,3666,14.8
13055,Chattooga County,2021-03-07,4,3670,14.8
13055,Chattooga County,2021-03-08,149,3819,15.4
13055,Chattooga County,2021-03-09,43,3862,15.6
13055,Chattooga County,2021-03-10,54,3916,15.8
13055,Chattooga County,2021-03-11,60,3976,16
13055,Chattooga County,2021-03-12,93,4069,16.4
13055,Chattooga County,2021-03-13,12,4081,16.4
13055,Chattooga County,2021-03-14,9,4090,16.5
13055,Chattooga County,2021-03-15,125,4215,17
13055,Chattooga County,2021-03-16,135,4350,17.5
13055,Chattooga County,2021-03-17,49,4399,17.7
13055,Chattooga County,2021-03-18,127,4526,18.2
13055,Chattooga County,2021-03-19,110,4636,18.7
13055,Chattooga County,2021-03-20,9,4645,18.7
13055,Chattooga County,2021-03-21,2,4647,18.7
13055,Chattooga County,2021-03-22,44,4691,18.9
13055,Chattooga County,2021-03-23,51,4742,19.1
13055,Chattooga County,2021-03-24,65,4807,19.4
13055,Chattooga County,2021-03-25,53,4860,19.6
13055,Chattooga County,2021-03-26,102,4962,20
13055,Chattooga County,2021-03-27,5,4967,20
13055,Chattooga County,2021-03-28,1,4968,20
13055,Chattooga County,2021-03-29,73,5041,20.3
13055,Chattooga County,2021-03-30,84,5125,20.7
13055,Chattooga County,2021-03-31,103,5228,21.1
13055,Chattooga County,2021-04-01,137,5365,21.6
13055,Chattooga County,2021-04-02,107,5472,22.1
13055,Chattooga County,2021-04-03,9,5481,22.1
13055,Chattooga County,2021-04-04,4,5485,22.1
13055,Chattooga County,2021-04-05,50,5535,22.3
13055,Chattooga County,2021-04-06,77,5612,22.6
13055,Chattooga County,2021-04-07,65,5677,22.9
13055,Chattooga County,2021-04-08,70,5747,23.2
13055,Chattooga County,2021-04-09,46,5793,23.3
13055,Chattooga County,2021-04-10,8,5801,23.4
13055,Chattooga County,2021-04-11,4,5805,23.4
13055,Chattooga County,2021-04-12,42,5847,23.6
13055,Chattooga County,2021-04-13,76,5923,23.9
13055,Chattooga County,2021-04-14,117,6040,24.3
13055,Chattooga County,2021-04-15,54,6094,24.6
13055,Chattooga County,2021-04-16,20,6114,24.6
13055,Chattooga County,2021-04-17,4,6118,24.7
13055,Chattooga County,2021-04-19,22,6140,24.7
13055,Chattooga County,2021-04-20,27,6167,24.9
13055,Chattooga County,2021-04-21,47,6214,25
13055,Chattooga County,2021-04-22,40,6254,25.2
13055,Chattooga County,2021-04-23,47,6301,25.4
13055,Chattooga County,2021-04-24,4,6305,25.4
13055,Chattooga County,2021-04-25,8,6313,25.4
13055,Chattooga County,2021-04-26,31,6344,25.6
13055,Chattooga County,2021-04-27,30,6374,25.7
13055,Chattooga County,2021-04-28,73,6447,26
13055,Chattooga County,2021-04-29,50,6497,26.2
13055,Chattooga County,2021-04-30,47,6544,26.4
13055,Chattooga County,2021-05-01,10,6554,26.4
13055,Chattooga County,2021-05-02,4,6558,26.4
13055,Chattooga County,2021-05-03,13,6571,26.5
13055,Chattooga County,2021-05-04,19,6590,26.6
13055,Chattooga County,2021-05-05,31,6621,26.7
13055,Chattooga County,2021-05-06,34,6655,26.8
13055,Chattooga County,2021-05-07,74,6729,27.1
13055,Chattooga County,2021-05-08,8,6737,27.2
13055,Chattooga County,2021-05-09,6,6743,27.2
13055,Chattooga County,2021-05-10,4,6747,27.2
13055,Chattooga County,2021-05-11,26,6773,27.3
13055,Chattooga County,2021-05-12,36,6809,27.4
13055,Chattooga County,2021-05-13,31,6840,27.6
13055,Chattooga County,2021-05-14,18,6858,27.6
13055,Chattooga County,2021-05-15,9,6867,27.7
13055,Chattooga County,2021-05-16,13,6880,27.7
13055,Chattooga County,2021-05-17,16,6896,27.8
13055,Chattooga County,2021-05-18,24,6920,27.9
13055,Chattooga County,2021-05-19,22,6942,28
13055,Chattooga County,2021-05-20,44,6986,28.2
13055,Chattooga County,2021-05-21,61,7047,28.4
13055,Chattooga County,2021-05-22,13,7060,28.5
13055,Chattooga County,2021-05-23,7,7067,28.5
13055,Chattooga County,2021-05-24,13,7080,28.5
13055,Chattooga County,2021-05-25,18,7098,28.6
13055,Chattooga County,2021-05-26,19,7117,28.7
13055,Chattooga County,2021-05-27,23,7140,28.8
13055,Chattooga County,2021-05-28,25,7165,28.9
13055,Chattooga County,2021-05-29,11,7176,28.9
13055,Chattooga County,2021-05-30,3,7179,28.9
13055,Chattooga County,2021-05-31,1,7180,28.9
13055,Chattooga County,2021-06-01,19,7199,29
13055,Chattooga County,2021-06-02,7,7206,29
13055,Chattooga County,2021-06-03,23,7229,29.1
13055,Chattooga County,2021-06-04,20,7249,29.2
13055,Chattooga County,2021-06-05,5,7254,29.2
13055,Chattooga County,2021-06-06,2,7256,29.2
13055,Chattooga County,2021-06-07,8,7264,29.3
13055,Chattooga County,2021-06-08,4,7268,29.3
13055,Chattooga County,2021-06-09,12,7280,29.3
13055,Chattooga County,2021-06-10,22,7302,29.4
13055,Chattooga County,2021-06-11,15,7317,29.5
13055,Chattooga County,2021-06-12,9,7326,29.5
13055,Chattooga County,2021-06-14,10,7336,29.6
13055,Chattooga County,2021-06-15,13,7349,29.6
13055,Chattooga County,2021-06-16,10,7359,29.7
13055,Chattooga County,2021-06-17,8,7367,29.7
13055,Chattooga County,2021-06-18,21,7388,29.8
13055,Chattooga County,2021-06-19,4,7392,29.8
13055,Chattooga County,2021-06-20,2,7394,29.8
13055,Chattooga County,2021-06-21,5,7399,29.8
13055,Chattooga County,2021-06-22,6,7405,29.8
13055,Chattooga County,2021-06-23,10,7415,29.9
13055,Chattooga County,2021-06-24,18,7433,30
13055,Chattooga County,2021-06-25,19,7452,30
13055,Chattooga County,2021-06-26,3,7455,30
13055,Chattooga County,2021-06-27,1,7456,30
13055,Chattooga County,2021-06-28,9,7465,30.1
13055,Chattooga County,2021-06-29,16,7481,30.2
13055,Chattooga County,2021-06-30,6,7487,30.2
13055,Chattooga County,2021-07-01,11,7498,30.2
13055,Chattooga County,2021-07-02,16,7514,30.3
13055,Chattooga County,2021-07-03,1,7515,30.3
13055,Chattooga County,2021-07-04,2,7517,30.3
13055,Chattooga County,2021-07-05,5,7522,30.3
13055,Chattooga County,2021-07-06,10,7532,30.4
13055,Chattooga County,2021-07-07,12,7544,30.4
13055,Chattooga County,2021-07-08,17,7561,30.5
13055,Chattooga County,2021-07-09,13,7574,30.5
13055,Chattooga County,2021-07-10,6,7580,30.5
13055,Chattooga County,2021-07-12,5,7585,30.6
13055,Chattooga County,2021-07-13,5,7590,30.6
13055,Chattooga County,2021-07-14,9,7599,30.6
13055,Chattooga County,2021-07-15,9,7608,30.7
13055,Chattooga County,2021-07-16,9,7617,30.7
13055,Chattooga County,2021-07-17,8,7625,30.7
13055,Chattooga County,2021-07-18,8,7633,30.8
13055,Chattooga County,2021-07-19,10,7643,30.8
13055,Chattooga County,2021-07-20,16,7659,30.9
13055,Chattooga County,2021-07-21,18,7677,30.9
13055,Chattooga County,2021-07-22,29,7706,31.1
13055,Chattooga County,2021-07-23,36,7742,31.2
13055,Chattooga County,2021-07-24,22,7764,31.3
13055,Chattooga County,2021-07-25,1,7765,31.3
13055,Chattooga County,2021-07-26,15,7780,31.4
13055,Chattooga County,2021-07-27,23,7803,31.4
13055,Chattooga County,2021-07-28,28,7831,31.6
13055,Chattooga County,2021-07-29,37,7868,31.7
13055,Chattooga County,2021-07-30,41,7909,31.9
13055,Chattooga County,2021-07-31,22,7931,32
13055,Chattooga County,2021-08-01,14,7945,32
13055,Chattooga County,2021-08-02,21,7966,32.1
13055,Chattooga County,2021-08-03,29,7995,32.2
13055,Chattooga County,2021-08-04,34,8029,32.4
13055,Chattooga County,2021-08-05,39,8068,32.5
13055,Chattooga County,2021-08-06,37,8105,32.7
13055,Chattooga County,2021-08-07,12,8117,32.7
13055,Chattooga County,2021-08-08,3,8120,32.7
13055,Chattooga County,2021-08-09,26,8146,32.8
13055,Chattooga County,2021-08-10,39,8185,33
13055,Chattooga County,2021-08-11,30,8215,33.1
13055,Chattooga County,2021-08-12,37,8252,33.3
13055,Chattooga County,2021-08-13,47,8299,33.4
13055,Chattooga County,2021-08-14,12,8311,33.5
13055,Chattooga County,2021-08-15,8,8319,33.5
13055,Chattooga County,2021-08-16,21,8340,33.6
13055,Chattooga County,2021-08-17,29,8369,33.7
13055,Chattooga County,2021-08-18,34,8403,33.9
13055,Chattooga County,2021-08-19,56,8459,34.1
13055,Chattooga County,2021-08-20,51,8510,34.3
13055,Chattooga County,2021-08-21,25,8535,34.4
13055,Chattooga County,2021-08-22,16,8551,34.5
13055,Chattooga County,2021-08-23,35,8586,34.6
13055,Chattooga County,2021-08-24,49,8635,34.8
13055,Chattooga County,2021-08-25,45,8680,35
13055,Chattooga County,2021-08-26,43,8723,35.2
13055,Chattooga County,2021-08-27,83,8806,35.5
13055,Chattooga County,2021-08-28,30,8836,35.6
13055,Chattooga County,2021-08-29,17,8853,35.7
13055,Chattooga County,2021-08-30,40,8893,35.8
13055,Chattooga County,2021-08-31,50,8943,36
13055,Chattooga County,2021-09-01,53,8996,36.3
13055,Chattooga County,2021-09-02,75,9071,36.6
13055,Chattooga County,2021-09-03,70,9141,36.8
13055,Chattooga County,2021-09-04,25,9166,36.9
13055,Chattooga County,2021-09-05,22,9188,37
13055,Chattooga County,2021-09-06,46,9234,37.2
13055,Chattooga County,2021-09-07,63,9297,37.5
13055,Chattooga County,2021-09-08,53,9350,37.7
13055,Chattooga County,2021-09-09,71,9421,38
13055,Chattooga County,2021-09-10,67,9488,38.2
13055,Chattooga County,2021-09-11,21,9509,38.3
13055,Chattooga County,2021-09-12,18,9527,38.4
13055,Chattooga County,2021-09-13,33,9560,38.5
13055,Chattooga County,2021-09-14,24,9584,38.6
13055,Chattooga County,2021-09-15,35,9619,38.8
13055,Chattooga County,2021-09-16,40,9659,38.9
13055,Chattooga County,2021-09-17,57,9716,39.2
13055,Chattooga County,2021-09-18,12,9728,39.2
13055,Chattooga County,2021-09-19,9,9737,39.2
13055,Chattooga County,2021-09-20,20,9757,39.3
13055,Chattooga County,2021-09-21,20,9777,39.4
13055,Chattooga County,2021-09-22,16,9793,39.5
13055,Chattooga County,2021-09-23,24,9817,39.6
13055,Chattooga County,2021-09-24,12,9829,39.6
13055,Chattooga County,2021-09-25,8,9837,39.6
13055,Chattooga County,2021-09-26,4,9841,39.7
13055,Chattooga County,2021-09-27,10,9851,39.7
13055,Chattooga County,2021-09-28,8,9859,39.7
13055,Chattooga County,2021-09-29,6,9865,39.8
13055,Chattooga County,2021-09-30,10,9875,39.8
13055,Chattooga County,2021-10-01,10,9885,39.8
13055,Chattooga County,2021-10-02,3,9888,39.9
13055,Chattooga County,2021-10-03,6,9894,39.9
13055,Chattooga County,2021-10-04,1,9895,39.9
13055,Chattooga County,2021-10-05,10,9905,39.9
13055,Chattooga County,2021-10-06,7,9912,39.9
13055,Chattooga County,2021-10-07,8,9920,40
13057,Cherokee County,2020-12-16,5,5,0
13057,Cherokee County,2020-12-17,19,24,0
13057,Cherokee County,2020-12-18,109,133,0.1
13057,Cherokee County,2020-12-19,35,168,0.1
13057,Cherokee County,2020-12-20,78,246,0.1
13057,Cherokee County,2020-12-21,113,359,0.1
13057,Cherokee County,2020-12-22,251,610,0.2
13057,Cherokee County,2020-12-23,256,866,0.3
13057,Cherokee County,2020-12-24,31,897,0.4
13057,Cherokee County,2020-12-26,26,923,0.4
13057,Cherokee County,2020-12-27,44,967,0.4
13057,Cherokee County,2020-12-28,353,1320,0.5
13057,Cherokee County,2020-12-29,468,1788,0.7
13057,Cherokee County,2020-12-30,433,2221,0.9
13057,Cherokee County,2020-12-31,160,2381,1
13057,Cherokee County,2021-01-01,158,2539,1
13057,Cherokee County,2021-01-02,54,2593,1
13057,Cherokee County,2021-01-03,65,2658,1.1
13057,Cherokee County,2021-01-04,319,2977,1.2
13057,Cherokee County,2021-01-05,524,3501,1.4
13057,Cherokee County,2021-01-06,429,3930,1.6
13057,Cherokee County,2021-01-07,390,4320,1.7
13057,Cherokee County,2021-01-08,347,4667,1.9
13057,Cherokee County,2021-01-09,81,4748,1.9
13057,Cherokee County,2021-01-10,157,4905,2
13057,Cherokee County,2021-01-11,809,5714,2.3
13057,Cherokee County,2021-01-12,927,6641,2.7
13057,Cherokee County,2021-01-13,808,7449,3
13057,Cherokee County,2021-01-14,878,8327,3.4
13057,Cherokee County,2021-01-15,854,9181,3.7
13057,Cherokee County,2021-01-16,515,9696,3.9
13057,Cherokee County,2021-01-17,210,9906,4
13057,Cherokee County,2021-01-18,1242,11148,4.5
13057,Cherokee County,2021-01-19,1446,12594,5.1
13057,Cherokee County,2021-01-20,1216,13810,5.6
13057,Cherokee County,2021-01-21,1308,15118,6.1
13057,Cherokee County,2021-01-22,952,16070,6.5
13057,Cherokee County,2021-01-23,167,16237,6.6
13057,Cherokee County,2021-01-24,80,16317,6.6
13057,Cherokee County,2021-01-25,920,17237,7
13057,Cherokee County,2021-01-26,918,18155,7.3
13057,Cherokee County,2021-01-27,962,19117,7.7
13057,Cherokee County,2021-01-28,1517,20634,8.3
13057,Cherokee County,2021-01-29,1000,21634,8.7
13057,Cherokee County,2021-01-30,158,21792,8.8
13057,Cherokee County,2021-01-31,66,21858,8.8
13057,Cherokee County,2021-02-01,829,22687,9.2
13057,Cherokee County,2021-02-02,739,23426,9.5
13057,Cherokee County,2021-02-03,548,23974,9.7
13057,Cherokee County,2021-02-04,711,24685,10
13057,Cherokee County,2021-02-05,517,25202,10.2
13057,Cherokee County,2021-02-06,71,25273,10.2
13057,Cherokee County,2021-02-07,46,25319,10.2
13057,Cherokee County,2021-02-08,403,25722,10.4
13057,Cherokee County,2021-02-09,814,26536,10.7
13057,Cherokee County,2021-02-10,494,27030,10.9
13057,Cherokee County,2021-02-11,567,27597,11.1
13057,Cherokee County,2021-02-12,644,28241,11.4
13057,Cherokee County,2021-02-13,119,28360,11.5
13057,Cherokee County,2021-02-14,103,28463,11.5
13057,Cherokee County,2021-02-15,404,28867,11.7
13057,Cherokee County,2021-02-16,545,29412,11.9
13057,Cherokee County,2021-02-17,466,29878,12.1
13057,Cherokee County,2021-02-18,354,30232,12.2
13057,Cherokee County,2021-02-19,375,30607,12.4
13057,Cherokee County,2021-02-20,113,30720,12.4
13057,Cherokee County,2021-02-21,87,30807,12.4
13057,Cherokee County,2021-02-22,177,30984,12.5
13057,Cherokee County,2021-02-23,387,31371,12.7
13057,Cherokee County,2021-02-24,387,31758,12.8
13057,Cherokee County,2021-02-25,462,32220,13
13057,Cherokee County,2021-02-26,895,33115,13.4
13057,Cherokee County,2021-02-27,176,33291,13.5
13057,Cherokee County,2021-02-28,195,33486,13.5
13057,Cherokee County,2021-03-01,754,34240,13.8
13057,Cherokee County,2021-03-02,731,34971,14.1
13057,Cherokee County,2021-03-03,718,35689,14.4
13057,Cherokee County,2021-03-04,628,36317,14.7
13057,Cherokee County,2021-03-05,1157,37474,15.1
13057,Cherokee County,2021-03-06,143,37617,15.2
13057,Cherokee County,2021-03-07,176,37793,15.3
13057,Cherokee County,2021-03-08,926,38719,15.6
13057,Cherokee County,2021-03-09,1188,39907,16.1
13057,Cherokee County,2021-03-10,1019,40926,16.5
13057,Cherokee County,2021-03-11,1709,42635,17.2
13057,Cherokee County,2021-03-12,1949,44584,18
13057,Cherokee County,2021-03-13,254,44838,18.1
13057,Cherokee County,2021-03-14,229,45067,18.2
13057,Cherokee County,2021-03-15,1528,46595,18.8
13057,Cherokee County,2021-03-16,1714,48309,19.5
13057,Cherokee County,2021-03-17,1668,49977,20.2
13057,Cherokee County,2021-03-18,1658,51635,20.9
13057,Cherokee County,2021-03-19,2000,53635,21.7
13057,Cherokee County,2021-03-20,383,54018,21.8
13057,Cherokee County,2021-03-21,369,54387,22
13057,Cherokee County,2021-03-22,1293,55680,22.5
13057,Cherokee County,2021-03-23,1560,57240,23.1
13057,Cherokee County,2021-03-24,1580,58820,23.8
13057,Cherokee County,2021-03-25,2020,60840,24.6
13057,Cherokee County,2021-03-26,1604,62444,25.2
13057,Cherokee County,2021-03-27,520,62964,25.4
13057,Cherokee County,2021-03-28,364,63328,25.6
13057,Cherokee County,2021-03-29,1592,64920,26.2
13057,Cherokee County,2021-03-30,1896,66816,27
13057,Cherokee County,2021-03-31,1809,68625,27.7
13057,Cherokee County,2021-04-01,2413,71038,28.7
13057,Cherokee County,2021-04-02,1245,72283,29.2
13057,Cherokee County,2021-04-03,584,72867,29.4
13057,Cherokee County,2021-04-04,288,73155,29.6
13057,Cherokee County,2021-04-05,1296,74451,30.1
13057,Cherokee County,2021-04-06,1870,76321,30.8
13057,Cherokee County,2021-04-07,1444,77765,31.4
13057,Cherokee County,2021-04-08,1747,79512,32.1
13057,Cherokee County,2021-04-09,1317,80829,32.7
13057,Cherokee County,2021-04-10,863,81692,33
13057,Cherokee County,2021-04-11,448,82140,33.2
13057,Cherokee County,2021-04-12,1022,83162,33.6
13057,Cherokee County,2021-04-13,918,84080,34
13057,Cherokee County,2021-04-14,898,84978,34.3
13057,Cherokee County,2021-04-15,709,85687,34.6
13057,Cherokee County,2021-04-16,992,86679,35
13057,Cherokee County,2021-04-17,176,86855,35.1
13057,Cherokee County,2021-04-18,207,87062,35.2
13057,Cherokee County,2021-04-19,575,87637,35.4
13057,Cherokee County,2021-04-20,719,88356,35.7
13057,Cherokee County,2021-04-21,741,89097,36
13057,Cherokee County,2021-04-22,710,89807,36.3
13057,Cherokee County,2021-04-23,698,90505,36.6
13057,Cherokee County,2021-04-24,261,90766,36.7
13057,Cherokee County,2021-04-25,181,90947,36.7
13057,Cherokee County,2021-04-26,511,91458,37
13057,Cherokee County,2021-04-27,632,92090,37.2
13057,Cherokee County,2021-04-28,663,92753,37.5
13057,Cherokee County,2021-04-29,556,93309,37.7
13057,Cherokee County,2021-04-30,711,94020,38
13057,Cherokee County,2021-05-01,312,94332,38.1
13057,Cherokee County,2021-05-02,191,94523,38.2
13057,Cherokee County,2021-05-03,397,94920,38.3
13057,Cherokee County,2021-05-04,470,95390,38.5
13057,Cherokee County,2021-05-05,426,95816,38.7
13057,Cherokee County,2021-05-06,413,96229,38.9
13057,Cherokee County,2021-05-07,499,96728,39.1
13057,Cherokee County,2021-05-08,265,96993,39.2
13057,Cherokee County,2021-05-09,113,97106,39.2
13057,Cherokee County,2021-05-10,258,97364,39.3
13057,Cherokee County,2021-05-11,412,97776,39.5
13057,Cherokee County,2021-05-12,414,98190,39.7
13057,Cherokee County,2021-05-13,418,98608,39.8
13057,Cherokee County,2021-05-14,590,99198,40.1
13057,Cherokee County,2021-05-15,486,99684,40.3
13057,Cherokee County,2021-05-16,280,99964,40.4
13057,Cherokee County,2021-05-17,530,100494,40.6
13057,Cherokee County,2021-05-18,535,101029,40.8
13057,Cherokee County,2021-05-19,519,101548,41
13057,Cherokee County,2021-05-20,415,101963,41.2
13057,Cherokee County,2021-05-21,432,102395,41.4
13057,Cherokee County,2021-05-22,321,102716,41.5
13057,Cherokee County,2021-05-23,173,102889,41.6
13057,Cherokee County,2021-05-24,293,103182,41.7
13057,Cherokee County,2021-05-25,291,103473,41.8
13057,Cherokee County,2021-05-26,351,103824,41.9
13057,Cherokee County,2021-05-27,257,104081,42.1
13057,Cherokee County,2021-05-28,296,104377,42.2
13057,Cherokee County,2021-05-29,155,104532,42.2
13057,Cherokee County,2021-05-30,127,104659,42.3
13057,Cherokee County,2021-05-31,35,104694,42.3
13057,Cherokee County,2021-06-01,325,105019,42.4
13057,Cherokee County,2021-06-02,268,105287,42.5
13057,Cherokee County,2021-06-03,240,105527,42.6
13057,Cherokee County,2021-06-04,309,105836,42.8
13057,Cherokee County,2021-06-05,176,106012,42.8
13057,Cherokee County,2021-06-06,144,106156,42.9
13057,Cherokee County,2021-06-07,197,106353,43
13057,Cherokee County,2021-06-08,242,106595,43.1
13057,Cherokee County,2021-06-09,190,106785,43.1
13057,Cherokee County,2021-06-10,173,106958,43.2
13057,Cherokee County,2021-06-11,235,107193,43.3
13057,Cherokee County,2021-06-12,138,107331,43.4
13057,Cherokee County,2021-06-13,49,107380,43.4
13057,Cherokee County,2021-06-14,174,107554,43.5
13057,Cherokee County,2021-06-15,178,107732,43.5
13057,Cherokee County,2021-06-16,171,107903,43.6
13057,Cherokee County,2021-06-17,185,108088,43.7
13057,Cherokee County,2021-06-18,188,108276,43.7
13057,Cherokee County,2021-06-19,131,108407,43.8
13057,Cherokee County,2021-06-20,63,108470,43.8
13057,Cherokee County,2021-06-21,165,108635,43.9
13057,Cherokee County,2021-06-22,164,108799,44
13057,Cherokee County,2021-06-23,179,108978,44
13057,Cherokee County,2021-06-24,135,109113,44.1
13057,Cherokee County,2021-06-25,164,109277,44.1
13057,Cherokee County,2021-06-26,89,109366,44.2
13057,Cherokee County,2021-06-27,73,109439,44.2
13057,Cherokee County,2021-06-28,159,109598,44.3
13057,Cherokee County,2021-06-29,159,109757,44.3
13057,Cherokee County,2021-06-30,121,109878,44.4
13057,Cherokee County,2021-07-01,134,110012,44.4
13057,Cherokee County,2021-07-02,157,110169,44.5
13057,Cherokee County,2021-07-03,78,110247,44.5
13057,Cherokee County,2021-07-04,15,110262,44.5
13057,Cherokee County,2021-07-05,88,110350,44.6
13057,Cherokee County,2021-07-06,145,110495,44.6
13057,Cherokee County,2021-07-07,136,110631,44.7
13057,Cherokee County,2021-07-08,150,110781,44.8
13057,Cherokee County,2021-07-09,178,110959,44.8
13057,Cherokee County,2021-07-10,118,111077,44.9
13057,Cherokee County,2021-07-11,84,111161,44.9
13057,Cherokee County,2021-07-12,143,111304,45
13057,Cherokee County,2021-07-13,166,111470,45
13057,Cherokee County,2021-07-14,120,111590,45.1
13057,Cherokee County,2021-07-15,138,111728,45.1
13057,Cherokee County,2021-07-16,203,111931,45.2
13057,Cherokee County,2021-07-17,154,112085,45.3
13057,Cherokee County,2021-07-18,109,112194,45.3
13057,Cherokee County,2021-07-19,200,112394,45.4
13057,Cherokee County,2021-07-20,226,112620,45.5
13057,Cherokee County,2021-07-21,244,112864,45.6
13057,Cherokee County,2021-07-22,235,113099,45.7
13057,Cherokee County,2021-07-23,321,113420,45.8
13057,Cherokee County,2021-07-24,222,113642,45.9
13057,Cherokee County,2021-07-25,194,113836,46
13057,Cherokee County,2021-07-26,303,114139,46.1
13057,Cherokee County,2021-07-27,296,114435,46.2
13057,Cherokee County,2021-07-28,335,114770,46.4
13057,Cherokee County,2021-07-29,306,115076,46.5
13057,Cherokee County,2021-07-30,428,115504,46.7
13057,Cherokee County,2021-07-31,308,115812,46.8
13057,Cherokee County,2021-08-01,206,116018,46.9
13057,Cherokee County,2021-08-02,359,116377,47
13057,Cherokee County,2021-08-03,378,116755,47.2
13057,Cherokee County,2021-08-04,367,117122,47.3
13057,Cherokee County,2021-08-05,363,117485,47.5
13057,Cherokee County,2021-08-06,511,117996,47.7
13057,Cherokee County,2021-08-07,287,118283,47.8
13057,Cherokee County,2021-08-08,246,118529,47.9
13057,Cherokee County,2021-08-09,417,118946,48.1
13057,Cherokee County,2021-08-10,442,119388,48.2
13057,Cherokee County,2021-08-11,397,119785,48.4
13057,Cherokee County,2021-08-12,387,120172,48.6
13057,Cherokee County,2021-08-13,493,120665,48.8
13057,Cherokee County,2021-08-14,347,121012,48.9
13057,Cherokee County,2021-08-15,223,121235,49
13057,Cherokee County,2021-08-16,382,121617,49.1
13057,Cherokee County,2021-08-17,387,122004,49.3
13057,Cherokee County,2021-08-18,372,122376,49.4
13057,Cherokee County,2021-08-19,379,122755,49.6
13057,Cherokee County,2021-08-20,419,123174,49.8
13057,Cherokee County,2021-08-21,268,123442,49.9
13057,Cherokee County,2021-08-22,170,123612,49.9
13057,Cherokee County,2021-08-23,332,123944,50.1
13057,Cherokee County,2021-08-24,389,124333,50.2
13057,Cherokee County,2021-08-25,361,124694,50.4
13057,Cherokee County,2021-08-26,359,125053,50.5
13057,Cherokee County,2021-08-27,388,125441,50.7
13057,Cherokee County,2021-08-28,271,125712,50.8
13057,Cherokee County,2021-08-29,150,125862,50.9
13057,Cherokee County,2021-08-30,287,126149,51
13057,Cherokee County,2021-08-31,302,126451,51.1
13057,Cherokee County,2021-09-01,299,126750,51.2
13057,Cherokee County,2021-09-02,311,127061,51.3
13057,Cherokee County,2021-09-03,362,127423,51.5
13057,Cherokee County,2021-09-04,200,127623,51.6
13057,Cherokee County,2021-09-05,192,127815,51.6
13057,Cherokee County,2021-09-06,42,127857,51.7
13057,Cherokee County,2021-09-07,269,128126,51.8
13057,Cherokee County,2021-09-08,227,128353,51.9
13057,Cherokee County,2021-09-09,234,128587,52
13057,Cherokee County,2021-09-10,348,128935,52.1
13057,Cherokee County,2021-09-11,199,129134,52.2
13057,Cherokee County,2021-09-12,145,129279,52.2
13057,Cherokee County,2021-09-13,256,129535,52.3
13057,Cherokee County,2021-09-14,219,129754,52.4
13057,Cherokee County,2021-09-15,158,129912,52.5
13057,Cherokee County,2021-09-16,170,130082,52.6
13057,Cherokee County,2021-09-17,256,130338,52.7
13057,Cherokee County,2021-09-18,150,130488,52.7
13057,Cherokee County,2021-09-19,93,130581,52.8
13057,Cherokee County,2021-09-20,158,130739,52.8
13057,Cherokee County,2021-09-21,145,130884,52.9
13057,Cherokee County,2021-09-22,139,131023,52.9
13057,Cherokee County,2021-09-23,113,131136,53
13057,Cherokee County,2021-09-24,99,131235,53
13057,Cherokee County,2021-09-25,73,131308,53.1
13057,Cherokee County,2021-09-26,44,131352,53.1
13057,Cherokee County,2021-09-27,94,131446,53.1
13057,Cherokee County,2021-09-28,82,131528,53.1
13057,Cherokee County,2021-09-29,83,131611,53.2
13057,Cherokee County,2021-09-30,65,131676,53.2
13057,Cherokee County,2021-10-01,88,131764,53.2
13057,Cherokee County,2021-10-02,46,131810,53.3
13057,Cherokee County,2021-10-03,32,131842,53.3
13057,Cherokee County,2021-10-04,51,131893,53.3
13057,Cherokee County,2021-10-05,30,131923,53.3
13057,Cherokee County,2021-10-06,51,131974,53.3
13057,Cherokee County,2021-10-07,25,131999,53.3
13059,Clarke County,2020-12-14,1,1,0
13059,Clarke County,2020-12-15,1,2,0
13059,Clarke County,2020-12-16,2,4,0
13059,Clarke County,2020-12-17,4,8,0
13059,Clarke County,2020-12-18,64,72,0.1
13059,Clarke County,2020-12-19,34,106,0.1
13059,Clarke County,2020-12-20,11,117,0.1
13059,Clarke County,2020-12-21,91,208,0.2
13059,Clarke County,2020-12-22,194,402,0.3
13059,Clarke County,2020-12-23,230,632,0.5
13059,Clarke County,2020-12-24,76,708,0.6
13059,Clarke County,2020-12-26,41,749,0.6
13059,Clarke County,2020-12-27,9,758,0.6
13059,Clarke County,2020-12-28,284,1042,0.8
13059,Clarke County,2020-12-29,293,1335,1.1
13059,Clarke County,2020-12-30,208,1543,1.2
13059,Clarke County,2020-12-31,99,1642,1.3
13059,Clarke County,2021-01-01,10,1652,1.3
13059,Clarke County,2021-01-02,63,1715,1.4
13059,Clarke County,2021-01-03,35,1750,1.4
13059,Clarke County,2021-01-04,240,1990,1.6
13059,Clarke County,2021-01-05,158,2148,1.7
13059,Clarke County,2021-01-06,298,2446,1.9
13059,Clarke County,2021-01-07,173,2619,2.1
13059,Clarke County,2021-01-08,223,2842,2.3
13059,Clarke County,2021-01-09,66,2908,2.3
13059,Clarke County,2021-01-10,60,2968,2.4
13059,Clarke County,2021-01-11,404,3372,2.7
13059,Clarke County,2021-01-12,646,4018,3.2
13059,Clarke County,2021-01-13,526,4544,3.6
13059,Clarke County,2021-01-14,510,5054,4
13059,Clarke County,2021-01-15,483,5537,4.4
13059,Clarke County,2021-01-16,362,5899,4.7
13059,Clarke County,2021-01-17,98,5997,4.8
13059,Clarke County,2021-01-18,309,6306,5
13059,Clarke County,2021-01-19,380,6686,5.3
13059,Clarke County,2021-01-20,340,7026,5.6
13059,Clarke County,2021-01-21,422,7448,5.9
13059,Clarke County,2021-01-22,298,7746,6.1
13059,Clarke County,2021-01-23,353,8099,6.4
13059,Clarke County,2021-01-24,39,8138,6.4
13059,Clarke County,2021-01-25,285,8423,6.7
13059,Clarke County,2021-01-26,228,8651,6.9
13059,Clarke County,2021-01-27,211,8862,7
13059,Clarke County,2021-01-28,343,9205,7.3
13059,Clarke County,2021-01-29,363,9568,7.6
13059,Clarke County,2021-01-30,138,9706,7.7
13059,Clarke County,2021-01-31,30,9736,7.7
13059,Clarke County,2021-02-01,244,9980,7.9
13059,Clarke County,2021-02-02,247,10227,8.1
13059,Clarke County,2021-02-03,224,10451,8.3
13059,Clarke County,2021-02-04,233,10684,8.5
13059,Clarke County,2021-02-05,222,10906,8.6
13059,Clarke County,2021-02-06,71,10977,8.7
13059,Clarke County,2021-02-07,29,11006,8.7
13059,Clarke County,2021-02-08,181,11187,8.9
13059,Clarke County,2021-02-09,262,11449,9.1
13059,Clarke County,2021-02-10,170,11619,9.2
13059,Clarke County,2021-02-11,171,11790,9.3
13059,Clarke County,2021-02-12,243,12033,9.5
13059,Clarke County,2021-02-13,112,12145,9.6
13059,Clarke County,2021-02-14,26,12171,9.6
13059,Clarke County,2021-02-15,194,12365,9.8
13059,Clarke County,2021-02-16,183,12548,9.9
13059,Clarke County,2021-02-17,169,12717,10.1
13059,Clarke County,2021-02-18,125,12842,10.2
13059,Clarke County,2021-02-19,94,12936,10.3
13059,Clarke County,2021-02-20,50,12986,10.3
13059,Clarke County,2021-02-21,7,12993,10.3
13059,Clarke County,2021-02-22,152,13145,10.4
13059,Clarke County,2021-02-23,207,13352,10.6
13059,Clarke County,2021-02-24,256,13608,10.8
13059,Clarke County,2021-02-25,249,13857,11
13059,Clarke County,2021-02-26,330,14187,11.2
13059,Clarke County,2021-02-27,172,14359,11.4
13059,Clarke County,2021-02-28,81,14440,11.4
13059,Clarke County,2021-03-01,413,14853,11.8
13059,Clarke County,2021-03-02,382,15235,12.1
13059,Clarke County,2021-03-03,368,15603,12.4
13059,Clarke County,2021-03-04,324,15927,12.6
13059,Clarke County,2021-03-05,286,16213,12.8
13059,Clarke County,2021-03-06,119,16332,12.9
13059,Clarke County,2021-03-07,152,16484,13.1
13059,Clarke County,2021-03-08,703,17187,13.6
13059,Clarke County,2021-03-09,449,17636,14
13059,Clarke County,2021-03-10,1392,19028,15.1
13059,Clarke County,2021-03-11,585,19613,15.5
13059,Clarke County,2021-03-12,484,20097,15.9
13059,Clarke County,2021-03-13,578,20675,16.4
13059,Clarke County,2021-03-14,212,20887,16.6
13059,Clarke County,2021-03-15,637,21524,17.1
13059,Clarke County,2021-03-16,748,22272,17.7
13059,Clarke County,2021-03-17,1084,23356,18.5
13059,Clarke County,2021-03-18,864,24220,19.2
13059,Clarke County,2021-03-19,762,24982,19.8
13059,Clarke County,2021-03-20,198,25180,20
13059,Clarke County,2021-03-21,154,25334,20.1
13059,Clarke County,2021-03-22,1007,26341,20.9
13059,Clarke County,2021-03-23,965,27306,21.6
13059,Clarke County,2021-03-24,1429,28735,22.8
13059,Clarke County,2021-03-25,1231,29966,23.7
13059,Clarke County,2021-03-26,906,30872,24.5
13059,Clarke County,2021-03-27,233,31105,24.7
13059,Clarke County,2021-03-28,123,31228,24.7
13059,Clarke County,2021-03-29,951,32179,25.5
13059,Clarke County,2021-03-30,1169,33348,26.4
13059,Clarke County,2021-03-31,1202,34550,27.4
13059,Clarke County,2021-04-01,1003,35553,28.2
13059,Clarke County,2021-04-02,837,36390,28.8
13059,Clarke County,2021-04-03,189,36579,29
13059,Clarke County,2021-04-04,128,36707,29.1
13059,Clarke County,2021-04-05,687,37394,29.6
13059,Clarke County,2021-04-06,740,38134,30.2
13059,Clarke County,2021-04-07,661,38795,30.7
13059,Clarke County,2021-04-08,681,39476,31.3
13059,Clarke County,2021-04-09,809,40285,31.9
13059,Clarke County,2021-04-10,328,40613,32.2
13059,Clarke County,2021-04-11,88,40701,32.3
13059,Clarke County,2021-04-12,450,41151,32.6
13059,Clarke County,2021-04-13,405,41556,32.9
13059,Clarke County,2021-04-14,386,41942,33.2
13059,Clarke County,2021-04-15,349,42291,33.5
13059,Clarke County,2021-04-16,371,42662,33.8
13059,Clarke County,2021-04-17,389,43051,34.1
13059,Clarke County,2021-04-18,32,43083,34.1
13059,Clarke County,2021-04-19,233,43316,34.3
13059,Clarke County,2021-04-20,266,43582,34.5
13059,Clarke County,2021-04-21,238,43820,34.7
13059,Clarke County,2021-04-22,264,44084,34.9
13059,Clarke County,2021-04-23,316,44400,35.2
13059,Clarke County,2021-04-24,120,44520,35.3
13059,Clarke County,2021-04-25,46,44566,35.3
13059,Clarke County,2021-04-26,167,44733,35.5
13059,Clarke County,2021-04-27,192,44925,35.6
13059,Clarke County,2021-04-28,223,45148,35.8
13059,Clarke County,2021-04-29,208,45356,35.9
13059,Clarke County,2021-04-30,270,45626,36.2
13059,Clarke County,2021-05-01,143,45769,36.3
13059,Clarke County,2021-05-02,36,45805,36.3
13059,Clarke County,2021-05-03,151,45956,36.4
13059,Clarke County,2021-05-04,143,46099,36.5
13059,Clarke County,2021-05-05,169,46268,36.7
13059,Clarke County,2021-05-06,212,46480,36.8
13059,Clarke County,2021-05-07,174,46654,37
13059,Clarke County,2021-05-08,58,46712,37
13059,Clarke County,2021-05-09,34,46746,37
13059,Clarke County,2021-05-10,132,46878,37.2
13059,Clarke County,2021-05-11,203,47081,37.3
13059,Clarke County,2021-05-12,245,47326,37.5
13059,Clarke County,2021-05-13,257,47583,37.7
13059,Clarke County,2021-05-14,301,47884,38
13059,Clarke County,2021-05-15,123,48007,38
13059,Clarke County,2021-05-16,81,48088,38.1
13059,Clarke County,2021-05-17,231,48319,38.3
13059,Clarke County,2021-05-18,187,48506,38.4
13059,Clarke County,2021-05-19,186,48692,38.6
13059,Clarke County,2021-05-20,187,48879,38.7
13059,Clarke County,2021-05-21,208,49087,38.9
13059,Clarke County,2021-05-22,93,49180,39
13059,Clarke County,2021-05-23,55,49235,39
13059,Clarke County,2021-05-24,144,49379,39.1
13059,Clarke County,2021-05-25,139,49518,39.2
13059,Clarke County,2021-05-26,165,49683,39.4
13059,Clarke County,2021-05-27,148,49831,39.5
13059,Clarke County,2021-05-28,132,49963,39.6
13059,Clarke County,2021-05-29,41,50004,39.6
13059,Clarke County,2021-05-30,28,50032,39.7
13059,Clarke County,2021-05-31,8,50040,39.7
13059,Clarke County,2021-06-01,127,50167,39.8
13059,Clarke County,2021-06-02,117,50284,39.9
13059,Clarke County,2021-06-03,81,50365,39.9
13059,Clarke County,2021-06-04,138,50503,40
13059,Clarke County,2021-06-05,59,50562,40.1
13059,Clarke County,2021-06-06,25,50587,40.1
13059,Clarke County,2021-06-07,90,50677,40.2
13059,Clarke County,2021-06-08,74,50751,40.2
13059,Clarke County,2021-06-09,79,50830,40.3
13059,Clarke County,2021-06-10,79,50909,40.3
13059,Clarke County,2021-06-11,85,50994,40.4
13059,Clarke County,2021-06-12,57,51051,40.5
13059,Clarke County,2021-06-13,13,51064,40.5
13059,Clarke County,2021-06-14,80,51144,40.5
13059,Clarke County,2021-06-15,77,51221,40.6
13059,Clarke County,2021-06-16,55,51276,40.6
13059,Clarke County,2021-06-17,71,51347,40.7
13059,Clarke County,2021-06-18,99,51446,40.8
13059,Clarke County,2021-06-19,55,51501,40.8
13059,Clarke County,2021-06-20,24,51525,40.8
13059,Clarke County,2021-06-21,58,51583,40.9
13059,Clarke County,2021-06-22,63,51646,40.9
13059,Clarke County,2021-06-23,73,51719,41
13059,Clarke County,2021-06-24,59,51778,41
13059,Clarke County,2021-06-25,80,51858,41.1
13059,Clarke County,2021-06-26,47,51905,41.1
13059,Clarke County,2021-06-27,28,51933,41.2
13059,Clarke County,2021-06-28,57,51990,41.2
13059,Clarke County,2021-06-29,51,52041,41.2
13059,Clarke County,2021-06-30,72,52113,41.3
13059,Clarke County,2021-07-01,60,52173,41.3
13059,Clarke County,2021-07-02,85,52258,41.4
13059,Clarke County,2021-07-03,29,52287,41.4
13059,Clarke County,2021-07-04,2,52289,41.4
13059,Clarke County,2021-07-05,29,52318,41.5
13059,Clarke County,2021-07-06,53,52371,41.5
13059,Clarke County,2021-07-07,70,52441,41.6
13059,Clarke County,2021-07-08,69,52510,41.6
13059,Clarke County,2021-07-09,95,52605,41.7
13059,Clarke County,2021-07-10,43,52648,41.7
13059,Clarke County,2021-07-11,21,52669,41.7
13059,Clarke County,2021-07-12,72,52741,41.8
13059,Clarke County,2021-07-13,84,52825,41.9
13059,Clarke County,2021-07-14,65,52890,41.9
13059,Clarke County,2021-07-15,59,52949,42
13059,Clarke County,2021-07-16,102,53051,42
13059,Clarke County,2021-07-17,73,53124,42.1
13059,Clarke County,2021-07-18,22,53146,42.1
13059,Clarke County,2021-07-19,74,53220,42.2
13059,Clarke County,2021-07-20,90,53310,42.3
13059,Clarke County,2021-07-21,105,53415,42.3
13059,Clarke County,2021-07-22,114,53529,42.4
13059,Clarke County,2021-07-23,138,53667,42.5
13059,Clarke County,2021-07-24,99,53766,42.6
13059,Clarke County,2021-07-25,43,53809,42.6
13059,Clarke County,2021-07-26,105,53914,42.7
13059,Clarke County,2021-07-27,129,54043,42.8
13059,Clarke County,2021-07-28,117,54160,42.9
13059,Clarke County,2021-07-29,137,54297,43
13059,Clarke County,2021-07-30,160,54457,43.2
13059,Clarke County,2021-07-31,82,54539,43.2
13059,Clarke County,2021-08-01,54,54593,43.3
13059,Clarke County,2021-08-02,149,54742,43.4
13059,Clarke County,2021-08-03,174,54916,43.5
13059,Clarke County,2021-08-04,134,55050,43.6
13059,Clarke County,2021-08-05,111,55161,43.7
13059,Clarke County,2021-08-06,200,55361,43.9
13059,Clarke County,2021-08-07,105,55466,44
13059,Clarke County,2021-08-08,54,55520,44
13059,Clarke County,2021-08-09,137,55657,44.1
13059,Clarke County,2021-08-10,146,55803,44.2
13059,Clarke County,2021-08-11,111,55914,44.3
13059,Clarke County,2021-08-12,136,56050,44.4
13059,Clarke County,2021-08-13,220,56270,44.6
13059,Clarke County,2021-08-14,85,56355,44.7
13059,Clarke County,2021-08-15,73,56428,44.7
13059,Clarke County,2021-08-16,131,56559,44.8
13059,Clarke County,2021-08-17,126,56685,44.9
13059,Clarke County,2021-08-18,139,56824,45
13059,Clarke County,2021-08-19,134,56958,45.1
13059,Clarke County,2021-08-20,175,57133,45.3
13059,Clarke County,2021-08-21,79,57212,45.3
13059,Clarke County,2021-08-22,42,57254,45.4
13059,Clarke County,2021-08-23,122,57376,45.5
13059,Clarke County,2021-08-24,130,57506,45.6
13059,Clarke County,2021-08-25,99,57605,45.7
13059,Clarke County,2021-08-26,135,57740,45.8
13059,Clarke County,2021-08-27,163,57903,45.9
13059,Clarke County,2021-08-28,82,57985,46
13059,Clarke County,2021-08-29,43,58028,46
13059,Clarke County,2021-08-30,100,58128,46.1
13059,Clarke County,2021-08-31,128,58256,46.2
13059,Clarke County,2021-09-01,118,58374,46.3
13059,Clarke County,2021-09-02,108,58482,46.3
13059,Clarke County,2021-09-03,252,58734,46.5
13059,Clarke County,2021-09-04,60,58794,46.6
13059,Clarke County,2021-09-05,46,58840,46.6
13059,Clarke County,2021-09-06,14,58854,46.6
13059,Clarke County,2021-09-07,140,58994,46.8
13059,Clarke County,2021-09-08,91,59085,46.8
13059,Clarke County,2021-09-09,137,59222,46.9
13059,Clarke County,2021-09-10,126,59348,47
13059,Clarke County,2021-09-11,48,59396,47.1
13059,Clarke County,2021-09-12,32,59428,47.1
13059,Clarke County,2021-09-13,105,59533,47.2
13059,Clarke County,2021-09-14,102,59635,47.3
13059,Clarke County,2021-09-15,109,59744,47.3
13059,Clarke County,2021-09-16,149,59893,47.5
13059,Clarke County,2021-09-17,92,59985,47.5
13059,Clarke County,2021-09-18,58,60043,47.6
13059,Clarke County,2021-09-19,25,60068,47.6
13059,Clarke County,2021-09-20,82,60150,47.7
13059,Clarke County,2021-09-21,85,60235,47.7
13059,Clarke County,2021-09-22,65,60300,47.8
13059,Clarke County,2021-09-23,64,60364,47.8
13059,Clarke County,2021-09-24,81,60445,47.9
13059,Clarke County,2021-09-25,51,60496,47.9
13059,Clarke County,2021-09-26,25,60521,48
13059,Clarke County,2021-09-27,44,60565,48
13059,Clarke County,2021-09-28,60,60625,48
13059,Clarke County,2021-09-29,51,60676,48.1
13059,Clarke County,2021-09-30,52,60728,48.1
13059,Clarke County,2021-10-01,52,60780,48.2
13059,Clarke County,2021-10-02,25,60805,48.2
13059,Clarke County,2021-10-03,11,60816,48.2
13059,Clarke County,2021-10-04,48,60864,48.2
13059,Clarke County,2021-10-05,47,60911,48.3
13059,Clarke County,2021-10-06,30,60941,48.3
13059,Clarke County,2021-10-07,31,60972,48.3
13061,Clay County,2020-12-21,1,1,0
13061,Clay County,2020-12-22,1,2,0.1
13061,Clay County,2020-12-23,1,3,0.1
13061,Clay County,2020-12-24,12,15,0.5
13061,Clay County,2020-12-26,10,25,0.8
13061,Clay County,2020-12-28,7,32,1.1
13061,Clay County,2020-12-29,5,37,1.3
13061,Clay County,2020-12-30,7,44,1.5
13061,Clay County,2020-12-31,4,48,1.6
13061,Clay County,2021-01-01,12,60,2
13061,Clay County,2021-01-02,15,75,2.5
13061,Clay County,2021-01-04,3,78,2.6
13061,Clay County,2021-01-05,51,129,4.4
13061,Clay County,2021-01-06,10,139,4.7
13061,Clay County,2021-01-07,20,159,5.4
13061,Clay County,2021-01-08,14,173,5.9
13061,Clay County,2021-01-09,3,176,6
13061,Clay County,2021-01-10,1,177,6
13061,Clay County,2021-01-11,10,187,6.3
13061,Clay County,2021-01-12,28,215,7.3
13061,Clay County,2021-01-13,48,263,8.9
13061,Clay County,2021-01-14,36,299,10.1
13061,Clay County,2021-01-15,55,354,12
13061,Clay County,2021-01-16,1,355,12
13061,Clay County,2021-01-17,1,356,12.1
13061,Clay County,2021-01-18,14,370,12.5
13061,Clay County,2021-01-19,19,389,13.2
13061,Clay County,2021-01-20,16,405,13.7
13061,Clay County,2021-01-21,39,444,15
13061,Clay County,2021-01-22,8,452,15.3
13061,Clay County,2021-01-24,2,454,15.4
13061,Clay County,2021-01-25,8,462,15.7
13061,Clay County,2021-01-26,21,483,16.4
13061,Clay County,2021-01-27,13,496,16.8
13061,Clay County,2021-01-28,33,529,17.9
13061,Clay County,2021-01-29,11,540,18.3
13061,Clay County,2021-01-30,2,542,18.4
13061,Clay County,2021-01-31,1,543,18.4
13061,Clay County,2021-02-01,40,583,19.8
13061,Clay County,2021-02-02,7,590,20
13061,Clay County,2021-02-03,11,601,20.4
13061,Clay County,2021-02-04,13,614,20.8
13061,Clay County,2021-02-05,8,622,21.1
13061,Clay County,2021-02-06,1,623,21.1
13061,Clay County,2021-02-07,1,624,21.1
13061,Clay County,2021-02-08,6,630,21.3
13061,Clay County,2021-02-09,5,635,21.5
13061,Clay County,2021-02-10,5,640,21.7
13061,Clay County,2021-02-11,4,644,21.8
13061,Clay County,2021-02-12,41,685,23.2
13061,Clay County,2021-02-14,3,688,23.3
13061,Clay County,2021-02-15,3,691,23.4
13061,Clay County,2021-02-16,4,695,23.6
13061,Clay County,2021-02-17,6,701,23.8
13061,Clay County,2021-02-18,24,725,24.6
13061,Clay County,2021-02-19,3,728,24.7
13061,Clay County,2021-02-20,4,732,24.8
13061,Clay County,2021-02-21,2,734,24.9
13061,Clay County,2021-02-22,1,735,24.9
13061,Clay County,2021-02-23,8,743,25.2
13061,Clay County,2021-02-24,32,775,26.3
13061,Clay County,2021-02-25,18,793,26.9
13061,Clay County,2021-02-26,25,818,27.7
13061,Clay County,2021-02-27,5,823,27.9
13061,Clay County,2021-02-28,6,829,28.1
13061,Clay County,2021-03-01,51,880,29.8
13061,Clay County,2021-03-02,20,900,30.5
13061,Clay County,2021-03-03,11,911,30.9
13061,Clay County,2021-03-04,7,918,31.1
13061,Clay County,2021-03-05,24,942,31.9
13061,Clay County,2021-03-06,2,944,32
13061,Clay County,2021-03-07,1,945,32
13061,Clay County,2021-03-08,19,964,32.7
13061,Clay County,2021-03-09,13,977,33.1
13061,Clay County,2021-03-10,33,1010,34.2
13061,Clay County,2021-03-11,9,1019,34.5
13061,Clay County,2021-03-12,9,1028,34.8
13061,Clay County,2021-03-14,2,1030,34.9
13061,Clay County,2021-03-15,27,1057,35.8
13061,Clay County,2021-03-16,13,1070,36.3
13061,Clay County,2021-03-17,31,1101,37.3
13061,Clay County,2021-03-18,18,1119,37.9
13061,Clay County,2021-03-19,15,1134,38.4
13061,Clay County,2021-03-20,1,1135,38.5
13061,Clay County,2021-03-22,7,1142,38.7
13061,Clay County,2021-03-23,4,1146,38.8
13061,Clay County,2021-03-24,14,1160,39.3
13061,Clay County,2021-03-25,18,1178,39.9
13061,Clay County,2021-03-26,10,1188,40.3
13061,Clay County,2021-03-27,1,1189,40.3
13061,Clay County,2021-03-28,2,1191,40.4
13061,Clay County,2021-03-29,15,1206,40.9
13061,Clay County,2021-03-30,9,1215,41.2
13061,Clay County,2021-03-31,19,1234,41.8
13061,Clay County,2021-04-01,37,1271,43.1
13061,Clay County,2021-04-02,12,1283,43.5
13061,Clay County,2021-04-03,1,1284,43.5
13061,Clay County,2021-04-04,2,1286,43.6
13061,Clay County,2021-04-05,5,1291,43.7
13061,Clay County,2021-04-06,4,1295,43.9
13061,Clay County,2021-04-07,14,1309,44.4
13061,Clay County,2021-04-08,11,1320,44.7
13061,Clay County,2021-04-09,12,1332,45.1
13061,Clay County,2021-04-10,14,1346,45.6
13061,Clay County,2021-04-12,2,1348,45.7
13061,Clay County,2021-04-13,7,1355,45.9
13061,Clay County,2021-04-14,11,1366,46.3
13061,Clay County,2021-04-15,16,1382,46.8
13061,Clay County,2021-04-16,5,1387,47
13061,Clay County,2021-04-18,2,1389,47.1
13061,Clay County,2021-04-19,11,1400,47.4
13061,Clay County,2021-04-20,5,1405,47.6
13061,Clay County,2021-04-21,7,1412,47.8
13061,Clay County,2021-04-22,18,1430,48.5
13061,Clay County,2021-04-23,12,1442,48.9
13061,Clay County,2021-04-24,1,1443,48.9
13061,Clay County,2021-04-26,1,1444,48.9
13061,Clay County,2021-04-27,5,1449,49.1
13061,Clay County,2021-04-28,7,1456,49.3
13061,Clay County,2021-04-29,3,1459,49.4
13061,Clay County,2021-04-30,5,1464,49.6
13061,Clay County,2021-05-01,6,1470,49.8
13061,Clay County,2021-05-03,1,1471,49.8
13061,Clay County,2021-05-04,5,1476,50
13061,Clay County,2021-05-05,8,1484,50.3
13061,Clay County,2021-05-06,7,1491,50.5
13061,Clay County,2021-05-07,1,1492,50.6
13061,Clay County,2021-05-08,3,1495,50.7
13061,Clay County,2021-05-09,1,1496,50.7
13061,Clay County,2021-05-10,3,1499,50.8
13061,Clay County,2021-05-11,10,1509,51.1
13061,Clay County,2021-05-12,6,1515,51.3
13061,Clay County,2021-05-13,5,1520,51.5
13061,Clay County,2021-05-14,3,1523,51.6
13061,Clay County,2021-05-15,5,1528,51.8
13061,Clay County,2021-05-16,1,1529,51.8
13061,Clay County,2021-05-17,3,1532,51.9
13061,Clay County,2021-05-18,6,1538,52.1
13061,Clay County,2021-05-19,6,1544,52.3
13061,Clay County,2021-05-20,4,1548,52.5
13061,Clay County,2021-05-21,1,1549,52.5
13061,Clay County,2021-05-22,3,1552,52.6
13061,Clay County,2021-05-24,1,1553,52.6
13061,Clay County,2021-05-25,3,1556,52.7
13061,Clay County,2021-05-26,3,1559,52.8
13061,Clay County,2021-05-27,4,1563,53
13061,Clay County,2021-05-28,2,1565,53
13061,Clay County,2021-05-30,1,1566,53.1
13061,Clay County,2021-06-01,5,1571,53.2
13061,Clay County,2021-06-02,2,1573,53.3
13061,Clay County,2021-06-03,2,1575,53.4
13061,Clay County,2021-06-04,2,1577,53.4
13061,Clay County,2021-06-07,3,1580,53.5
13061,Clay County,2021-06-08,1,1581,53.6
13061,Clay County,2021-06-09,7,1588,53.8
13061,Clay County,2021-06-10,4,1592,53.9
13061,Clay County,2021-06-11,1,1593,54
13061,Clay County,2021-06-13,1,1594,54
13061,Clay County,2021-06-14,3,1597,54.1
13061,Clay County,2021-06-15,5,1602,54.3
13061,Clay County,2021-06-16,1,1603,54.3
13061,Clay County,2021-06-17,3,1606,54.4
13061,Clay County,2021-06-18,3,1609,54.5
13061,Clay County,2021-06-19,3,1612,54.6
13061,Clay County,2021-06-21,1,1613,54.7
13061,Clay County,2021-06-22,9,1622,55
13061,Clay County,2021-06-23,5,1627,55.1
13061,Clay County,2021-06-24,1,1628,55.2
13061,Clay County,2021-06-25,3,1631,55.3
13061,Clay County,2021-06-26,1,1632,55.3
13061,Clay County,2021-06-27,1,1633,55.3
13061,Clay County,2021-06-29,1,1634,55.4
13061,Clay County,2021-06-30,5,1639,55.5
13061,Clay County,2021-07-01,2,1641,55.6
13061,Clay County,2021-07-05,1,1642,55.6
13061,Clay County,2021-07-06,1,1643,55.7
13061,Clay County,2021-07-07,3,1646,55.8
13061,Clay County,2021-07-08,2,1648,55.8
13061,Clay County,2021-07-09,1,1649,55.9
13061,Clay County,2021-07-10,1,1650,55.9
13061,Clay County,2021-07-12,2,1652,56
13061,Clay County,2021-07-13,3,1655,56.1
13061,Clay County,2021-07-14,5,1660,56.3
13061,Clay County,2021-07-15,3,1663,56.4
13061,Clay County,2021-07-16,9,1672,56.7
13061,Clay County,2021-07-18,1,1673,56.7
13061,Clay County,2021-07-19,3,1676,56.8
13061,Clay County,2021-07-20,1,1677,56.8
13061,Clay County,2021-07-21,5,1682,57
13061,Clay County,2021-07-22,1,1683,57
13061,Clay County,2021-07-23,5,1688,57.2
13061,Clay County,2021-07-26,2,1690,57.3
13061,Clay County,2021-07-27,2,1692,57.3
13061,Clay County,2021-07-28,14,1706,57.8
13061,Clay County,2021-07-29,4,1710,57.9
13061,Clay County,2021-07-30,6,1716,58.1
13061,Clay County,2021-07-31,1,1717,58.2
13061,Clay County,2021-08-01,3,1720,58.3
13061,Clay County,2021-08-02,13,1733,58.7
13061,Clay County,2021-08-03,3,1736,58.8
13061,Clay County,2021-08-04,7,1743,59.1
13061,Clay County,2021-08-05,3,1746,59.2
13061,Clay County,2021-08-06,10,1756,59.5
13061,Clay County,2021-08-07,2,1758,59.6
13061,Clay County,2021-08-08,1,1759,59.6
13061,Clay County,2021-08-09,5,1764,59.8
13061,Clay County,2021-08-10,9,1773,60.1
13061,Clay County,2021-08-11,8,1781,60.4
13061,Clay County,2021-08-12,14,1795,60.8
13061,Clay County,2021-08-13,17,1812,61.4
13061,Clay County,2021-08-14,2,1814,61.5
13061,Clay County,2021-08-15,4,1818,61.6
13061,Clay County,2021-08-16,6,1824,61.8
13061,Clay County,2021-08-17,1,1825,61.8
13061,Clay County,2021-08-18,10,1835,62.2
13061,Clay County,2021-08-19,10,1845,62.5
13061,Clay County,2021-08-20,5,1850,62.7
13061,Clay County,2021-08-21,2,1852,62.8
13061,Clay County,2021-08-22,2,1854,62.8
13061,Clay County,2021-08-23,7,1861,63.1
13061,Clay County,2021-08-24,1,1862,63.1
13061,Clay County,2021-08-25,6,1868,63.3
13061,Clay County,2021-08-26,10,1878,63.6
13061,Clay County,2021-08-27,6,1884,63.8
13061,Clay County,2021-08-28,2,1886,63.9
13061,Clay County,2021-08-29,3,1889,64
13061,Clay County,2021-08-30,5,1894,64.2
13061,Clay County,2021-08-31,2,1896,64.2
13061,Clay County,2021-09-01,3,1899,64.4
13061,Clay County,2021-09-02,5,1904,64.5
13061,Clay County,2021-09-03,6,1910,64.7
13061,Clay County,2021-09-04,2,1912,64.8
13061,Clay County,2021-09-07,4,1916,64.9
13061,Clay County,2021-09-08,12,1928,65.3
13061,Clay County,2021-09-09,1,1929,65.4
13061,Clay County,2021-09-10,2,1931,65.4
13061,Clay County,2021-09-11,2,1933,65.5
13061,Clay County,2021-09-12,2,1935,65.6
13061,Clay County,2021-09-13,2,1937,65.6
13061,Clay County,2021-09-14,9,1946,65.9
13061,Clay County,2021-09-15,2,1948,66
13061,Clay County,2021-09-16,6,1954,66.2
13061,Clay County,2021-09-17,1,1955,66.2
13061,Clay County,2021-09-18,1,1956,66.3
13061,Clay County,2021-09-20,1,1957,66.3
13061,Clay County,2021-09-21,2,1959,66.4
13061,Clay County,2021-09-22,2,1961,66.5
13061,Clay County,2021-09-23,1,1962,66.5
13061,Clay County,2021-09-26,1,1963,66.5
13061,Clay County,2021-09-27,3,1966,66.6
13061,Clay County,2021-09-29,1,1967,66.7
13061,Clay County,2021-09-30,3,1970,66.8
13061,Clay County,2021-10-05,1,1971,66.8
13061,Clay County,2021-10-06,2,1973,66.9
13061,Clay County,2021-10-07,4,1977,67
13063,Clayton County,2020-12-16,3,3,0
13063,Clayton County,2020-12-17,12,15,0
13063,Clayton County,2020-12-18,37,52,0
13063,Clayton County,2020-12-19,32,84,0
13063,Clayton County,2020-12-20,20,104,0
13063,Clayton County,2020-12-21,50,154,0.1
13063,Clayton County,2020-12-22,78,232,0.1
13063,Clayton County,2020-12-23,122,354,0.1
13063,Clayton County,2020-12-24,15,369,0.1
13063,Clayton County,2020-12-26,15,384,0.1
13063,Clayton County,2020-12-27,100,484,0.2
13063,Clayton County,2020-12-28,176,660,0.2
13063,Clayton County,2020-12-29,330,990,0.3
13063,Clayton County,2020-12-30,218,1208,0.4
13063,Clayton County,2020-12-31,128,1336,0.5
13063,Clayton County,2021-01-01,31,1367,0.5
13063,Clayton County,2021-01-02,21,1388,0.5
13063,Clayton County,2021-01-03,26,1414,0.5
13063,Clayton County,2021-01-04,154,1568,0.6
13063,Clayton County,2021-01-05,171,1739,0.6
13063,Clayton County,2021-01-06,350,2089,0.7
13063,Clayton County,2021-01-07,152,2241,0.8
13063,Clayton County,2021-01-08,183,2424,0.9
13063,Clayton County,2021-01-09,76,2500,0.9
13063,Clayton County,2021-01-10,41,2541,0.9
13063,Clayton County,2021-01-11,291,2832,1
13063,Clayton County,2021-01-12,236,3068,1.1
13063,Clayton County,2021-01-13,288,3356,1.2
13063,Clayton County,2021-01-14,324,3680,1.3
13063,Clayton County,2021-01-15,706,4386,1.5
13063,Clayton County,2021-01-16,341,4727,1.7
13063,Clayton County,2021-01-17,115,4842,1.7
13063,Clayton County,2021-01-18,237,5079,1.8
13063,Clayton County,2021-01-19,344,5423,1.9
13063,Clayton County,2021-01-20,403,5826,2.1
13063,Clayton County,2021-01-21,379,6205,2.2
13063,Clayton County,2021-01-22,388,6593,2.3
13063,Clayton County,2021-01-23,648,7241,2.6
13063,Clayton County,2021-01-24,36,7277,2.6
13063,Clayton County,2021-01-25,314,7591,2.7
13063,Clayton County,2021-01-26,284,7875,2.8
13063,Clayton County,2021-01-27,350,8225,2.9
13063,Clayton County,2021-01-28,371,8596,3
13063,Clayton County,2021-01-29,867,9463,3.3
13063,Clayton County,2021-01-30,197,9660,3.4
13063,Clayton County,2021-01-31,120,9780,3.4
13063,Clayton County,2021-02-01,319,10099,3.6
13063,Clayton County,2021-02-02,226,10325,3.6
13063,Clayton County,2021-02-03,265,10590,3.7
13063,Clayton County,2021-02-04,380,10970,3.9
13063,Clayton County,2021-02-05,220,11190,3.9
13063,Clayton County,2021-02-06,491,11681,4.1
13063,Clayton County,2021-02-07,36,11717,4.1
13063,Clayton County,2021-02-08,160,11877,4.2
13063,Clayton County,2021-02-09,388,12265,4.3
13063,Clayton County,2021-02-10,552,12817,4.5
13063,Clayton County,2021-02-11,298,13115,4.6
13063,Clayton County,2021-02-12,237,13352,4.7
13063,Clayton County,2021-02-13,166,13518,4.8
13063,Clayton County,2021-02-14,69,13587,4.8
13063,Clayton County,2021-02-15,224,13811,4.9
13063,Clayton County,2021-02-16,468,14279,5
13063,Clayton County,2021-02-17,453,14732,5.2
13063,Clayton County,2021-02-18,313,15045,5.3
13063,Clayton County,2021-02-19,431,15476,5.5
13063,Clayton County,2021-02-20,133,15609,5.5
13063,Clayton County,2021-02-21,57,15666,5.5
13063,Clayton County,2021-02-22,232,15898,5.6
13063,Clayton County,2021-02-23,582,16480,5.8
13063,Clayton County,2021-02-24,496,16976,6
13063,Clayton County,2021-02-25,549,17525,6.2
13063,Clayton County,2021-02-26,486,18011,6.4
13063,Clayton County,2021-02-27,243,18254,6.4
13063,Clayton County,2021-02-28,170,18424,6.5
13063,Clayton County,2021-03-01,412,18836,6.6
13063,Clayton County,2021-03-02,605,19441,6.9
13063,Clayton County,2021-03-03,557,19998,7.1
13063,Clayton County,2021-03-04,777,20775,7.3
13063,Clayton County,2021-03-05,885,21660,7.6
13063,Clayton County,2021-03-06,421,22081,7.8
13063,Clayton County,2021-03-07,214,22295,7.9
13063,Clayton County,2021-03-08,695,22990,8.1
13063,Clayton County,2021-03-09,1030,24020,8.5
13063,Clayton County,2021-03-10,1037,25057,8.8
13063,Clayton County,2021-03-11,1144,26201,9.2
13063,Clayton County,2021-03-12,1043,27244,9.6
13063,Clayton County,2021-03-13,548,27792,9.8
13063,Clayton County,2021-03-14,385,28177,9.9
13063,Clayton County,2021-03-15,937,29114,10.3
13063,Clayton County,2021-03-16,1074,30188,10.6
13063,Clayton County,2021-03-17,1057,31245,11
13063,Clayton County,2021-03-18,904,32149,11.3
13063,Clayton County,2021-03-19,1242,33391,11.8
13063,Clayton County,2021-03-20,605,33996,12
13063,Clayton County,2021-03-21,435,34431,12.1
13063,Clayton County,2021-03-22,988,35419,12.5
13063,Clayton County,2021-03-23,1445,36864,13
13063,Clayton County,2021-03-24,1603,38467,13.6
13063,Clayton County,2021-03-25,1881,40348,14.2
13063,Clayton County,2021-03-26,1340,41688,14.7
13063,Clayton County,2021-03-27,879,42567,15
13063,Clayton County,2021-03-28,472,43039,15.2
13063,Clayton County,2021-03-29,1276,44315,15.6
13063,Clayton County,2021-03-30,1752,46067,16.2
13063,Clayton County,2021-03-31,1788,47855,16.9
13063,Clayton County,2021-04-01,1739,49594,17.5
13063,Clayton County,2021-04-02,1503,51097,18
13063,Clayton County,2021-04-03,738,51835,18.3
13063,Clayton County,2021-04-04,286,52121,18.4
13063,Clayton County,2021-04-05,1183,53304,18.8
13063,Clayton County,2021-04-06,1864,55168,19.5
13063,Clayton County,2021-04-07,1892,57060,20.1
13063,Clayton County,2021-04-08,1699,58759,20.7
13063,Clayton County,2021-04-09,1811,60570,21.4
13063,Clayton County,2021-04-10,1334,61904,21.8
13063,Clayton County,2021-04-11,387,62291,22
13063,Clayton County,2021-04-12,996,63287,22.3
13063,Clayton County,2021-04-13,1228,64515,22.8
13063,Clayton County,2021-04-14,1108,65623,23.1
13063,Clayton County,2021-04-15,1022,66645,23.5
13063,Clayton County,2021-04-16,994,67639,23.9
13063,Clayton County,2021-04-17,463,68102,24
13063,Clayton County,2021-04-18,299,68401,24.1
13063,Clayton County,2021-04-19,652,69053,24.4
13063,Clayton County,2021-04-20,942,69995,24.7
13063,Clayton County,2021-04-21,831,70826,25
13063,Clayton County,2021-04-22,836,71662,25.3
13063,Clayton County,2021-04-23,766,72428,25.5
13063,Clayton County,2021-04-24,499,72927,25.7
13063,Clayton County,2021-04-25,247,73174,25.8
13063,Clayton County,2021-04-26,577,73751,26
13063,Clayton County,2021-04-27,660,74411,26.2
13063,Clayton County,2021-04-28,686,75097,26.5
13063,Clayton County,2021-04-29,722,75819,26.7
13063,Clayton County,2021-04-30,736,76555,27
13063,Clayton County,2021-05-01,536,77091,27.2
13063,Clayton County,2021-05-02,315,77406,27.3
13063,Clayton County,2021-05-03,530,77936,27.5
13063,Clayton County,2021-05-04,634,78570,27.7
13063,Clayton County,2021-05-05,650,79220,27.9
13063,Clayton County,2021-05-06,549,79769,28.1
13063,Clayton County,2021-05-07,528,80297,28.3
13063,Clayton County,2021-05-08,356,80653,28.4
13063,Clayton County,2021-05-09,144,80797,28.5
13063,Clayton County,2021-05-10,405,81202,28.6
13063,Clayton County,2021-05-11,605,81807,28.9
13063,Clayton County,2021-05-12,482,82289,29
13063,Clayton County,2021-05-13,520,82809,29.2
13063,Clayton County,2021-05-14,721,83530,29.5
13063,Clayton County,2021-05-15,628,84158,29.7
13063,Clayton County,2021-05-16,417,84575,29.8
13063,Clayton County,2021-05-17,665,85240,30.1
13063,Clayton County,2021-05-18,635,85875,30.3
13063,Clayton County,2021-05-19,535,86410,30.5
13063,Clayton County,2021-05-20,505,86915,30.7
13063,Clayton County,2021-05-21,490,87405,30.8
13063,Clayton County,2021-05-22,489,87894,31
13063,Clayton County,2021-05-23,240,88134,31.1
13063,Clayton County,2021-05-24,474,88608,31.3
13063,Clayton County,2021-05-25,453,89061,31.4
13063,Clayton County,2021-05-26,451,89512,31.6
13063,Clayton County,2021-05-27,376,89888,31.7
13063,Clayton County,2021-05-28,385,90273,31.8
13063,Clayton County,2021-05-29,252,90525,31.9
13063,Clayton County,2021-05-30,268,90793,32
13063,Clayton County,2021-05-31,67,90860,32
13063,Clayton County,2021-06-01,452,91312,32.2
13063,Clayton County,2021-06-02,364,91676,32.3
13063,Clayton County,2021-06-03,333,92009,32.5
13063,Clayton County,2021-06-04,384,92393,32.6
13063,Clayton County,2021-06-05,277,92670,32.7
13063,Clayton County,2021-06-06,255,92925,32.8
13063,Clayton County,2021-06-07,364,93289,32.9
13063,Clayton County,2021-06-08,342,93631,33
13063,Clayton County,2021-06-09,318,93949,33.1
13063,Clayton County,2021-06-10,320,94269,33.2
13063,Clayton County,2021-06-11,310,94579,33.4
13063,Clayton County,2021-06-12,240,94819,33.4
13063,Clayton County,2021-06-13,85,94904,33.5
13063,Clayton County,2021-06-14,289,95193,33.6
13063,Clayton County,2021-06-15,263,95456,33.7
13063,Clayton County,2021-06-16,267,95723,33.8
13063,Clayton County,2021-06-17,262,95985,33.9
13063,Clayton County,2021-06-18,307,96292,34
13063,Clayton County,2021-06-19,193,96485,34
13063,Clayton County,2021-06-20,120,96605,34.1
13063,Clayton County,2021-06-21,276,96881,34.2
13063,Clayton County,2021-06-22,287,97168,34.3
13063,Clayton County,2021-06-23,261,97429,34.4
13063,Clayton County,2021-06-24,259,97688,34.5
13063,Clayton County,2021-06-25,285,97973,34.6
13063,Clayton County,2021-06-26,185,98158,34.6
13063,Clayton County,2021-06-27,138,98296,34.7
13063,Clayton County,2021-06-28,224,98520,34.7
13063,Clayton County,2021-06-29,216,98736,34.8
13063,Clayton County,2021-06-30,213,98949,34.9
13063,Clayton County,2021-07-01,218,99167,35
13063,Clayton County,2021-07-02,236,99403,35.1
13063,Clayton County,2021-07-03,170,99573,35.1
13063,Clayton County,2021-07-04,17,99590,35.1
13063,Clayton County,2021-07-05,200,99790,35.2
13063,Clayton County,2021-07-06,228,100018,35.3
13063,Clayton County,2021-07-07,222,100240,35.4
13063,Clayton County,2021-07-08,240,100480,35.4
13063,Clayton County,2021-07-09,269,100749,35.5
13063,Clayton County,2021-07-10,228,100977,35.6
13063,Clayton County,2021-07-11,200,101177,35.7
13063,Clayton County,2021-07-12,217,101394,35.8
13063,Clayton County,2021-07-13,259,101653,35.9
13063,Clayton County,2021-07-14,262,101915,35.9
13063,Clayton County,2021-07-15,245,102160,36
13063,Clayton County,2021-07-16,286,102446,36.1
13063,Clayton County,2021-07-17,215,102661,36.2
13063,Clayton County,2021-07-18,140,102801,36.3
13063,Clayton County,2021-07-19,333,103134,36.4
13063,Clayton County,2021-07-20,334,103468,36.5
13063,Clayton County,2021-07-21,357,103825,36.6
13063,Clayton County,2021-07-22,380,104205,36.8
13063,Clayton County,2021-07-23,400,104605,36.9
13063,Clayton County,2021-07-24,296,104901,37
13063,Clayton County,2021-07-25,272,105173,37.1
13063,Clayton County,2021-07-26,427,105600,37.2
13063,Clayton County,2021-07-27,452,106052,37.4
13063,Clayton County,2021-07-28,512,106564,37.6
13063,Clayton County,2021-07-29,478,107042,37.8
13063,Clayton County,2021-07-30,507,107549,37.9
13063,Clayton County,2021-07-31,437,107986,38.1
13063,Clayton County,2021-08-01,311,108297,38.2
13063,Clayton County,2021-08-02,430,108727,38.3
13063,Clayton County,2021-08-03,452,109179,38.5
13063,Clayton County,2021-08-04,500,109679,38.7
13063,Clayton County,2021-08-05,471,110150,38.8
13063,Clayton County,2021-08-06,559,110709,39
13063,Clayton County,2021-08-07,457,111166,39.2
13063,Clayton County,2021-08-08,272,111438,39.3
13063,Clayton County,2021-08-09,494,111932,39.5
13063,Clayton County,2021-08-10,571,112503,39.7
13063,Clayton County,2021-08-11,479,112982,39.8
13063,Clayton County,2021-08-12,490,113472,40
13063,Clayton County,2021-08-13,519,113991,40.2
13063,Clayton County,2021-08-14,436,114427,40.4
13063,Clayton County,2021-08-15,241,114668,40.4
13063,Clayton County,2021-08-16,431,115099,40.6
13063,Clayton County,2021-08-17,446,115545,40.8
13063,Clayton County,2021-08-18,433,115978,40.9
13063,Clayton County,2021-08-19,393,116371,41
13063,Clayton County,2021-08-20,431,116802,41.2
13063,Clayton County,2021-08-21,443,117245,41.4
13063,Clayton County,2021-08-22,189,117434,41.4
13063,Clayton County,2021-08-23,408,117842,41.6
13063,Clayton County,2021-08-24,386,118228,41.7
13063,Clayton County,2021-08-25,419,118647,41.8
13063,Clayton County,2021-08-26,466,119113,42
13063,Clayton County,2021-08-27,477,119590,42.2
13063,Clayton County,2021-08-28,571,120161,42.4
13063,Clayton County,2021-08-29,253,120414,42.5
13063,Clayton County,2021-08-30,413,120827,42.6
13063,Clayton County,2021-08-31,384,121211,42.7
13063,Clayton County,2021-09-01,439,121650,42.9
13063,Clayton County,2021-09-02,355,122005,43
13063,Clayton County,2021-09-03,644,122649,43.3
13063,Clayton County,2021-09-04,268,122917,43.4
13063,Clayton County,2021-09-05,214,123131,43.4
13063,Clayton County,2021-09-06,95,123226,43.5
13063,Clayton County,2021-09-07,378,123604,43.6
13063,Clayton County,2021-09-08,413,124017,43.7
13063,Clayton County,2021-09-09,414,124431,43.9
13063,Clayton County,2021-09-10,436,124867,44
13063,Clayton County,2021-09-11,304,125171,44.1
13063,Clayton County,2021-09-12,185,125356,44.2
13063,Clayton County,2021-09-13,407,125763,44.4
13063,Clayton County,2021-09-14,356,126119,44.5
13063,Clayton County,2021-09-15,365,126484,44.6
13063,Clayton County,2021-09-16,317,126801,44.7
13063,Clayton County,2021-09-17,368,127169,44.9
13063,Clayton County,2021-09-18,275,127444,44.9
13063,Clayton County,2021-09-19,149,127593,45
13063,Clayton County,2021-09-20,305,127898,45.1
13063,Clayton County,2021-09-21,253,128151,45.2
13063,Clayton County,2021-09-22,234,128385,45.3
13063,Clayton County,2021-09-23,240,128625,45.4
13063,Clayton County,2021-09-24,184,128809,45.4
13063,Clayton County,2021-09-25,164,128973,45.5
13063,Clayton County,2021-09-26,91,129064,45.5
13063,Clayton County,2021-09-27,142,129206,45.6
13063,Clayton County,2021-09-28,149,129355,45.6
13063,Clayton County,2021-09-29,144,129499,45.7
13063,Clayton County,2021-09-30,164,129663,45.7
13063,Clayton County,2021-10-01,144,129807,45.8
13063,Clayton County,2021-10-02,104,129911,45.8
13063,Clayton County,2021-10-03,46,129957,45.8
13063,Clayton County,2021-10-04,100,130057,45.9
13063,Clayton County,2021-10-05,77,130134,45.9
13063,Clayton County,2021-10-06,118,130252,45.9
13063,Clayton County,2021-10-07,64,130316,46
13063,Clayton County,2021-10-08,1,130317,46
13065,Clinch County,2020-12-22,5,5,0.1
13065,Clinch County,2020-12-23,5,10,0.1
13065,Clinch County,2020-12-24,3,13,0.2
13065,Clinch County,2020-12-26,1,14,0.2
13065,Clinch County,2020-12-28,6,20,0.3
13065,Clinch County,2020-12-29,4,24,0.4
13065,Clinch County,2020-12-30,16,40,0.6
13065,Clinch County,2020-12-31,15,55,0.8
13065,Clinch County,2021-01-04,4,59,0.9
13065,Clinch County,2021-01-05,6,65,1
13065,Clinch County,2021-01-06,4,69,1
13065,Clinch County,2021-01-07,15,84,1.3
13065,Clinch County,2021-01-08,5,89,1.3
13065,Clinch County,2021-01-09,1,90,1.3
13065,Clinch County,2021-01-10,1,91,1.4
13065,Clinch County,2021-01-11,18,109,1.6
13065,Clinch County,2021-01-12,102,211,3.2
13065,Clinch County,2021-01-13,67,278,4.2
13065,Clinch County,2021-01-14,52,330,4.9
13065,Clinch County,2021-01-15,8,338,5.1
13065,Clinch County,2021-01-16,2,340,5.1
13065,Clinch County,2021-01-18,2,342,5.1
13065,Clinch County,2021-01-19,49,391,5.8
13065,Clinch County,2021-01-20,98,489,7.3
13065,Clinch County,2021-01-21,8,497,7.4
13065,Clinch County,2021-01-22,10,507,7.6
13065,Clinch County,2021-01-23,1,508,7.6
13065,Clinch County,2021-01-25,7,515,7.7
13065,Clinch County,2021-01-26,4,519,7.8
13065,Clinch County,2021-01-27,25,544,8.1
13065,Clinch County,2021-01-28,3,547,8.2
13065,Clinch County,2021-01-29,17,564,8.4
13065,Clinch County,2021-01-30,1,565,8.5
13065,Clinch County,2021-02-01,7,572,8.6
13065,Clinch County,2021-02-02,21,593,8.9
13065,Clinch County,2021-02-03,11,604,9
13065,Clinch County,2021-02-04,6,610,9.1
13065,Clinch County,2021-02-05,13,623,9.3
13065,Clinch County,2021-02-08,3,626,9.4
13065,Clinch County,2021-02-09,1,627,9.4
13065,Clinch County,2021-02-10,10,637,9.5
13065,Clinch County,2021-02-11,5,642,9.6
13065,Clinch County,2021-02-12,4,646,9.7
13065,Clinch County,2021-02-13,1,647,9.7
13065,Clinch County,2021-02-15,3,650,9.7
13065,Clinch County,2021-02-16,8,658,9.8
13065,Clinch County,2021-02-17,16,674,10.1
13065,Clinch County,2021-02-18,3,677,10.1
13065,Clinch County,2021-02-19,4,681,10.2
13065,Clinch County,2021-02-22,6,687,10.3
13065,Clinch County,2021-02-23,2,689,10.3
13065,Clinch County,2021-02-24,13,702,10.5
13065,Clinch County,2021-02-25,3,705,10.5
13065,Clinch County,2021-02-26,84,789,11.8
13065,Clinch County,2021-02-28,1,790,11.8
13065,Clinch County,2021-03-01,1,791,11.8
13065,Clinch County,2021-03-03,18,809,12.1
13065,Clinch County,2021-03-04,3,812,12.1
13065,Clinch County,2021-03-05,33,845,12.6
13065,Clinch County,2021-03-06,2,847,12.7
13065,Clinch County,2021-03-07,1,848,12.7
13065,Clinch County,2021-03-08,5,853,12.8
13065,Clinch County,2021-03-09,5,858,12.8
13065,Clinch County,2021-03-10,26,884,13.2
13065,Clinch County,2021-03-11,75,959,14.3
13065,Clinch County,2021-03-12,5,964,14.4
13065,Clinch County,2021-03-15,3,967,14.5
13065,Clinch County,2021-03-16,9,976,14.6
13065,Clinch County,2021-03-17,25,1001,15
13065,Clinch County,2021-03-18,25,1026,15.3
13065,Clinch County,2021-03-19,100,1126,16.8
13065,Clinch County,2021-03-20,5,1131,16.9
13065,Clinch County,2021-03-22,2,1133,16.9
13065,Clinch County,2021-03-23,10,1143,17.1
13065,Clinch County,2021-03-24,45,1188,17.8
13065,Clinch County,2021-03-25,12,1200,17.9
13065,Clinch County,2021-03-26,57,1257,18.8
13065,Clinch County,2021-03-27,7,1264,18.9
13065,Clinch County,2021-03-28,9,1273,19
13065,Clinch County,2021-03-29,3,1276,19.1
13065,Clinch County,2021-03-30,8,1284,19.2
13065,Clinch County,2021-03-31,68,1352,20.2
13065,Clinch County,2021-04-01,12,1364,20.4
13065,Clinch County,2021-04-02,50,1414,21.1
13065,Clinch County,2021-04-03,4,1418,21.2
13065,Clinch County,2021-04-05,9,1427,21.3
13065,Clinch County,2021-04-06,6,1433,21.4
13065,Clinch County,2021-04-07,26,1459,21.8
13065,Clinch County,2021-04-08,6,1465,21.9
13065,Clinch County,2021-04-09,18,1483,22.2
13065,Clinch County,2021-04-10,5,1488,22.3
13065,Clinch County,2021-04-11,1,1489,22.3
13065,Clinch County,2021-04-12,6,1495,22.4
13065,Clinch County,2021-04-13,5,1500,22.4
13065,Clinch County,2021-04-14,25,1525,22.8
13065,Clinch County,2021-04-15,17,1542,23.1
13065,Clinch County,2021-04-16,18,1560,23.3
13065,Clinch County,2021-04-17,4,1564,23.4
13065,Clinch County,2021-04-19,1,1565,23.4
13065,Clinch County,2021-04-20,5,1570,23.5
13065,Clinch County,2021-04-21,14,1584,23.7
13065,Clinch County,2021-04-22,9,1593,23.8
13065,Clinch County,2021-04-23,46,1639,24.5
13065,Clinch County,2021-04-24,1,1640,24.5
13065,Clinch County,2021-04-26,1,1641,24.5
13065,Clinch County,2021-04-27,6,1647,24.6
13065,Clinch County,2021-04-28,8,1655,24.8
13065,Clinch County,2021-04-29,5,1660,24.8
13065,Clinch County,2021-04-30,13,1673,25
13065,Clinch County,2021-05-01,1,1674,25
13065,Clinch County,2021-05-02,1,1675,25.1
13065,Clinch County,2021-05-03,4,1679,25.1
13065,Clinch County,2021-05-04,2,1681,25.1
13065,Clinch County,2021-05-05,11,1692,25.3
13065,Clinch County,2021-05-06,11,1703,25.5
13065,Clinch County,2021-05-07,70,1773,26.5
13065,Clinch County,2021-05-08,1,1774,26.5
13065,Clinch County,2021-05-10,1,1775,26.5
13065,Clinch County,2021-05-11,2,1777,26.6
13065,Clinch County,2021-05-12,4,1781,26.6
13065,Clinch County,2021-05-13,4,1785,26.7
13065,Clinch County,2021-05-14,4,1789,26.8
13065,Clinch County,2021-05-15,3,1792,26.8
13065,Clinch County,2021-05-16,1,1793,26.8
13065,Clinch County,2021-05-17,7,1800,26.9
13065,Clinch County,2021-05-18,3,1803,27
13065,Clinch County,2021-05-19,11,1814,27.1
13065,Clinch County,2021-05-20,3,1817,27.2
13065,Clinch County,2021-05-21,7,1824,27.3
13065,Clinch County,2021-05-22,3,1827,27.3
13065,Clinch County,2021-05-24,6,1833,27.4
13065,Clinch County,2021-05-25,6,1839,27.5
13065,Clinch County,2021-05-26,8,1847,27.6
13065,Clinch County,2021-05-27,4,1851,27.7
13065,Clinch County,2021-05-28,2,1853,27.7
13065,Clinch County,2021-05-29,4,1857,27.8
13065,Clinch County,2021-05-30,1,1858,27.8
13065,Clinch County,2021-06-01,3,1861,27.8
13065,Clinch County,2021-06-02,7,1868,27.9
13065,Clinch County,2021-06-03,3,1871,28
13065,Clinch County,2021-06-04,4,1875,28
13065,Clinch County,2021-06-05,2,1877,28.1
13065,Clinch County,2021-06-07,5,1882,28.1
13065,Clinch County,2021-06-08,2,1884,28.2
13065,Clinch County,2021-06-09,3,1887,28.2
13065,Clinch County,2021-06-10,4,1891,28.3
13065,Clinch County,2021-06-11,9,1900,28.4
13065,Clinch County,2021-06-12,3,1903,28.5
13065,Clinch County,2021-06-14,4,1907,28.5
13065,Clinch County,2021-06-16,8,1915,28.6
13065,Clinch County,2021-06-17,2,1917,28.7
13065,Clinch County,2021-06-18,2,1919,28.7
13065,Clinch County,2021-06-19,5,1924,28.8
13065,Clinch County,2021-06-21,5,1929,28.9
13065,Clinch County,2021-06-22,5,1934,28.9
13065,Clinch County,2021-06-23,8,1942,29
13065,Clinch County,2021-06-24,8,1950,29.2
13065,Clinch County,2021-06-25,13,1963,29.4
13065,Clinch County,2021-06-26,1,1964,29.4
13065,Clinch County,2021-06-27,1,1965,29.4
13065,Clinch County,2021-06-28,3,1968,29.4
13065,Clinch County,2021-06-29,1,1969,29.4
13065,Clinch County,2021-06-30,4,1973,29.5
13065,Clinch County,2021-07-01,5,1978,29.6
13065,Clinch County,2021-07-02,2,1980,29.6
13065,Clinch County,2021-07-06,1,1981,29.6
13065,Clinch County,2021-07-07,2,1983,29.7
13065,Clinch County,2021-07-08,2,1985,29.7
13065,Clinch County,2021-07-09,3,1988,29.7
13065,Clinch County,2021-07-10,3,1991,29.8
13065,Clinch County,2021-07-12,2,1993,29.8
13065,Clinch County,2021-07-13,2,1995,29.8
13065,Clinch County,2021-07-14,5,2000,29.9
13065,Clinch County,2021-07-16,7,2007,30
13065,Clinch County,2021-07-19,6,2013,30.1
13065,Clinch County,2021-07-20,3,2016,30.2
13065,Clinch County,2021-07-21,11,2027,30.3
13065,Clinch County,2021-07-22,9,2036,30.5
13065,Clinch County,2021-07-23,8,2044,30.6
13065,Clinch County,2021-07-24,6,2050,30.7
13065,Clinch County,2021-07-25,4,2054,30.7
13065,Clinch County,2021-07-26,15,2069,30.9
13065,Clinch County,2021-07-27,23,2092,31.3
13065,Clinch County,2021-07-28,38,2130,31.9
13065,Clinch County,2021-07-29,28,2158,32.3
13065,Clinch County,2021-07-30,39,2197,32.9
13065,Clinch County,2021-07-31,7,2204,33
13065,Clinch County,2021-08-01,2,2206,33
13065,Clinch County,2021-08-02,25,2231,33.4
13065,Clinch County,2021-08-03,23,2254,33.7
13065,Clinch County,2021-08-04,22,2276,34
13065,Clinch County,2021-08-05,32,2308,34.5
13065,Clinch County,2021-08-06,43,2351,35.2
13065,Clinch County,2021-08-07,11,2362,35.3
13065,Clinch County,2021-08-08,1,2363,35.3
13065,Clinch County,2021-08-09,40,2403,35.9
13065,Clinch County,2021-08-10,18,2421,36.2
13065,Clinch County,2021-08-11,40,2461,36.8
13065,Clinch County,2021-08-12,31,2492,37.3
13065,Clinch County,2021-08-13,39,2531,37.9
13065,Clinch County,2021-08-14,5,2536,37.9
13065,Clinch County,2021-08-15,3,2539,38
13065,Clinch County,2021-08-16,21,2560,38.3
13065,Clinch County,2021-08-17,14,2574,38.5
13065,Clinch County,2021-08-18,22,2596,38.8
13065,Clinch County,2021-08-19,22,2618,39.2
13065,Clinch County,2021-08-20,15,2633,39.4
13065,Clinch County,2021-08-21,2,2635,39.4
13065,Clinch County,2021-08-22,3,2638,39.5
13065,Clinch County,2021-08-23,16,2654,39.7
13065,Clinch County,2021-08-24,12,2666,39.9
13065,Clinch County,2021-08-25,32,2698,40.4
13065,Clinch County,2021-08-26,15,2713,40.6
13065,Clinch County,2021-08-27,14,2727,40.8
13065,Clinch County,2021-08-28,5,2732,40.9
13065,Clinch County,2021-08-29,3,2735,40.9
13065,Clinch County,2021-08-30,10,2745,41.1
13065,Clinch County,2021-08-31,4,2749,41.1
13065,Clinch County,2021-09-01,5,2754,41.2
13065,Clinch County,2021-09-02,7,2761,41.3
13065,Clinch County,2021-09-03,13,2774,41.5
13065,Clinch County,2021-09-04,4,2778,41.5
13065,Clinch County,2021-09-05,1,2779,41.6
13065,Clinch County,2021-09-07,7,2786,41.7
13065,Clinch County,2021-09-08,4,2790,41.7
13065,Clinch County,2021-09-09,6,2796,41.8
13065,Clinch County,2021-09-10,7,2803,41.9
13065,Clinch County,2021-09-11,2,2805,42
13065,Clinch County,2021-09-13,3,2808,42
13065,Clinch County,2021-09-14,4,2812,42.1
13065,Clinch County,2021-09-15,1,2813,42.1
13065,Clinch County,2021-09-16,5,2818,42.1
13065,Clinch County,2021-09-17,10,2828,42.3
13065,Clinch County,2021-09-20,4,2832,42.4
13065,Clinch County,2021-09-21,1,2833,42.4
13065,Clinch County,2021-09-22,4,2837,42.4
13065,Clinch County,2021-09-23,7,2844,42.5
13065,Clinch County,2021-09-24,3,2847,42.6
13065,Clinch County,2021-09-25,2,2849,42.6
13065,Clinch County,2021-09-27,1,2850,42.6
13065,Clinch County,2021-09-28,4,2854,42.7
13065,Clinch County,2021-09-29,1,2855,42.7
13065,Clinch County,2021-09-30,1,2856,42.7
13065,Clinch County,2021-10-03,1,2857,42.7
13065,Clinch County,2021-10-04,1,2858,42.7
13065,Clinch County,2021-10-05,1,2859,42.8
13065,Clinch County,2021-10-07,4,2863,42.8
13067,Cobb County,2020-12-15,1,1,0
13067,Cobb County,2020-12-16,6,7,0
13067,Cobb County,2020-12-17,119,126,0
13067,Cobb County,2020-12-18,402,528,0.1
13067,Cobb County,2020-12-19,253,781,0.1
13067,Cobb County,2020-12-20,263,1044,0.1
13067,Cobb County,2020-12-21,586,1630,0.2
13067,Cobb County,2020-12-22,925,2555,0.3
13067,Cobb County,2020-12-23,1009,3564,0.5
13067,Cobb County,2020-12-24,382,3946,0.5
13067,Cobb County,2020-12-25,12,3958,0.5
13067,Cobb County,2020-12-26,158,4116,0.5
13067,Cobb County,2020-12-27,170,4286,0.6
13067,Cobb County,2020-12-28,1404,5690,0.8
13067,Cobb County,2020-12-29,1169,6859,0.9
13067,Cobb County,2020-12-30,1427,8286,1.1
13067,Cobb County,2020-12-31,556,8842,1.2
13067,Cobb County,2021-01-01,198,9040,1.2
13067,Cobb County,2021-01-02,162,9202,1.2
13067,Cobb County,2021-01-03,195,9397,1.3
13067,Cobb County,2021-01-04,1172,10569,1.4
13067,Cobb County,2021-01-05,1332,11901,1.6
13067,Cobb County,2021-01-06,972,12873,1.7
13067,Cobb County,2021-01-07,1046,13919,1.9
13067,Cobb County,2021-01-08,1228,15147,2
13067,Cobb County,2021-01-09,488,15635,2.1
13067,Cobb County,2021-01-10,152,15787,2.1
13067,Cobb County,2021-01-11,2109,17896,2.4
13067,Cobb County,2021-01-12,2574,20470,2.7
13067,Cobb County,2021-01-13,3003,23473,3.1
13067,Cobb County,2021-01-14,3196,26669,3.6
13067,Cobb County,2021-01-15,3110,29779,4
13067,Cobb County,2021-01-16,2063,31842,4.2
13067,Cobb County,2021-01-17,598,32440,4.3
13067,Cobb County,2021-01-18,2499,34939,4.7
13067,Cobb County,2021-01-19,3259,38198,5.1
13067,Cobb County,2021-01-20,3500,41698,5.6
13067,Cobb County,2021-01-21,3529,45227,6
13067,Cobb County,2021-01-22,2791,48018,6.4
13067,Cobb County,2021-01-23,837,48855,6.5
13067,Cobb County,2021-01-24,349,49204,6.5
13067,Cobb County,2021-01-25,2727,51931,6.9
13067,Cobb County,2021-01-26,2664,54595,7.3
13067,Cobb County,2021-01-27,2644,57239,7.6
13067,Cobb County,2021-01-28,3068,60307,8
13067,Cobb County,2021-01-29,2917,63224,8.4
13067,Cobb County,2021-01-30,709,63933,8.5
13067,Cobb County,2021-01-31,146,64079,8.5
13067,Cobb County,2021-02-01,2147,66226,8.8
13067,Cobb County,2021-02-02,1931,68157,9.1
13067,Cobb County,2021-02-03,1939,70096,9.3
13067,Cobb County,2021-02-04,1752,71848,9.6
13067,Cobb County,2021-02-05,1458,73306,9.8
13067,Cobb County,2021-02-06,362,73668,9.8
13067,Cobb County,2021-02-07,175,73843,9.8
13067,Cobb County,2021-02-08,979,74822,10
13067,Cobb County,2021-02-09,1224,76046,10.1
13067,Cobb County,2021-02-10,924,76970,10.2
13067,Cobb County,2021-02-11,1335,78305,10.4
13067,Cobb County,2021-02-12,855,79160,10.5
13067,Cobb County,2021-02-13,538,79698,10.6
13067,Cobb County,2021-02-14,276,79974,10.6
13067,Cobb County,2021-02-15,1165,81139,10.8
13067,Cobb County,2021-02-16,1090,82229,10.9
13067,Cobb County,2021-02-17,1188,83417,11.1
13067,Cobb County,2021-02-18,1126,84543,11.3
13067,Cobb County,2021-02-19,1057,85600,11.4
13067,Cobb County,2021-02-20,333,85933,11.4
13067,Cobb County,2021-02-21,187,86120,11.5
13067,Cobb County,2021-02-22,753,86873,11.6
13067,Cobb County,2021-02-23,1492,88365,11.8
13067,Cobb County,2021-02-24,1651,90016,12
13067,Cobb County,2021-02-25,2131,92147,12.3
13067,Cobb County,2021-02-26,1565,93712,12.5
13067,Cobb County,2021-02-27,899,94611,12.6
13067,Cobb County,2021-02-28,751,95362,12.7
13067,Cobb County,2021-03-01,1801,97163,12.9
13067,Cobb County,2021-03-02,2165,99328,13.2
13067,Cobb County,2021-03-03,2453,101781,13.5
13067,Cobb County,2021-03-04,2398,104179,13.9
13067,Cobb County,2021-03-05,2398,106577,14.2
13067,Cobb County,2021-03-06,897,107474,14.3
13067,Cobb County,2021-03-07,841,108315,14.4
13067,Cobb County,2021-03-08,3765,112080,14.9
13067,Cobb County,2021-03-09,4011,116091,15.5
13067,Cobb County,2021-03-10,4069,120160,16
13067,Cobb County,2021-03-11,4519,124679,16.6
13067,Cobb County,2021-03-12,4053,128732,17.1
13067,Cobb County,2021-03-13,1368,130100,17.3
13067,Cobb County,2021-03-14,1165,131265,17.5
13067,Cobb County,2021-03-15,4108,135373,18
13067,Cobb County,2021-03-16,5336,140709,18.7
13067,Cobb County,2021-03-17,5804,146513,19.5
13067,Cobb County,2021-03-18,6158,152671,20.3
13067,Cobb County,2021-03-19,7514,160185,21.3
13067,Cobb County,2021-03-20,2285,162470,21.6
13067,Cobb County,2021-03-21,1490,163960,21.8
13067,Cobb County,2021-03-22,5657,169617,22.6
13067,Cobb County,2021-03-23,5677,175294,23.3
13067,Cobb County,2021-03-24,6801,182095,24.2
13067,Cobb County,2021-03-25,7231,189326,25.2
13067,Cobb County,2021-03-26,7220,196546,26.2
13067,Cobb County,2021-03-27,3007,199553,26.6
13067,Cobb County,2021-03-28,1966,201519,26.8
13067,Cobb County,2021-03-29,6047,207566,27.6
13067,Cobb County,2021-03-30,7839,215405,28.7
13067,Cobb County,2021-03-31,8049,223454,29.7
13067,Cobb County,2021-04-01,7786,231240,30.8
13067,Cobb County,2021-04-02,5388,236628,31.5
13067,Cobb County,2021-04-03,2428,239056,31.8
13067,Cobb County,2021-04-04,1255,240311,32
13067,Cobb County,2021-04-05,5013,245324,32.7
13067,Cobb County,2021-04-06,6514,251838,33.5
13067,Cobb County,2021-04-07,6064,257902,34.3
13067,Cobb County,2021-04-08,5886,263788,35.1
13067,Cobb County,2021-04-09,5966,269754,35.9
13067,Cobb County,2021-04-10,3953,273707,36.4
13067,Cobb County,2021-04-11,1462,275169,36.6
13067,Cobb County,2021-04-12,3895,279064,37.1
13067,Cobb County,2021-04-13,4118,283182,37.7
13067,Cobb County,2021-04-14,3437,286619,38.2
13067,Cobb County,2021-04-15,3563,290182,38.6
13067,Cobb County,2021-04-16,3686,293868,39.1
13067,Cobb County,2021-04-17,1102,294970,39.3
13067,Cobb County,2021-04-18,1069,296039,39.4
13067,Cobb County,2021-04-19,2598,298637,39.8
13067,Cobb County,2021-04-20,2957,301594,40.1
13067,Cobb County,2021-04-21,2832,304426,40.5
13067,Cobb County,2021-04-22,2566,306992,40.9
13067,Cobb County,2021-04-23,2424,309416,41.2
13067,Cobb County,2021-04-24,1248,310664,41.4
13067,Cobb County,2021-04-25,705,311369,41.4
13067,Cobb County,2021-04-26,2036,313405,41.7
13067,Cobb County,2021-04-27,2279,315684,42
13067,Cobb County,2021-04-28,2294,317978,42.3
13067,Cobb County,2021-04-29,1967,319945,42.6
13067,Cobb County,2021-04-30,2375,322320,42.9
13067,Cobb County,2021-05-01,1589,323909,43.1
13067,Cobb County,2021-05-02,700,324609,43.2
13067,Cobb County,2021-05-03,1370,325979,43.4
13067,Cobb County,2021-05-04,1757,327736,43.6
13067,Cobb County,2021-05-05,1686,329422,43.9
13067,Cobb County,2021-05-06,1480,330902,44
13067,Cobb County,2021-05-07,1687,332589,44.3
13067,Cobb County,2021-05-08,1092,333681,44.4
13067,Cobb County,2021-05-09,445,334126,44.5
13067,Cobb County,2021-05-10,981,335107,44.6
13067,Cobb County,2021-05-11,1680,336787,44.8
13067,Cobb County,2021-05-12,1932,338719,45.1
13067,Cobb County,2021-05-13,1748,340467,45.3
13067,Cobb County,2021-05-14,2240,342707,45.6
13067,Cobb County,2021-05-15,1964,344671,45.9
13067,Cobb County,2021-05-16,1163,345834,46
13067,Cobb County,2021-05-17,1956,347790,46.3
13067,Cobb County,2021-05-18,2007,349797,46.6
13067,Cobb County,2021-05-19,2328,352125,46.9
13067,Cobb County,2021-05-20,1553,353678,47.1
13067,Cobb County,2021-05-21,1651,355329,47.3
13067,Cobb County,2021-05-22,1389,356718,47.5
13067,Cobb County,2021-05-23,704,357422,47.6
13067,Cobb County,2021-05-24,1133,358555,47.7
13067,Cobb County,2021-05-25,1141,359696,47.9
13067,Cobb County,2021-05-26,1334,361030,48.1
13067,Cobb County,2021-05-27,1162,362192,48.2
13067,Cobb County,2021-05-28,1234,363426,48.4
13067,Cobb County,2021-05-29,683,364109,48.5
13067,Cobb County,2021-05-30,457,364566,48.5
13067,Cobb County,2021-05-31,116,364682,48.5
13067,Cobb County,2021-06-01,995,365677,48.7
13067,Cobb County,2021-06-02,1090,366767,48.8
13067,Cobb County,2021-06-03,1159,367926,49
13067,Cobb County,2021-06-04,1018,368944,49.1
13067,Cobb County,2021-06-05,742,369686,49.2
13067,Cobb County,2021-06-06,431,370117,49.3
13067,Cobb County,2021-06-07,759,370876,49.4
13067,Cobb County,2021-06-08,784,371660,49.5
13067,Cobb County,2021-06-09,689,372349,49.6
13067,Cobb County,2021-06-10,764,373113,49.7
13067,Cobb County,2021-06-11,794,373907,49.8
13067,Cobb County,2021-06-12,541,374448,49.8
13067,Cobb County,2021-06-13,205,374653,49.9
13067,Cobb County,2021-06-14,639,375292,50
13067,Cobb County,2021-06-15,655,375947,50
13067,Cobb County,2021-06-16,617,376564,50.1
13067,Cobb County,2021-06-17,633,377197,50.2
13067,Cobb County,2021-06-18,746,377943,50.3
13067,Cobb County,2021-06-19,545,378488,50.4
13067,Cobb County,2021-06-20,310,378798,50.4
13067,Cobb County,2021-06-21,628,379426,50.5
13067,Cobb County,2021-06-22,562,379988,50.6
13067,Cobb County,2021-06-23,564,380552,50.7
13067,Cobb County,2021-06-24,549,381101,50.7
13067,Cobb County,2021-06-25,657,381758,50.8
13067,Cobb County,2021-06-26,473,382231,50.9
13067,Cobb County,2021-06-27,315,382546,50.9
13067,Cobb County,2021-06-28,570,383116,51
13067,Cobb County,2021-06-29,577,383693,51.1
13067,Cobb County,2021-06-30,554,384247,51.1
13067,Cobb County,2021-07-01,465,384712,51.2
13067,Cobb County,2021-07-02,646,385358,51.3
13067,Cobb County,2021-07-03,410,385768,51.4
13067,Cobb County,2021-07-04,46,385814,51.4
13067,Cobb County,2021-07-05,464,386278,51.4
13067,Cobb County,2021-07-06,495,386773,51.5
13067,Cobb County,2021-07-07,533,387306,51.6
13067,Cobb County,2021-07-08,549,387855,51.6
13067,Cobb County,2021-07-09,633,388488,51.7
13067,Cobb County,2021-07-10,538,389026,51.8
13067,Cobb County,2021-07-11,329,389355,51.8
13067,Cobb County,2021-07-12,529,389884,51.9
13067,Cobb County,2021-07-13,535,390419,52
13067,Cobb County,2021-07-14,528,390947,52
13067,Cobb County,2021-07-15,499,391446,52.1
13067,Cobb County,2021-07-16,647,392093,52.2
13067,Cobb County,2021-07-17,572,392665,52.3
13067,Cobb County,2021-07-18,393,393058,52.3
13067,Cobb County,2021-07-19,718,393776,52.4
13067,Cobb County,2021-07-20,816,394592,52.5
13067,Cobb County,2021-07-21,812,395404,52.6
13067,Cobb County,2021-07-22,937,396341,52.8
13067,Cobb County,2021-07-23,1082,397423,52.9
13067,Cobb County,2021-07-24,859,398282,53
13067,Cobb County,2021-07-25,614,398896,53.1
13067,Cobb County,2021-07-26,980,399876,53.2
13067,Cobb County,2021-07-27,1001,400877,53.4
13067,Cobb County,2021-07-28,1136,402013,53.5
13067,Cobb County,2021-07-29,1135,403148,53.7
13067,Cobb County,2021-07-30,1364,404512,53.8
13067,Cobb County,2021-07-31,951,405463,54
13067,Cobb County,2021-08-01,652,406115,54.1
13067,Cobb County,2021-08-02,1138,407253,54.2
13067,Cobb County,2021-08-03,1172,408425,54.4
13067,Cobb County,2021-08-04,1104,409529,54.5
13067,Cobb County,2021-08-05,1234,410763,54.7
13067,Cobb County,2021-08-06,1326,412089,54.9
13067,Cobb County,2021-08-07,999,413088,55
13067,Cobb County,2021-08-08,664,413752,55.1
13067,Cobb County,2021-08-09,1158,414910,55.2
13067,Cobb County,2021-08-10,1273,416183,55.4
13067,Cobb County,2021-08-11,1069,417252,55.5
13067,Cobb County,2021-08-12,1042,418294,55.7
13067,Cobb County,2021-08-13,1309,419603,55.9
13067,Cobb County,2021-08-14,944,420547,56
13067,Cobb County,2021-08-15,513,421060,56.1
13067,Cobb County,2021-08-16,975,422035,56.2
13067,Cobb County,2021-08-17,1051,423086,56.3
13067,Cobb County,2021-08-18,976,424062,56.4
13067,Cobb County,2021-08-19,936,424998,56.6
13067,Cobb County,2021-08-20,1130,426128,56.7
13067,Cobb County,2021-08-21,800,426928,56.8
13067,Cobb County,2021-08-22,565,427493,56.9
13067,Cobb County,2021-08-23,1032,428525,57
13067,Cobb County,2021-08-24,940,429465,57.2
13067,Cobb County,2021-08-25,972,430437,57.3
13067,Cobb County,2021-08-26,958,431395,57.4
13067,Cobb County,2021-08-27,1071,432466,57.6
13067,Cobb County,2021-08-28,733,433199,57.7
13067,Cobb County,2021-08-29,411,433610,57.7
13067,Cobb County,2021-08-30,892,434502,57.8
13067,Cobb County,2021-08-31,773,435275,57.9
13067,Cobb County,2021-09-01,863,436138,58.1
13067,Cobb County,2021-09-02,831,436969,58.2
13067,Cobb County,2021-09-03,982,437951,58.3
13067,Cobb County,2021-09-04,632,438583,58.4
13067,Cobb County,2021-09-05,456,439039,58.4
13067,Cobb County,2021-09-06,140,439179,58.5
13067,Cobb County,2021-09-07,646,439825,58.5
13067,Cobb County,2021-09-08,795,440620,58.7
13067,Cobb County,2021-09-09,729,441349,58.8
13067,Cobb County,2021-09-10,896,442245,58.9
13067,Cobb County,2021-09-11,613,442858,59
13067,Cobb County,2021-09-12,402,443260,59
13067,Cobb County,2021-09-13,685,443945,59.1
13067,Cobb County,2021-09-14,640,444585,59.2
13067,Cobb County,2021-09-15,535,445120,59.3
13067,Cobb County,2021-09-16,503,445623,59.3
13067,Cobb County,2021-09-17,679,446302,59.4
13067,Cobb County,2021-09-18,441,446743,59.5
13067,Cobb County,2021-09-19,280,447023,59.5
13067,Cobb County,2021-09-20,528,447551,59.6
13067,Cobb County,2021-09-21,458,448009,59.6
13067,Cobb County,2021-09-22,367,448376,59.7
13067,Cobb County,2021-09-23,346,448722,59.7
13067,Cobb County,2021-09-24,369,449091,59.8
13067,Cobb County,2021-09-25,284,449375,59.8
13067,Cobb County,2021-09-26,158,449533,59.8
13067,Cobb County,2021-09-27,272,449805,59.9
13067,Cobb County,2021-09-28,257,450062,59.9
13067,Cobb County,2021-09-29,256,450318,59.9
13067,Cobb County,2021-09-30,259,450577,60
13067,Cobb County,2021-10-01,317,450894,60
13067,Cobb County,2021-10-02,204,451098,60
13067,Cobb County,2021-10-03,111,451209,60.1
13067,Cobb County,2021-10-04,141,451350,60.1
13067,Cobb County,2021-10-05,136,451486,60.1
13067,Cobb County,2021-10-06,175,451661,60.1
13067,Cobb County,2021-10-07,74,451735,60.1
13069,Coffee County,2020-12-18,1,1,0
13069,Coffee County,2020-12-19,2,3,0
13069,Coffee County,2020-12-21,2,5,0
13069,Coffee County,2020-12-22,8,13,0
13069,Coffee County,2020-12-23,66,79,0.2
13069,Coffee County,2020-12-24,40,119,0.3
13069,Coffee County,2020-12-26,1,120,0.3
13069,Coffee County,2020-12-27,2,122,0.3
13069,Coffee County,2020-12-28,48,170,0.4
13069,Coffee County,2020-12-29,18,188,0.4
13069,Coffee County,2020-12-30,89,277,0.6
13069,Coffee County,2020-12-31,25,302,0.7
13069,Coffee County,2021-01-01,40,342,0.8
13069,Coffee County,2021-01-03,2,344,0.8
13069,Coffee County,2021-01-04,63,407,0.9
13069,Coffee County,2021-01-05,48,455,1.1
13069,Coffee County,2021-01-06,75,530,1.2
13069,Coffee County,2021-01-07,113,643,1.5
13069,Coffee County,2021-01-08,173,816,1.9
13069,Coffee County,2021-01-09,20,836,1.9
13069,Coffee County,2021-01-10,93,929,2.2
13069,Coffee County,2021-01-11,191,1120,2.6
13069,Coffee County,2021-01-12,255,1375,3.2
13069,Coffee County,2021-01-13,243,1618,3.8
13069,Coffee County,2021-01-14,290,1908,4.4
13069,Coffee County,2021-01-15,124,2032,4.7
13069,Coffee County,2021-01-16,4,2036,4.7
13069,Coffee County,2021-01-17,6,2042,4.7
13069,Coffee County,2021-01-18,149,2191,5.1
13069,Coffee County,2021-01-19,244,2435,5.7
13069,Coffee County,2021-01-20,173,2608,6.1
13069,Coffee County,2021-01-21,213,2821,6.6
13069,Coffee County,2021-01-22,181,3002,7
13069,Coffee County,2021-01-23,49,3051,7.1
13069,Coffee County,2021-01-24,1,3052,7.1
13069,Coffee County,2021-01-25,154,3206,7.5
13069,Coffee County,2021-01-26,188,3394,7.9
13069,Coffee County,2021-01-27,170,3564,8.3
13069,Coffee County,2021-01-28,190,3754,8.7
13069,Coffee County,2021-01-29,80,3834,8.9
13069,Coffee County,2021-01-30,2,3836,8.9
13069,Coffee County,2021-01-31,4,3840,8.9
13069,Coffee County,2021-02-01,73,3913,9.1
13069,Coffee County,2021-02-02,18,3931,9.1
13069,Coffee County,2021-02-03,31,3962,9.2
13069,Coffee County,2021-02-04,25,3987,9.3
13069,Coffee County,2021-02-05,33,4020,9.3
13069,Coffee County,2021-02-06,1,4021,9.3
13069,Coffee County,2021-02-07,7,4028,9.4
13069,Coffee County,2021-02-08,16,4044,9.4
13069,Coffee County,2021-02-09,55,4099,9.5
13069,Coffee County,2021-02-10,37,4136,9.6
13069,Coffee County,2021-02-11,22,4158,9.7
13069,Coffee County,2021-02-12,60,4218,9.8
13069,Coffee County,2021-02-13,18,4236,9.8
13069,Coffee County,2021-02-14,10,4246,9.9
13069,Coffee County,2021-02-15,63,4309,10
13069,Coffee County,2021-02-16,24,4333,10.1
13069,Coffee County,2021-02-17,70,4403,10.2
13069,Coffee County,2021-02-18,21,4424,10.3
13069,Coffee County,2021-02-19,71,4495,10.4
13069,Coffee County,2021-02-20,35,4530,10.5
13069,Coffee County,2021-02-22,53,4583,10.7
13069,Coffee County,2021-02-23,22,4605,10.7
13069,Coffee County,2021-02-24,103,4708,10.9
13069,Coffee County,2021-02-25,44,4752,11
13069,Coffee County,2021-02-26,51,4803,11.2
13069,Coffee County,2021-02-27,11,4814,11.2
13069,Coffee County,2021-02-28,3,4817,11.2
13069,Coffee County,2021-03-01,82,4899,11.4
13069,Coffee County,2021-03-02,27,4926,11.5
13069,Coffee County,2021-03-03,263,5189,12.1
13069,Coffee County,2021-03-04,12,5201,12.1
13069,Coffee County,2021-03-05,81,5282,12.3
13069,Coffee County,2021-03-06,12,5294,12.3
13069,Coffee County,2021-03-08,80,5374,12.5
13069,Coffee County,2021-03-09,53,5427,12.6
13069,Coffee County,2021-03-10,202,5629,13.1
13069,Coffee County,2021-03-11,106,5735,13.3
13069,Coffee County,2021-03-12,248,5983,13.9
13069,Coffee County,2021-03-13,8,5991,13.9
13069,Coffee County,2021-03-14,12,6003,14
13069,Coffee County,2021-03-15,104,6107,14.2
13069,Coffee County,2021-03-16,165,6272,14.6
13069,Coffee County,2021-03-17,248,6520,15.2
13069,Coffee County,2021-03-18,38,6558,15.2
13069,Coffee County,2021-03-19,141,6699,15.6
13069,Coffee County,2021-03-20,23,6722,15.6
13069,Coffee County,2021-03-21,5,6727,15.6
13069,Coffee County,2021-03-22,86,6813,15.8
13069,Coffee County,2021-03-23,135,6948,16.2
13069,Coffee County,2021-03-24,174,7122,16.6
13069,Coffee County,2021-03-25,95,7217,16.8
13069,Coffee County,2021-03-26,269,7486,17.4
13069,Coffee County,2021-03-27,7,7493,17.4
13069,Coffee County,2021-03-28,5,7498,17.4
13069,Coffee County,2021-03-29,99,7597,17.7
13069,Coffee County,2021-03-30,157,7754,18
13069,Coffee County,2021-03-31,293,8047,18.7
13069,Coffee County,2021-04-01,120,8167,19
13069,Coffee County,2021-04-02,191,8358,19.4
13069,Coffee County,2021-04-03,56,8414,19.6
13069,Coffee County,2021-04-04,7,8421,19.6
13069,Coffee County,2021-04-05,63,8484,19.7
13069,Coffee County,2021-04-06,102,8586,20
13069,Coffee County,2021-04-07,162,8748,20.3
13069,Coffee County,2021-04-08,136,8884,20.7
13069,Coffee County,2021-04-09,115,8999,20.9
13069,Coffee County,2021-04-10,13,9012,20.9
13069,Coffee County,2021-04-11,6,9018,21
13069,Coffee County,2021-04-12,44,9062,21.1
13069,Coffee County,2021-04-13,86,9148,21.3
13069,Coffee County,2021-04-14,68,9216,21.4
13069,Coffee County,2021-04-15,42,9258,21.5
13069,Coffee County,2021-04-16,81,9339,21.7
13069,Coffee County,2021-04-17,32,9371,21.8
13069,Coffee County,2021-04-18,3,9374,21.8
13069,Coffee County,2021-04-19,36,9410,21.9
13069,Coffee County,2021-04-20,56,9466,22
13069,Coffee County,2021-04-21,93,9559,22.2
13069,Coffee County,2021-04-22,34,9593,22.3
13069,Coffee County,2021-04-23,37,9630,22.4
13069,Coffee County,2021-04-24,13,9643,22.4
13069,Coffee County,2021-04-26,15,9658,22.4
13069,Coffee County,2021-04-27,75,9733,22.6
13069,Coffee County,2021-04-28,91,9824,22.8
13069,Coffee County,2021-04-29,66,9890,23
13069,Coffee County,2021-04-30,47,9937,23.1
13069,Coffee County,2021-05-01,14,9951,23.1
13069,Coffee County,2021-05-02,1,9952,23.1
13069,Coffee County,2021-05-03,26,9978,23.2
13069,Coffee County,2021-05-04,51,10029,23.3
13069,Coffee County,2021-05-05,62,10091,23.5
13069,Coffee County,2021-05-06,27,10118,23.5
13069,Coffee County,2021-05-07,62,10180,23.7
13069,Coffee County,2021-05-08,23,10203,23.7
13069,Coffee County,2021-05-09,7,10210,23.7
13069,Coffee County,2021-05-10,12,10222,23.8
13069,Coffee County,2021-05-11,31,10253,23.8
13069,Coffee County,2021-05-12,49,10302,23.9
13069,Coffee County,2021-05-13,54,10356,24.1
13069,Coffee County,2021-05-14,42,10398,24.2
13069,Coffee County,2021-05-15,16,10414,24.2
13069,Coffee County,2021-05-16,7,10421,24.2
13069,Coffee County,2021-05-17,32,10453,24.3
13069,Coffee County,2021-05-18,52,10505,24.4
13069,Coffee County,2021-05-19,70,10575,24.6
13069,Coffee County,2021-05-20,43,10618,24.7
13069,Coffee County,2021-05-21,39,10657,24.8
13069,Coffee County,2021-05-22,25,10682,24.8
13069,Coffee County,2021-05-24,10,10692,24.9
13069,Coffee County,2021-05-25,39,10731,24.9
13069,Coffee County,2021-05-26,61,10792,25.1
13069,Coffee County,2021-05-27,85,10877,25.3
13069,Coffee County,2021-05-28,29,10906,25.4
13069,Coffee County,2021-05-29,24,10930,25.4
13069,Coffee County,2021-05-30,5,10935,25.4
13069,Coffee County,2021-05-31,2,10937,25.4
13069,Coffee County,2021-06-01,26,10963,25.5
13069,Coffee County,2021-06-02,51,11014,25.6
13069,Coffee County,2021-06-03,20,11034,25.6
13069,Coffee County,2021-06-04,31,11065,25.7
13069,Coffee County,2021-06-05,13,11078,25.8
13069,Coffee County,2021-06-06,6,11084,25.8
13069,Coffee County,2021-06-07,11,11095,25.8
13069,Coffee County,2021-06-08,25,11120,25.8
13069,Coffee County,2021-06-09,27,11147,25.9
13069,Coffee County,2021-06-10,37,11184,26
13069,Coffee County,2021-06-11,10,11194,26
13069,Coffee County,2021-06-12,5,11199,26
13069,Coffee County,2021-06-13,2,11201,26
13069,Coffee County,2021-06-14,16,11217,26.1
13069,Coffee County,2021-06-15,145,11362,26.4
13069,Coffee County,2021-06-16,23,11385,26.5
13069,Coffee County,2021-06-17,12,11397,26.5
13069,Coffee County,2021-06-18,26,11423,26.6
13069,Coffee County,2021-06-19,19,11442,26.6
13069,Coffee County,2021-06-20,2,11444,26.6
13069,Coffee County,2021-06-21,10,11454,26.6
13069,Coffee County,2021-06-22,35,11489,26.7
13069,Coffee County,2021-06-23,27,11516,26.8
13069,Coffee County,2021-06-24,19,11535,26.8
13069,Coffee County,2021-06-25,24,11559,26.9
13069,Coffee County,2021-06-26,14,11573,26.9
13069,Coffee County,2021-06-27,3,11576,26.9
13069,Coffee County,2021-06-28,19,11595,27
13069,Coffee County,2021-06-29,55,11650,27.1
13069,Coffee County,2021-06-30,40,11690,27.2
13069,Coffee County,2021-07-01,23,11713,27.2
13069,Coffee County,2021-07-02,16,11729,27.3
13069,Coffee County,2021-07-03,18,11747,27.3
13069,Coffee County,2021-07-04,2,11749,27.3
13069,Coffee County,2021-07-05,18,11767,27.4
13069,Coffee County,2021-07-06,39,11806,27.4
13069,Coffee County,2021-07-07,27,11833,27.5
13069,Coffee County,2021-07-08,21,11854,27.6
13069,Coffee County,2021-07-09,38,11892,27.6
13069,Coffee County,2021-07-10,8,11900,27.7
13069,Coffee County,2021-07-11,2,11902,27.7
13069,Coffee County,2021-07-12,10,11912,27.7
13069,Coffee County,2021-07-13,54,11966,27.8
13069,Coffee County,2021-07-14,54,12020,27.9
13069,Coffee County,2021-07-15,36,12056,28
13069,Coffee County,2021-07-16,50,12106,28.1
13069,Coffee County,2021-07-17,19,12125,28.2
13069,Coffee County,2021-07-18,6,12131,28.2
13069,Coffee County,2021-07-19,60,12191,28.3
13069,Coffee County,2021-07-20,87,12278,28.5
13069,Coffee County,2021-07-21,56,12334,28.7
13069,Coffee County,2021-07-22,41,12375,28.8
13069,Coffee County,2021-07-23,67,12442,28.9
13069,Coffee County,2021-07-24,30,12472,29
13069,Coffee County,2021-07-25,13,12485,29
13069,Coffee County,2021-07-26,76,12561,29.2
13069,Coffee County,2021-07-27,114,12675,29.5
13069,Coffee County,2021-07-28,115,12790,29.7
13069,Coffee County,2021-07-29,92,12882,29.9
13069,Coffee County,2021-07-30,188,13070,30.4
13069,Coffee County,2021-07-31,28,13098,30.4
13069,Coffee County,2021-08-01,93,13191,30.7
13069,Coffee County,2021-08-02,98,13289,30.9
13069,Coffee County,2021-08-03,190,13479,31.3
13069,Coffee County,2021-08-04,145,13624,31.7
13069,Coffee County,2021-08-05,117,13741,31.9
13069,Coffee County,2021-08-06,160,13901,32.3
13069,Coffee County,2021-08-07,67,13968,32.5
13069,Coffee County,2021-08-08,19,13987,32.5
13069,Coffee County,2021-08-09,106,14093,32.8
13069,Coffee County,2021-08-10,172,14265,33.2
13069,Coffee County,2021-08-11,175,14440,33.6
13069,Coffee County,2021-08-12,111,14551,33.8
13069,Coffee County,2021-08-13,253,14804,34.4
13069,Coffee County,2021-08-14,69,14873,34.6
13069,Coffee County,2021-08-15,14,14887,34.6
13069,Coffee County,2021-08-16,132,15019,34.9
13069,Coffee County,2021-08-17,169,15188,35.3
13069,Coffee County,2021-08-18,153,15341,35.7
13069,Coffee County,2021-08-19,75,15416,35.8
13069,Coffee County,2021-08-20,141,15557,36.2
13069,Coffee County,2021-08-21,47,15604,36.3
13069,Coffee County,2021-08-22,23,15627,36.3
13069,Coffee County,2021-08-23,85,15712,36.5
13069,Coffee County,2021-08-24,106,15818,36.8
13069,Coffee County,2021-08-25,93,15911,37
13069,Coffee County,2021-08-26,66,15977,37.1
13069,Coffee County,2021-08-27,82,16059,37.3
13069,Coffee County,2021-08-28,33,16092,37.4
13069,Coffee County,2021-08-29,42,16134,37.5
13069,Coffee County,2021-08-30,48,16182,37.6
13069,Coffee County,2021-08-31,77,16259,37.8
13069,Coffee County,2021-09-01,41,16300,37.9
13069,Coffee County,2021-09-02,67,16367,38
13069,Coffee County,2021-09-03,56,16423,38.2
13069,Coffee County,2021-09-04,21,16444,38.2
13069,Coffee County,2021-09-05,12,16456,38.3
13069,Coffee County,2021-09-06,19,16475,38.3
13069,Coffee County,2021-09-07,35,16510,38.4
13069,Coffee County,2021-09-08,38,16548,38.5
13069,Coffee County,2021-09-09,41,16589,38.6
13069,Coffee County,2021-09-10,63,16652,38.7
13069,Coffee County,2021-09-11,23,16675,38.8
13069,Coffee County,2021-09-12,9,16684,38.8
13069,Coffee County,2021-09-13,34,16718,38.9
13069,Coffee County,2021-09-14,38,16756,38.9
13069,Coffee County,2021-09-15,23,16779,39
13069,Coffee County,2021-09-16,49,16828,39.1
13069,Coffee County,2021-09-17,26,16854,39.2
13069,Coffee County,2021-09-18,12,16866,39.2
13069,Coffee County,2021-09-19,1,16867,39.2
13069,Coffee County,2021-09-20,18,16885,39.2
13069,Coffee County,2021-09-21,29,16914,39.3
13069,Coffee County,2021-09-22,25,16939,39.4
13069,Coffee County,2021-09-23,16,16955,39.4
13069,Coffee County,2021-09-24,31,16986,39.5
13069,Coffee County,2021-09-25,8,16994,39.5
13069,Coffee County,2021-09-26,7,17001,39.5
13069,Coffee County,2021-09-27,19,17020,39.6
13069,Coffee County,2021-09-28,37,17057,39.6
13069,Coffee County,2021-09-29,21,17078,39.7
13069,Coffee County,2021-09-30,15,17093,39.7
13069,Coffee County,2021-10-01,16,17109,39.8
13069,Coffee County,2021-10-02,6,17115,39.8
13069,Coffee County,2021-10-03,2,17117,39.8
13069,Coffee County,2021-10-04,10,17127,39.8
13069,Coffee County,2021-10-05,17,17144,39.9
13069,Coffee County,2021-10-06,14,17158,39.9
13069,Coffee County,2021-10-07,4,17162,39.9
13071,Colquitt County,2020-12-16,1,1,0
13071,Colquitt County,2020-12-17,61,62,0.1
13071,Colquitt County,2020-12-18,99,161,0.4
13071,Colquitt County,2020-12-19,3,164,0.4
13071,Colquitt County,2020-12-20,1,165,0.4
13071,Colquitt County,2020-12-21,40,205,0.5
13071,Colquitt County,2020-12-22,47,252,0.6
13071,Colquitt County,2020-12-23,58,310,0.7
13071,Colquitt County,2020-12-24,6,316,0.7
13071,Colquitt County,2020-12-26,1,317,0.7
13071,Colquitt County,2020-12-27,1,318,0.7
13071,Colquitt County,2020-12-28,31,349,0.8
13071,Colquitt County,2020-12-29,86,435,1
13071,Colquitt County,2020-12-30,87,522,1.1
13071,Colquitt County,2020-12-31,35,557,1.2
13071,Colquitt County,2021-01-01,14,571,1.3
13071,Colquitt County,2021-01-02,3,574,1.3
13071,Colquitt County,2021-01-03,1,575,1.3
13071,Colquitt County,2021-01-04,83,658,1.4
13071,Colquitt County,2021-01-05,89,747,1.6
13071,Colquitt County,2021-01-06,120,867,1.9
13071,Colquitt County,2021-01-07,88,955,2.1
13071,Colquitt County,2021-01-08,190,1145,2.5
13071,Colquitt County,2021-01-09,6,1151,2.5
13071,Colquitt County,2021-01-10,5,1156,2.5
13071,Colquitt County,2021-01-11,88,1244,2.7
13071,Colquitt County,2021-01-12,129,1373,3
13071,Colquitt County,2021-01-13,349,1722,3.8
13071,Colquitt County,2021-01-14,99,1821,4
13071,Colquitt County,2021-01-15,334,2155,4.7
13071,Colquitt County,2021-01-16,89,2244,4.9
13071,Colquitt County,2021-01-17,1,2245,4.9
13071,Colquitt County,2021-01-18,93,2338,5.1
13071,Colquitt County,2021-01-19,170,2508,5.5
13071,Colquitt County,2021-01-20,647,3155,6.9
13071,Colquitt County,2021-01-21,197,3352,7.4
13071,Colquitt County,2021-01-22,337,3689,8.1
13071,Colquitt County,2021-01-23,19,3708,8.2
13071,Colquitt County,2021-01-25,79,3787,8.3
13071,Colquitt County,2021-01-26,121,3908,8.6
13071,Colquitt County,2021-01-27,132,4040,8.9
13071,Colquitt County,2021-01-28,89,4129,9.1
13071,Colquitt County,2021-01-29,80,4209,9.3
13071,Colquitt County,2021-01-30,3,4212,9.3
13071,Colquitt County,2021-01-31,5,4217,9.3
13071,Colquitt County,2021-02-01,90,4307,9.5
13071,Colquitt County,2021-02-02,77,4384,9.6
13071,Colquitt County,2021-02-03,178,4562,10
13071,Colquitt County,2021-02-04,91,4653,10.2
13071,Colquitt County,2021-02-05,54,4707,10.3
13071,Colquitt County,2021-02-06,2,4709,10.4
13071,Colquitt County,2021-02-08,56,4765,10.5
13071,Colquitt County,2021-02-09,42,4807,10.6
13071,Colquitt County,2021-02-10,49,4856,10.7
13071,Colquitt County,2021-02-11,58,4914,10.8
13071,Colquitt County,2021-02-12,114,5028,11.1
13071,Colquitt County,2021-02-13,25,5053,11.1
13071,Colquitt County,2021-02-14,11,5064,11.1
13071,Colquitt County,2021-02-15,36,5100,11.2
13071,Colquitt County,2021-02-16,32,5132,11.3
13071,Colquitt County,2021-02-17,45,5177,11.4
13071,Colquitt County,2021-02-18,42,5219,11.5
13071,Colquitt County,2021-02-19,15,5234,11.5
13071,Colquitt County,2021-02-20,6,5240,11.5
13071,Colquitt County,2021-02-21,4,5244,11.5
13071,Colquitt County,2021-02-22,39,5283,11.6
13071,Colquitt County,2021-02-23,38,5321,11.7
13071,Colquitt County,2021-02-24,60,5381,11.8
13071,Colquitt County,2021-02-25,38,5419,11.9
13071,Colquitt County,2021-02-26,172,5591,12.3
13071,Colquitt County,2021-02-27,6,5597,12.3
13071,Colquitt County,2021-02-28,1,5598,12.3
13071,Colquitt County,2021-03-01,44,5642,12.4
13071,Colquitt County,2021-03-02,50,5692,12.5
13071,Colquitt County,2021-03-03,40,5732,12.6
13071,Colquitt County,2021-03-04,29,5761,12.7
13071,Colquitt County,2021-03-05,145,5906,13
13071,Colquitt County,2021-03-06,11,5917,13
13071,Colquitt County,2021-03-07,12,5929,13
13071,Colquitt County,2021-03-08,74,6003,13.2
13071,Colquitt County,2021-03-09,105,6108,13.4
13071,Colquitt County,2021-03-10,68,6176,13.6
13071,Colquitt County,2021-03-11,55,6231,13.7
13071,Colquitt County,2021-03-12,208,6439,14.2
13071,Colquitt County,2021-03-13,116,6555,14.4
13071,Colquitt County,2021-03-14,17,6572,14.4
13071,Colquitt County,2021-03-15,71,6643,14.6
13071,Colquitt County,2021-03-16,90,6733,14.8
13071,Colquitt County,2021-03-17,120,6853,15.1
13071,Colquitt County,2021-03-18,93,6946,15.3
13071,Colquitt County,2021-03-19,384,7330,16.1
13071,Colquitt County,2021-03-20,103,7433,16.3
13071,Colquitt County,2021-03-21,11,7444,16.4
13071,Colquitt County,2021-03-22,66,7510,16.5
13071,Colquitt County,2021-03-23,94,7604,16.7
13071,Colquitt County,2021-03-24,84,7688,16.9
13071,Colquitt County,2021-03-25,253,7941,17.5
13071,Colquitt County,2021-03-26,368,8309,18.3
13071,Colquitt County,2021-03-27,8,8317,18.3
13071,Colquitt County,2021-03-28,20,8337,18.3
13071,Colquitt County,2021-03-29,65,8402,18.5
13071,Colquitt County,2021-03-30,137,8539,18.8
13071,Colquitt County,2021-03-31,637,9176,20.2
13071,Colquitt County,2021-04-01,122,9298,20.4
13071,Colquitt County,2021-04-02,322,9620,21.1
13071,Colquitt County,2021-04-03,12,9632,21.2
13071,Colquitt County,2021-04-04,11,9643,21.2
13071,Colquitt County,2021-04-05,111,9754,21.4
13071,Colquitt County,2021-04-06,188,9942,21.9
13071,Colquitt County,2021-04-07,104,10046,22.1
13071,Colquitt County,2021-04-08,184,10230,22.5
13071,Colquitt County,2021-04-09,132,10362,22.8
13071,Colquitt County,2021-04-10,42,10404,22.9
13071,Colquitt County,2021-04-11,17,10421,22.9
13071,Colquitt County,2021-04-12,71,10492,23.1
13071,Colquitt County,2021-04-13,172,10664,23.4
13071,Colquitt County,2021-04-14,54,10718,23.6
13071,Colquitt County,2021-04-15,177,10895,24
13071,Colquitt County,2021-04-16,101,10996,24.2
13071,Colquitt County,2021-04-17,25,11021,24.2
13071,Colquitt County,2021-04-18,8,11029,24.2
13071,Colquitt County,2021-04-19,19,11048,24.3
13071,Colquitt County,2021-04-20,157,11205,24.6
13071,Colquitt County,2021-04-21,58,11263,24.8
13071,Colquitt County,2021-04-22,76,11339,24.9
13071,Colquitt County,2021-04-23,116,11455,25.2
13071,Colquitt County,2021-04-24,7,11462,25.2
13071,Colquitt County,2021-04-25,7,11469,25.2
13071,Colquitt County,2021-04-26,22,11491,25.3
13071,Colquitt County,2021-04-27,123,11614,25.5
13071,Colquitt County,2021-04-28,64,11678,25.7
13071,Colquitt County,2021-04-29,72,11750,25.8
13071,Colquitt County,2021-04-30,73,11823,26
13071,Colquitt County,2021-05-01,108,11931,26.2
13071,Colquitt County,2021-05-02,5,11936,26.2
13071,Colquitt County,2021-05-03,51,11987,26.4
13071,Colquitt County,2021-05-04,72,12059,26.5
13071,Colquitt County,2021-05-05,40,12099,26.6
13071,Colquitt County,2021-05-06,50,12149,26.7
13071,Colquitt County,2021-05-07,24,12173,26.8
13071,Colquitt County,2021-05-08,16,12189,26.8
13071,Colquitt County,2021-05-09,5,12194,26.8
13071,Colquitt County,2021-05-10,111,12305,27.1
13071,Colquitt County,2021-05-11,73,12378,27.2
13071,Colquitt County,2021-05-12,36,12414,27.3
13071,Colquitt County,2021-05-13,131,12545,27.6
13071,Colquitt County,2021-05-14,58,12603,27.7
13071,Colquitt County,2021-05-15,27,12630,27.8
13071,Colquitt County,2021-05-16,3,12633,27.8
13071,Colquitt County,2021-05-17,33,12666,27.8
13071,Colquitt County,2021-05-18,178,12844,28.2
13071,Colquitt County,2021-05-19,62,12906,28.4
13071,Colquitt County,2021-05-20,83,12989,28.6
13071,Colquitt County,2021-05-21,39,13028,28.6
13071,Colquitt County,2021-05-22,27,13055,28.7
13071,Colquitt County,2021-05-23,3,13058,28.7
13071,Colquitt County,2021-05-24,54,13112,28.8
13071,Colquitt County,2021-05-25,68,13180,29
13071,Colquitt County,2021-05-26,46,13226,29.1
13071,Colquitt County,2021-05-27,25,13251,29.1
13071,Colquitt County,2021-05-28,25,13276,29.2
13071,Colquitt County,2021-05-29,6,13282,29.2
13071,Colquitt County,2021-05-30,4,13286,29.2
13071,Colquitt County,2021-05-31,2,13288,29.2
13071,Colquitt County,2021-06-01,51,13339,29.3
13071,Colquitt County,2021-06-02,40,13379,29.4
13071,Colquitt County,2021-06-03,94,13473,29.6
13071,Colquitt County,2021-06-04,26,13499,29.7
13071,Colquitt County,2021-06-05,7,13506,29.7
13071,Colquitt County,2021-06-06,11,13517,29.7
13071,Colquitt County,2021-06-07,38,13555,29.8
13071,Colquitt County,2021-06-08,46,13601,29.9
13071,Colquitt County,2021-06-09,74,13675,30.1
13071,Colquitt County,2021-06-10,77,13752,30.2
13071,Colquitt County,2021-06-11,24,13776,30.3
13071,Colquitt County,2021-06-12,16,13792,30.3
13071,Colquitt County,2021-06-13,2,13794,30.3
13071,Colquitt County,2021-06-14,29,13823,30.4
13071,Colquitt County,2021-06-15,49,13872,30.5
13071,Colquitt County,2021-06-16,28,13900,30.6
13071,Colquitt County,2021-06-17,30,13930,30.6
13071,Colquitt County,2021-06-18,32,13962,30.7
13071,Colquitt County,2021-06-19,10,13972,30.7
13071,Colquitt County,2021-06-20,2,13974,30.7
13071,Colquitt County,2021-06-21,20,13994,30.8
13071,Colquitt County,2021-06-22,32,14026,30.8
13071,Colquitt County,2021-06-23,23,14049,30.9
13071,Colquitt County,2021-06-24,24,14073,30.9
13071,Colquitt County,2021-06-25,42,14115,31
13071,Colquitt County,2021-06-26,13,14128,31.1
13071,Colquitt County,2021-06-27,2,14130,31.1
13071,Colquitt County,2021-06-28,13,14143,31.1
13071,Colquitt County,2021-06-29,33,14176,31.2
13071,Colquitt County,2021-06-30,23,14199,31.2
13071,Colquitt County,2021-07-01,31,14230,31.3
13071,Colquitt County,2021-07-02,53,14283,31.4
13071,Colquitt County,2021-07-03,15,14298,31.4
13071,Colquitt County,2021-07-04,2,14300,31.4
13071,Colquitt County,2021-07-05,15,14315,31.5
13071,Colquitt County,2021-07-06,43,14358,31.6
13071,Colquitt County,2021-07-07,27,14385,31.6
13071,Colquitt County,2021-07-08,30,14415,31.7
13071,Colquitt County,2021-07-09,26,14441,31.7
13071,Colquitt County,2021-07-10,11,14452,31.8
13071,Colquitt County,2021-07-11,3,14455,31.8
13071,Colquitt County,2021-07-12,23,14478,31.8
13071,Colquitt County,2021-07-13,46,14524,31.9
13071,Colquitt County,2021-07-14,35,14559,32
13071,Colquitt County,2021-07-15,50,14609,32.1
13071,Colquitt County,2021-07-16,40,14649,32.2
13071,Colquitt County,2021-07-17,27,14676,32.3
13071,Colquitt County,2021-07-18,5,14681,32.3
13071,Colquitt County,2021-07-19,52,14733,32.4
13071,Colquitt County,2021-07-20,78,14811,32.6
13071,Colquitt County,2021-07-21,56,14867,32.7
13071,Colquitt County,2021-07-22,81,14948,32.9
13071,Colquitt County,2021-07-23,66,15014,33
13071,Colquitt County,2021-07-24,40,15054,33.1
13071,Colquitt County,2021-07-25,16,15070,33.1
13071,Colquitt County,2021-07-26,61,15131,33.3
13071,Colquitt County,2021-07-27,146,15277,33.6
13071,Colquitt County,2021-07-28,106,15383,33.8
13071,Colquitt County,2021-07-29,172,15555,34.2
13071,Colquitt County,2021-07-30,100,15655,34.4
13071,Colquitt County,2021-07-31,98,15753,34.6
13071,Colquitt County,2021-08-01,17,15770,34.7
13071,Colquitt County,2021-08-02,94,15864,34.9
13071,Colquitt County,2021-08-03,157,16021,35.2
13071,Colquitt County,2021-08-04,164,16185,35.6
13071,Colquitt County,2021-08-05,166,16351,35.9
13071,Colquitt County,2021-08-06,144,16495,36.3
13071,Colquitt County,2021-08-07,91,16586,36.5
13071,Colquitt County,2021-08-08,12,16598,36.5
13071,Colquitt County,2021-08-09,83,16681,36.7
13071,Colquitt County,2021-08-10,160,16841,37
13071,Colquitt County,2021-08-11,94,16935,37.2
13071,Colquitt County,2021-08-12,158,17093,37.6
13071,Colquitt County,2021-08-13,137,17230,37.9
13071,Colquitt County,2021-08-14,96,17326,38.1
13071,Colquitt County,2021-08-15,17,17343,38.1
13071,Colquitt County,2021-08-16,82,17425,38.3
13071,Colquitt County,2021-08-17,140,17565,38.6
13071,Colquitt County,2021-08-18,128,17693,38.9
13071,Colquitt County,2021-08-19,116,17809,39.2
13071,Colquitt County,2021-08-20,107,17916,39.4
13071,Colquitt County,2021-08-21,89,18005,39.6
13071,Colquitt County,2021-08-22,17,18022,39.6
13071,Colquitt County,2021-08-23,72,18094,39.8
13071,Colquitt County,2021-08-24,115,18209,40
13071,Colquitt County,2021-08-25,92,18301,40.2
13071,Colquitt County,2021-08-26,82,18383,40.4
13071,Colquitt County,2021-08-27,96,18479,40.6
13071,Colquitt County,2021-08-28,75,18554,40.8
13071,Colquitt County,2021-08-29,15,18569,40.8
13071,Colquitt County,2021-08-30,71,18640,41
13071,Colquitt County,2021-08-31,82,18722,41.2
13071,Colquitt County,2021-09-01,98,18820,41.4
13071,Colquitt County,2021-09-02,122,18942,41.6
13071,Colquitt County,2021-09-03,92,19034,41.8
13071,Colquitt County,2021-09-04,30,19064,41.9
13071,Colquitt County,2021-09-05,6,19070,41.9
13071,Colquitt County,2021-09-06,8,19078,41.9
13071,Colquitt County,2021-09-07,55,19133,42.1
13071,Colquitt County,2021-09-08,45,19178,42.2
13071,Colquitt County,2021-09-09,52,19230,42.3
13071,Colquitt County,2021-09-10,55,19285,42.4
13071,Colquitt County,2021-09-11,27,19312,42.5
13071,Colquitt County,2021-09-12,4,19316,42.5
13071,Colquitt County,2021-09-13,49,19365,42.6
13071,Colquitt County,2021-09-14,58,19423,42.7
13071,Colquitt County,2021-09-15,41,19464,42.8
13071,Colquitt County,2021-09-16,65,19529,42.9
13071,Colquitt County,2021-09-17,38,19567,43
13071,Colquitt County,2021-09-18,11,19578,43
13071,Colquitt County,2021-09-19,8,19586,43.1
13071,Colquitt County,2021-09-20,30,19616,43.1
13071,Colquitt County,2021-09-21,30,19646,43.2
13071,Colquitt County,2021-09-22,38,19684,43.3
13071,Colquitt County,2021-09-23,29,19713,43.3
13071,Colquitt County,2021-09-24,26,19739,43.4
13071,Colquitt County,2021-09-25,11,19750,43.4
13071,Colquitt County,2021-09-26,5,19755,43.4
13071,Colquitt County,2021-09-27,13,19768,43.5
13071,Colquitt County,2021-09-28,22,19790,43.5
13071,Colquitt County,2021-09-29,9,19799,43.5
13071,Colquitt County,2021-09-30,18,19817,43.6
13071,Colquitt County,2021-10-01,12,19829,43.6
13071,Colquitt County,2021-10-02,4,19833,43.6
13071,Colquitt County,2021-10-03,2,19835,43.6
13071,Colquitt County,2021-10-04,11,19846,43.6
13071,Colquitt County,2021-10-05,16,19862,43.7
13071,Colquitt County,2021-10-06,11,19873,43.7
13071,Colquitt County,2021-10-07,4,19877,43.7
13073,Columbia County,2020-12-14,1,1,0
13073,Columbia County,2020-12-15,1,2,0
13073,Columbia County,2020-12-16,6,8,0
13073,Columbia County,2020-12-17,125,133,0.1
13073,Columbia County,2020-12-18,290,423,0.3
13073,Columbia County,2020-12-19,101,524,0.3
13073,Columbia County,2020-12-20,6,530,0.4
13073,Columbia County,2020-12-21,58,588,0.4
13073,Columbia County,2020-12-22,740,1328,0.9
13073,Columbia County,2020-12-23,720,2048,1.4
13073,Columbia County,2020-12-24,149,2197,1.5
13073,Columbia County,2020-12-26,69,2266,1.5
13073,Columbia County,2020-12-27,27,2293,1.5
13073,Columbia County,2020-12-28,191,2484,1.6
13073,Columbia County,2020-12-29,427,2911,1.9
13073,Columbia County,2020-12-30,452,3363,2.2
13073,Columbia County,2020-12-31,258,3621,2.4
13073,Columbia County,2021-01-01,54,3675,2.4
13073,Columbia County,2021-01-02,85,3760,2.5
13073,Columbia County,2021-01-03,2,3762,2.5
13073,Columbia County,2021-01-04,499,4261,2.8
13073,Columbia County,2021-01-05,566,4827,3.2
13073,Columbia County,2021-01-06,278,5105,3.4
13073,Columbia County,2021-01-07,271,5376,3.6
13073,Columbia County,2021-01-08,245,5621,3.7
13073,Columbia County,2021-01-09,516,6137,4.1
13073,Columbia County,2021-01-10,16,6153,4.1
13073,Columbia County,2021-01-11,316,6469,4.3
13073,Columbia County,2021-01-12,320,6789,4.5
13073,Columbia County,2021-01-13,570,7359,4.9
13073,Columbia County,2021-01-14,662,8021,5.3
13073,Columbia County,2021-01-15,776,8797,5.8
13073,Columbia County,2021-01-16,301,9098,6
13073,Columbia County,2021-01-17,53,9151,6.1
13073,Columbia County,2021-01-18,311,9462,6.3
13073,Columbia County,2021-01-19,433,9895,6.6
13073,Columbia County,2021-01-20,412,10307,6.8
13073,Columbia County,2021-01-21,1023,11330,7.5
13073,Columbia County,2021-01-22,695,12025,8
13073,Columbia County,2021-01-23,95,12120,8
13073,Columbia County,2021-01-24,29,12149,8.1
13073,Columbia County,2021-01-25,402,12551,8.3
13073,Columbia County,2021-01-26,373,12924,8.6
13073,Columbia County,2021-01-27,367,13291,8.8
13073,Columbia County,2021-01-28,1011,14302,9.5
13073,Columbia County,2021-01-29,357,14659,9.7
13073,Columbia County,2021-01-30,431,15090,10
13073,Columbia County,2021-01-31,5,15095,10
13073,Columbia County,2021-02-01,214,15309,10.2
13073,Columbia County,2021-02-02,550,15859,10.5
13073,Columbia County,2021-02-03,112,15971,10.6
13073,Columbia County,2021-02-04,634,16605,11
13073,Columbia County,2021-02-05,239,16844,11.2
13073,Columbia County,2021-02-06,61,16905,11.2
13073,Columbia County,2021-02-07,8,16913,11.2
13073,Columbia County,2021-02-08,148,17061,11.3
13073,Columbia County,2021-02-09,189,17250,11.4
13073,Columbia County,2021-02-10,425,17675,11.7
13073,Columbia County,2021-02-11,547,18222,12.1
13073,Columbia County,2021-02-12,115,18337,12.2
13073,Columbia County,2021-02-13,682,19019,12.6
13073,Columbia County,2021-02-14,40,19059,12.6
13073,Columbia County,2021-02-15,183,19242,12.8
13073,Columbia County,2021-02-16,271,19513,12.9
13073,Columbia County,2021-02-17,582,20095,13.3
13073,Columbia County,2021-02-18,271,20366,13.5
13073,Columbia County,2021-02-19,116,20482,13.6
13073,Columbia County,2021-02-20,64,20546,13.6
13073,Columbia County,2021-02-21,19,20565,13.6
13073,Columbia County,2021-02-22,93,20658,13.7
13073,Columbia County,2021-02-23,203,20861,13.8
13073,Columbia County,2021-02-24,66,20927,13.9
13073,Columbia County,2021-02-25,508,21435,14.2
13073,Columbia County,2021-02-26,137,21572,14.3
13073,Columbia County,2021-02-27,141,21713,14.4
13073,Columbia County,2021-02-28,55,21768,14.4
13073,Columbia County,2021-03-01,178,21946,14.6
13073,Columbia County,2021-03-02,284,22230,14.8
13073,Columbia County,2021-03-03,251,22481,14.9
13073,Columbia County,2021-03-04,389,22870,15.2
13073,Columbia County,2021-03-05,205,23075,15.3
13073,Columbia County,2021-03-06,95,23170,15.4
13073,Columbia County,2021-03-07,110,23280,15.4
13073,Columbia County,2021-03-08,409,23689,15.7
13073,Columbia County,2021-03-09,346,24035,15.9
13073,Columbia County,2021-03-10,581,24616,16.3
13073,Columbia County,2021-03-11,1710,26326,17.5
13073,Columbia County,2021-03-12,1287,27613,18.3
13073,Columbia County,2021-03-13,568,28181,18.7
13073,Columbia County,2021-03-14,82,28263,18.8
13073,Columbia County,2021-03-15,455,28718,19.1
13073,Columbia County,2021-03-16,839,29557,19.6
13073,Columbia County,2021-03-17,905,30462,20.2
13073,Columbia County,2021-03-18,358,30820,20.5
13073,Columbia County,2021-03-19,453,31273,20.8
13073,Columbia County,2021-03-20,414,31687,21
13073,Columbia County,2021-03-21,139,31826,21.1
13073,Columbia County,2021-03-22,1049,32875,21.8
13073,Columbia County,2021-03-23,756,33631,22.3
13073,Columbia County,2021-03-24,520,34151,22.7
13073,Columbia County,2021-03-25,1533,35684,23.7
13073,Columbia County,2021-03-26,433,36117,24
13073,Columbia County,2021-03-27,983,37100,24.6
13073,Columbia County,2021-03-28,215,37315,24.8
13073,Columbia County,2021-03-29,544,37859,25.1
13073,Columbia County,2021-03-30,1321,39180,26
13073,Columbia County,2021-03-31,628,39808,26.4
13073,Columbia County,2021-04-01,1287,41095,27.3
13073,Columbia County,2021-04-02,387,41482,27.5
13073,Columbia County,2021-04-03,201,41683,27.7
13073,Columbia County,2021-04-04,178,41861,27.8
13073,Columbia County,2021-04-05,530,42391,28.1
13073,Columbia County,2021-04-06,725,43116,28.6
13073,Columbia County,2021-04-07,517,43633,29
13073,Columbia County,2021-04-08,646,44279,29.4
13073,Columbia County,2021-04-09,366,44645,29.6
13073,Columbia County,2021-04-10,251,44896,29.8
13073,Columbia County,2021-04-11,173,45069,29.9
13073,Columbia County,2021-04-12,258,45327,30.1
13073,Columbia County,2021-04-13,691,46018,30.5
13073,Columbia County,2021-04-14,227,46245,30.7
13073,Columbia County,2021-04-15,514,46759,31
13073,Columbia County,2021-04-16,225,46984,31.2
13073,Columbia County,2021-04-17,125,47109,31.3
13073,Columbia County,2021-04-18,75,47184,31.3
13073,Columbia County,2021-04-19,169,47353,31.4
13073,Columbia County,2021-04-20,606,47959,31.8
13073,Columbia County,2021-04-21,262,48221,32
13073,Columbia County,2021-04-22,378,48599,32.2
13073,Columbia County,2021-04-23,293,48892,32.4
13073,Columbia County,2021-04-24,116,49008,32.5
13073,Columbia County,2021-04-25,85,49093,32.6
13073,Columbia County,2021-04-26,200,49293,32.7
13073,Columbia County,2021-04-27,239,49532,32.9
13073,Columbia County,2021-04-28,324,49856,33.1
13073,Columbia County,2021-04-29,405,50261,33.4
13073,Columbia County,2021-04-30,266,50527,33.5
13073,Columbia County,2021-05-01,223,50750,33.7
13073,Columbia County,2021-05-02,65,50815,33.7
13073,Columbia County,2021-05-03,142,50957,33.8
13073,Columbia County,2021-05-04,225,51182,34
13073,Columbia County,2021-05-05,201,51383,34.1
13073,Columbia County,2021-05-06,184,51567,34.2
13073,Columbia County,2021-05-07,210,51777,34.4
13073,Columbia County,2021-05-08,112,51889,34.4
13073,Columbia County,2021-05-09,45,51934,34.5
13073,Columbia County,2021-05-10,96,52030,34.5
13073,Columbia County,2021-05-11,205,52235,34.7
13073,Columbia County,2021-05-12,193,52428,34.8
13073,Columbia County,2021-05-13,173,52601,34.9
13073,Columbia County,2021-05-14,275,52876,35.1
13073,Columbia County,2021-05-15,221,53097,35.2
13073,Columbia County,2021-05-16,136,53233,35.3
13073,Columbia County,2021-05-17,297,53530,35.5
13073,Columbia County,2021-05-18,355,53885,35.8
13073,Columbia County,2021-05-19,283,54168,35.9
13073,Columbia County,2021-05-20,269,54437,36.1
13073,Columbia County,2021-05-21,245,54682,36.3
13073,Columbia County,2021-05-22,263,54945,36.5
13073,Columbia County,2021-05-23,78,55023,36.5
13073,Columbia County,2021-05-24,178,55201,36.6
13073,Columbia County,2021-05-25,200,55401,36.8
13073,Columbia County,2021-05-26,206,55607,36.9
13073,Columbia County,2021-05-27,225,55832,37
13073,Columbia County,2021-05-28,167,55999,37.2
13073,Columbia County,2021-05-29,87,56086,37.2
13073,Columbia County,2021-05-30,71,56157,37.3
13073,Columbia County,2021-05-31,18,56175,37.3
13073,Columbia County,2021-06-01,150,56325,37.4
13073,Columbia County,2021-06-02,178,56503,37.5
13073,Columbia County,2021-06-03,164,56667,37.6
13073,Columbia County,2021-06-04,148,56815,37.7
13073,Columbia County,2021-06-05,94,56909,37.8
13073,Columbia County,2021-06-06,53,56962,37.8
13073,Columbia County,2021-06-07,110,57072,37.9
13073,Columbia County,2021-06-08,97,57169,37.9
13073,Columbia County,2021-06-09,112,57281,38
13073,Columbia County,2021-06-10,158,57439,38.1
13073,Columbia County,2021-06-11,144,57583,38.2
13073,Columbia County,2021-06-12,90,57673,38.3
13073,Columbia County,2021-06-13,29,57702,38.3
13073,Columbia County,2021-06-14,118,57820,38.4
13073,Columbia County,2021-06-15,81,57901,38.4
13073,Columbia County,2021-06-16,109,58010,38.5
13073,Columbia County,2021-06-17,109,58119,38.6
13073,Columbia County,2021-06-18,115,58234,38.6
13073,Columbia County,2021-06-19,49,58283,38.7
13073,Columbia County,2021-06-20,37,58320,38.7
13073,Columbia County,2021-06-21,83,58403,38.8
13073,Columbia County,2021-06-22,86,58489,38.8
13073,Columbia County,2021-06-23,128,58617,38.9
13073,Columbia County,2021-06-24,104,58721,39
13073,Columbia County,2021-06-25,77,58798,39
13073,Columbia County,2021-06-26,85,58883,39.1
13073,Columbia County,2021-06-27,30,58913,39.1
13073,Columbia County,2021-06-28,71,58984,39.1
13073,Columbia County,2021-06-29,77,59061,39.2
13073,Columbia County,2021-06-30,84,59145,39.2
13073,Columbia County,2021-07-01,93,59238,39.3
13073,Columbia County,2021-07-02,74,59312,39.4
13073,Columbia County,2021-07-03,62,59374,39.4
13073,Columbia County,2021-07-04,5,59379,39.4
13073,Columbia County,2021-07-05,82,59461,39.5
13073,Columbia County,2021-07-06,92,59553,39.5
13073,Columbia County,2021-07-07,71,59624,39.6
13073,Columbia County,2021-07-08,82,59706,39.6
13073,Columbia County,2021-07-09,99,59805,39.7
13073,Columbia County,2021-07-10,58,59863,39.7
13073,Columbia County,2021-07-11,45,59908,39.8
13073,Columbia County,2021-07-12,95,60003,39.8
13073,Columbia County,2021-07-13,93,60096,39.9
13073,Columbia County,2021-07-14,92,60188,39.9
13073,Columbia County,2021-07-15,99,60287,40
13073,Columbia County,2021-07-16,81,60368,40.1
13073,Columbia County,2021-07-17,82,60450,40.1
13073,Columbia County,2021-07-18,55,60505,40.1
13073,Columbia County,2021-07-19,78,60583,40.2
13073,Columbia County,2021-07-20,115,60698,40.3
13073,Columbia County,2021-07-21,136,60834,40.4
13073,Columbia County,2021-07-22,152,60986,40.5
13073,Columbia County,2021-07-23,182,61168,40.6
13073,Columbia County,2021-07-24,149,61317,40.7
13073,Columbia County,2021-07-25,95,61412,40.7
13073,Columbia County,2021-07-26,161,61573,40.9
13073,Columbia County,2021-07-27,202,61775,41
13073,Columbia County,2021-07-28,252,62027,41.2
13073,Columbia County,2021-07-29,231,62258,41.3
13073,Columbia County,2021-07-30,265,62523,41.5
13073,Columbia County,2021-07-31,162,62685,41.6
13073,Columbia County,2021-08-01,111,62796,41.7
13073,Columbia County,2021-08-02,240,63036,41.8
13073,Columbia County,2021-08-03,245,63281,42
13073,Columbia County,2021-08-04,264,63545,42.2
13073,Columbia County,2021-08-05,260,63805,42.3
13073,Columbia County,2021-08-06,291,64096,42.5
13073,Columbia County,2021-08-07,208,64304,42.7
13073,Columbia County,2021-08-08,127,64431,42.8
13073,Columbia County,2021-08-09,247,64678,42.9
13073,Columbia County,2021-08-10,296,64974,43.1
13073,Columbia County,2021-08-11,245,65219,43.3
13073,Columbia County,2021-08-12,226,65445,43.4
13073,Columbia County,2021-08-13,283,65728,43.6
13073,Columbia County,2021-08-14,212,65940,43.8
13073,Columbia County,2021-08-15,133,66073,43.8
13073,Columbia County,2021-08-16,226,66299,44
13073,Columbia County,2021-08-17,236,66535,44.1
13073,Columbia County,2021-08-18,245,66780,44.3
13073,Columbia County,2021-08-19,248,67028,44.5
13073,Columbia County,2021-08-20,248,67276,44.6
13073,Columbia County,2021-08-21,164,67440,44.7
13073,Columbia County,2021-08-22,81,67521,44.8
13073,Columbia County,2021-08-23,200,67721,44.9
13073,Columbia County,2021-08-24,202,67923,45.1
13073,Columbia County,2021-08-25,239,68162,45.2
13073,Columbia County,2021-08-26,212,68374,45.4
13073,Columbia County,2021-08-27,257,68631,45.5
13073,Columbia County,2021-08-28,134,68765,45.6
13073,Columbia County,2021-08-29,96,68861,45.7
13073,Columbia County,2021-08-30,179,69040,45.8
13073,Columbia County,2021-08-31,205,69245,45.9
13073,Columbia County,2021-09-01,206,69451,46.1
13073,Columbia County,2021-09-02,217,69668,46.2
13073,Columbia County,2021-09-03,213,69881,46.4
13073,Columbia County,2021-09-04,125,70006,46.5
13073,Columbia County,2021-09-05,91,70097,46.5
13073,Columbia County,2021-09-06,34,70131,46.5
13073,Columbia County,2021-09-07,147,70278,46.6
13073,Columbia County,2021-09-08,159,70437,46.7
13073,Columbia County,2021-09-09,140,70577,46.8
13073,Columbia County,2021-09-10,220,70797,47
13073,Columbia County,2021-09-11,113,70910,47.1
13073,Columbia County,2021-09-12,94,71004,47.1
13073,Columbia County,2021-09-13,154,71158,47.2
13073,Columbia County,2021-09-14,150,71308,47.3
13073,Columbia County,2021-09-15,148,71456,47.4
13073,Columbia County,2021-09-16,131,71587,47.5
13073,Columbia County,2021-09-17,142,71729,47.6
13073,Columbia County,2021-09-18,77,71806,47.6
13073,Columbia County,2021-09-19,45,71851,47.7
13073,Columbia County,2021-09-20,76,71927,47.7
13073,Columbia County,2021-09-21,112,72039,47.8
13073,Columbia County,2021-09-22,106,72145,47.9
13073,Columbia County,2021-09-23,88,72233,47.9
13073,Columbia County,2021-09-24,62,72295,48
13073,Columbia County,2021-09-25,55,72350,48
13073,Columbia County,2021-09-26,34,72384,48
13073,Columbia County,2021-09-27,40,72424,48.1
13073,Columbia County,2021-09-28,66,72490,48.1
13073,Columbia County,2021-09-29,68,72558,48.1
13073,Columbia County,2021-09-30,55,72613,48.2
13073,Columbia County,2021-10-01,70,72683,48.2
13073,Columbia County,2021-10-02,30,72713,48.2
13073,Columbia County,2021-10-03,14,72727,48.3
13073,Columbia County,2021-10-04,35,72762,48.3
13073,Columbia County,2021-10-05,31,72793,48.3
13073,Columbia County,2021-10-06,52,72845,48.3
13073,Columbia County,2021-10-07,20,72865,48.3
13075,Cook County,2020-12-16,1,1,0
13075,Cook County,2020-12-17,1,2,0
13075,Cook County,2020-12-18,7,9,0.1
13075,Cook County,2020-12-19,1,10,0.1
13075,Cook County,2020-12-21,14,24,0.1
13075,Cook County,2020-12-22,4,28,0.2
13075,Cook County,2020-12-23,22,50,0.3
13075,Cook County,2020-12-24,3,53,0.3
13075,Cook County,2020-12-26,1,54,0.3
13075,Cook County,2020-12-28,23,77,0.4
13075,Cook County,2020-12-29,36,113,0.7
13075,Cook County,2020-12-30,29,142,0.8
13075,Cook County,2020-12-31,17,159,0.9
13075,Cook County,2021-01-01,2,161,0.9
13075,Cook County,2021-01-03,6,167,1
13075,Cook County,2021-01-04,26,193,1.1
13075,Cook County,2021-01-05,25,218,1.3
13075,Cook County,2021-01-06,44,262,1.5
13075,Cook County,2021-01-07,58,320,1.9
13075,Cook County,2021-01-08,27,347,2
13075,Cook County,2021-01-11,53,400,2.3
13075,Cook County,2021-01-12,42,442,2.6
13075,Cook County,2021-01-13,125,567,3.3
13075,Cook County,2021-01-14,102,669,3.9
13075,Cook County,2021-01-15,97,766,4.5
13075,Cook County,2021-01-16,2,768,4.5
13075,Cook County,2021-01-17,1,769,4.5
13075,Cook County,2021-01-18,62,831,4.8
13075,Cook County,2021-01-19,80,911,5.3
13075,Cook County,2021-01-20,196,1107,6.4
13075,Cook County,2021-01-21,106,1213,7.1
13075,Cook County,2021-01-22,72,1285,7.5
13075,Cook County,2021-01-25,64,1349,7.9
13075,Cook County,2021-01-26,39,1388,8.1
13075,Cook County,2021-01-27,198,1586,9.2
13075,Cook County,2021-01-28,43,1629,9.5
13075,Cook County,2021-01-29,46,1675,9.8
13075,Cook County,2021-01-30,6,1681,9.8
13075,Cook County,2021-01-31,5,1686,9.8
13075,Cook County,2021-02-01,34,1720,10
13075,Cook County,2021-02-02,71,1791,10.4
13075,Cook County,2021-02-03,178,1969,11.5
13075,Cook County,2021-02-04,38,2007,11.7
13075,Cook County,2021-02-05,56,2063,12
13075,Cook County,2021-02-08,10,2073,12.1
13075,Cook County,2021-02-09,23,2096,12.2
13075,Cook County,2021-02-10,86,2182,12.7
13075,Cook County,2021-02-11,27,2209,12.9
13075,Cook County,2021-02-12,16,2225,13
13075,Cook County,2021-02-13,1,2226,13
13075,Cook County,2021-02-14,4,2230,13
13075,Cook County,2021-02-15,18,2248,13.1
13075,Cook County,2021-02-16,23,2271,13.2
13075,Cook County,2021-02-17,47,2318,13.5
13075,Cook County,2021-02-18,15,2333,13.6
13075,Cook County,2021-02-19,35,2368,13.8
13075,Cook County,2021-02-20,3,2371,13.8
13075,Cook County,2021-02-22,33,2404,14
13075,Cook County,2021-02-23,23,2427,14.1
13075,Cook County,2021-02-24,67,2494,14.5
13075,Cook County,2021-02-25,26,2520,14.7
13075,Cook County,2021-02-26,18,2538,14.8
13075,Cook County,2021-02-27,4,2542,14.8
13075,Cook County,2021-02-28,6,2548,14.8
13075,Cook County,2021-03-01,54,2602,15.1
13075,Cook County,2021-03-02,15,2617,15.2
13075,Cook County,2021-03-03,53,2670,15.5
13075,Cook County,2021-03-04,27,2697,15.7
13075,Cook County,2021-03-05,30,2727,15.9
13075,Cook County,2021-03-06,7,2734,15.9
13075,Cook County,2021-03-07,11,2745,16
13075,Cook County,2021-03-08,37,2782,16.2
13075,Cook County,2021-03-09,48,2830,16.5
13075,Cook County,2021-03-10,52,2882,16.8
13075,Cook County,2021-03-11,116,2998,17.5
13075,Cook County,2021-03-12,34,3032,17.7
13075,Cook County,2021-03-13,22,3054,17.8
13075,Cook County,2021-03-14,6,3060,17.8
13075,Cook County,2021-03-15,57,3117,18.1
13075,Cook County,2021-03-16,53,3170,18.5
13075,Cook County,2021-03-17,83,3253,18.9
13075,Cook County,2021-03-18,66,3319,19.3
13075,Cook County,2021-03-19,45,3364,19.6
13075,Cook County,2021-03-20,18,3382,19.7
13075,Cook County,2021-03-21,6,3388,19.7
13075,Cook County,2021-03-22,62,3450,20.1
13075,Cook County,2021-03-23,38,3488,20.3
13075,Cook County,2021-03-24,79,3567,20.8
13075,Cook County,2021-03-25,82,3649,21.2
13075,Cook County,2021-03-26,45,3694,21.5
13075,Cook County,2021-03-27,6,3700,21.5
13075,Cook County,2021-03-28,15,3715,21.6
13075,Cook County,2021-03-29,54,3769,21.9
13075,Cook County,2021-03-30,72,3841,22.4
13075,Cook County,2021-03-31,118,3959,23
13075,Cook County,2021-04-01,43,4002,23.3
13075,Cook County,2021-04-02,38,4040,23.5
13075,Cook County,2021-04-03,7,4047,23.6
13075,Cook County,2021-04-04,9,4056,23.6
13075,Cook County,2021-04-05,46,4102,23.9
13075,Cook County,2021-04-06,34,4136,24.1
13075,Cook County,2021-04-07,48,4184,24.4
13075,Cook County,2021-04-08,32,4216,24.5
13075,Cook County,2021-04-09,41,4257,24.8
13075,Cook County,2021-04-10,8,4265,24.8
13075,Cook County,2021-04-11,10,4275,24.9
13075,Cook County,2021-04-12,44,4319,25.1
13075,Cook County,2021-04-13,26,4345,25.3
13075,Cook County,2021-04-14,50,4395,25.6
13075,Cook County,2021-04-15,19,4414,25.7
13075,Cook County,2021-04-16,19,4433,25.8
13075,Cook County,2021-04-17,7,4440,25.8
13075,Cook County,2021-04-18,2,4442,25.9
13075,Cook County,2021-04-19,28,4470,26
13075,Cook County,2021-04-20,19,4489,26.1
13075,Cook County,2021-04-21,45,4534,26.4
13075,Cook County,2021-04-22,33,4567,26.6
13075,Cook County,2021-04-23,18,4585,26.7
13075,Cook County,2021-04-24,3,4588,26.7
13075,Cook County,2021-04-26,24,4612,26.8
13075,Cook County,2021-04-27,16,4628,26.9
13075,Cook County,2021-04-28,16,4644,27
13075,Cook County,2021-04-29,18,4662,27.1
13075,Cook County,2021-04-30,27,4689,27.3
13075,Cook County,2021-05-01,5,4694,27.3
13075,Cook County,2021-05-02,1,4695,27.3
13075,Cook County,2021-05-03,10,4705,27.4
13075,Cook County,2021-05-04,13,4718,27.5
13075,Cook County,2021-05-05,22,4740,27.6
13075,Cook County,2021-05-06,18,4758,27.7
13075,Cook County,2021-05-07,19,4777,27.8
13075,Cook County,2021-05-08,8,4785,27.9
13075,Cook County,2021-05-10,15,4800,27.9
13075,Cook County,2021-05-11,18,4818,28
13075,Cook County,2021-05-12,14,4832,28.1
13075,Cook County,2021-05-13,9,4841,28.2
13075,Cook County,2021-05-14,19,4860,28.3
13075,Cook County,2021-05-15,15,4875,28.4
13075,Cook County,2021-05-16,2,4877,28.4
13075,Cook County,2021-05-17,18,4895,28.5
13075,Cook County,2021-05-18,18,4913,28.6
13075,Cook County,2021-05-19,33,4946,28.8
13075,Cook County,2021-05-20,16,4962,28.9
13075,Cook County,2021-05-21,32,4994,29.1
13075,Cook County,2021-05-22,23,5017,29.2
13075,Cook County,2021-05-23,5,5022,29.2
13075,Cook County,2021-05-24,18,5040,29.3
13075,Cook County,2021-05-25,7,5047,29.4
13075,Cook County,2021-05-26,23,5070,29.5
13075,Cook County,2021-05-27,17,5087,29.6
13075,Cook County,2021-05-28,21,5108,29.7
13075,Cook County,2021-05-29,7,5115,29.8
13075,Cook County,2021-05-30,3,5118,29.8
13075,Cook County,2021-05-31,3,5121,29.8
13075,Cook County,2021-06-01,14,5135,29.9
13075,Cook County,2021-06-02,17,5152,30
13075,Cook County,2021-06-03,13,5165,30.1
13075,Cook County,2021-06-04,10,5175,30.1
13075,Cook County,2021-06-05,3,5178,30.1
13075,Cook County,2021-06-06,2,5180,30.2
13075,Cook County,2021-06-07,15,5195,30.2
13075,Cook County,2021-06-08,8,5203,30.3
13075,Cook County,2021-06-09,5,5208,30.3
13075,Cook County,2021-06-10,15,5223,30.4
13075,Cook County,2021-06-11,13,5236,30.5
13075,Cook County,2021-06-12,3,5239,30.5
13075,Cook County,2021-06-13,4,5243,30.5
13075,Cook County,2021-06-14,8,5251,30.6
13075,Cook County,2021-06-15,13,5264,30.6
13075,Cook County,2021-06-16,8,5272,30.7
13075,Cook County,2021-06-17,13,5285,30.8
13075,Cook County,2021-06-18,15,5300,30.9
13075,Cook County,2021-06-19,1,5301,30.9
13075,Cook County,2021-06-20,1,5302,30.9
13075,Cook County,2021-06-21,17,5319,31
13075,Cook County,2021-06-22,10,5329,31
13075,Cook County,2021-06-23,7,5336,31.1
13075,Cook County,2021-06-24,12,5348,31.1
13075,Cook County,2021-06-25,16,5364,31.2
13075,Cook County,2021-06-26,4,5368,31.3
13075,Cook County,2021-06-27,2,5370,31.3
13075,Cook County,2021-06-28,5,5375,31.3
13075,Cook County,2021-06-29,5,5380,31.3
13075,Cook County,2021-06-30,10,5390,31.4
13075,Cook County,2021-07-01,10,5400,31.4
13075,Cook County,2021-07-02,9,5409,31.5
13075,Cook County,2021-07-03,4,5413,31.5
13075,Cook County,2021-07-04,1,5414,31.5
13075,Cook County,2021-07-05,6,5420,31.6
13075,Cook County,2021-07-06,15,5435,31.6
13075,Cook County,2021-07-07,10,5445,31.7
13075,Cook County,2021-07-08,8,5453,31.7
13075,Cook County,2021-07-09,9,5462,31.8
13075,Cook County,2021-07-10,4,5466,31.8
13075,Cook County,2021-07-11,1,5467,31.8
13075,Cook County,2021-07-12,3,5470,31.8
13075,Cook County,2021-07-13,11,5481,31.9
13075,Cook County,2021-07-14,9,5490,32
13075,Cook County,2021-07-15,13,5503,32
13075,Cook County,2021-07-16,16,5519,32.1
13075,Cook County,2021-07-17,1,5520,32.1
13075,Cook County,2021-07-18,2,5522,32.1
13075,Cook County,2021-07-19,11,5533,32.2
13075,Cook County,2021-07-20,14,5547,32.3
13075,Cook County,2021-07-21,22,5569,32.4
13075,Cook County,2021-07-22,12,5581,32.5
13075,Cook County,2021-07-23,32,5613,32.7
13075,Cook County,2021-07-24,8,5621,32.7
13075,Cook County,2021-07-25,15,5636,32.8
13075,Cook County,2021-07-26,31,5667,33
13075,Cook County,2021-07-27,29,5696,33.2
13075,Cook County,2021-07-28,33,5729,33.4
13075,Cook County,2021-07-29,39,5768,33.6
13075,Cook County,2021-07-30,58,5826,33.9
13075,Cook County,2021-07-31,22,5848,34
13075,Cook County,2021-08-01,11,5859,34.1
13075,Cook County,2021-08-02,42,5901,34.4
13075,Cook County,2021-08-03,34,5935,34.6
13075,Cook County,2021-08-04,38,5973,34.8
13075,Cook County,2021-08-05,35,6008,35
13075,Cook County,2021-08-06,67,6075,35.4
13075,Cook County,2021-08-07,32,6107,35.6
13075,Cook County,2021-08-08,18,6125,35.7
13075,Cook County,2021-08-09,48,6173,35.9
13075,Cook County,2021-08-10,40,6213,36.2
13075,Cook County,2021-08-11,39,6252,36.4
13075,Cook County,2021-08-12,53,6305,36.7
13075,Cook County,2021-08-13,68,6373,37.1
13075,Cook County,2021-08-14,25,6398,37.2
13075,Cook County,2021-08-15,9,6407,37.3
13075,Cook County,2021-08-16,54,6461,37.6
13075,Cook County,2021-08-17,43,6504,37.9
13075,Cook County,2021-08-18,34,6538,38.1
13075,Cook County,2021-08-19,32,6570,38.2
13075,Cook County,2021-08-20,67,6637,38.6
13075,Cook County,2021-08-21,14,6651,38.7
13075,Cook County,2021-08-22,16,6667,38.8
13075,Cook County,2021-08-23,36,6703,39
13075,Cook County,2021-08-24,32,6735,39.2
13075,Cook County,2021-08-25,33,6768,39.4
13075,Cook County,2021-08-26,44,6812,39.7
13075,Cook County,2021-08-27,47,6859,39.9
13075,Cook County,2021-08-28,26,6885,40.1
13075,Cook County,2021-08-29,10,6895,40.1
13075,Cook County,2021-08-30,39,6934,40.4
13075,Cook County,2021-08-31,32,6966,40.6
13075,Cook County,2021-09-01,25,6991,40.7
13075,Cook County,2021-09-02,19,7010,40.8
13075,Cook County,2021-09-03,34,7044,41
13075,Cook County,2021-09-04,6,7050,41
13075,Cook County,2021-09-05,4,7054,41.1
13075,Cook County,2021-09-06,2,7056,41.1
13075,Cook County,2021-09-07,20,7076,41.2
13075,Cook County,2021-09-08,14,7090,41.3
13075,Cook County,2021-09-09,12,7102,41.3
13075,Cook County,2021-09-10,20,7122,41.5
13075,Cook County,2021-09-11,8,7130,41.5
13075,Cook County,2021-09-12,8,7138,41.6
13075,Cook County,2021-09-13,16,7154,41.6
13075,Cook County,2021-09-14,15,7169,41.7
13075,Cook County,2021-09-15,15,7184,41.8
13075,Cook County,2021-09-16,12,7196,41.9
13075,Cook County,2021-09-17,15,7211,42
13075,Cook County,2021-09-18,5,7216,42
13075,Cook County,2021-09-19,3,7219,42
13075,Cook County,2021-09-20,8,7227,42.1
13075,Cook County,2021-09-21,12,7239,42.1
13075,Cook County,2021-09-22,9,7248,42.2
13075,Cook County,2021-09-23,11,7259,42.3
13075,Cook County,2021-09-24,9,7268,42.3
13075,Cook County,2021-09-25,4,7272,42.3
13075,Cook County,2021-09-27,5,7277,42.4
13075,Cook County,2021-09-28,6,7283,42.4
13075,Cook County,2021-09-29,5,7288,42.4
13075,Cook County,2021-09-30,9,7297,42.5
13075,Cook County,2021-10-01,5,7302,42.5
13075,Cook County,2021-10-02,3,7305,42.5
13075,Cook County,2021-10-05,1,7306,42.5
13075,Cook County,2021-10-06,6,7312,42.6
13075,Cook County,2021-10-07,2,7314,42.6
13077,Coweta County,2020-12-14,1,1,0
13077,Coweta County,2020-12-16,1,2,0
13077,Coweta County,2020-12-17,5,7,0
13077,Coweta County,2020-12-18,19,26,0
13077,Coweta County,2020-12-19,9,35,0
13077,Coweta County,2020-12-20,9,44,0
13077,Coweta County,2020-12-21,47,91,0.1
13077,Coweta County,2020-12-22,73,164,0.1
13077,Coweta County,2020-12-23,102,266,0.2
13077,Coweta County,2020-12-24,14,280,0.2
13077,Coweta County,2020-12-26,5,285,0.2
13077,Coweta County,2020-12-27,10,295,0.2
13077,Coweta County,2020-12-28,262,557,0.4
13077,Coweta County,2020-12-29,280,837,0.6
13077,Coweta County,2020-12-30,371,1208,0.8
13077,Coweta County,2020-12-31,113,1321,0.9
13077,Coweta County,2021-01-01,35,1356,0.9
13077,Coweta County,2021-01-02,8,1364,1
13077,Coweta County,2021-01-03,10,1374,1
13077,Coweta County,2021-01-04,216,1590,1.1
13077,Coweta County,2021-01-05,70,1660,1.2
13077,Coweta County,2021-01-06,113,1773,1.2
13077,Coweta County,2021-01-07,120,1893,1.3
13077,Coweta County,2021-01-08,167,2060,1.4
13077,Coweta County,2021-01-09,114,2174,1.5
13077,Coweta County,2021-01-10,34,2208,1.5
13077,Coweta County,2021-01-11,916,3124,2.2
13077,Coweta County,2021-01-12,319,3443,2.4
13077,Coweta County,2021-01-13,332,3775,2.6
13077,Coweta County,2021-01-14,917,4692,3.3
13077,Coweta County,2021-01-15,333,5025,3.5
13077,Coweta County,2021-01-16,236,5261,3.7
13077,Coweta County,2021-01-17,59,5320,3.7
13077,Coweta County,2021-01-18,195,5515,3.8
13077,Coweta County,2021-01-19,406,5921,4.1
13077,Coweta County,2021-01-20,309,6230,4.3
13077,Coweta County,2021-01-21,259,6489,4.5
13077,Coweta County,2021-01-22,318,6807,4.8
13077,Coweta County,2021-01-23,109,6916,4.8
13077,Coweta County,2021-01-24,26,6942,4.8
13077,Coweta County,2021-01-25,245,7187,5
13077,Coweta County,2021-01-26,164,7351,5.1
13077,Coweta County,2021-01-27,392,7743,5.4
13077,Coweta County,2021-01-28,388,8131,5.7
13077,Coweta County,2021-01-29,406,8537,6
13077,Coweta County,2021-01-30,82,8619,6
13077,Coweta County,2021-01-31,36,8655,6
13077,Coweta County,2021-02-01,146,8801,6.1
13077,Coweta County,2021-02-02,179,8980,6.3
13077,Coweta County,2021-02-03,112,9092,6.3
13077,Coweta County,2021-02-04,288,9380,6.5
13077,Coweta County,2021-02-05,139,9519,6.6
13077,Coweta County,2021-02-06,41,9560,6.7
13077,Coweta County,2021-02-07,23,9583,6.7
13077,Coweta County,2021-02-08,122,9705,6.8
13077,Coweta County,2021-02-09,153,9858,6.9
13077,Coweta County,2021-02-10,132,9990,7
13077,Coweta County,2021-02-11,182,10172,7.1
13077,Coweta County,2021-02-12,106,10278,7.2
13077,Coweta County,2021-02-13,58,10336,7.2
13077,Coweta County,2021-02-14,35,10371,7.2
13077,Coweta County,2021-02-15,156,10527,7.3
13077,Coweta County,2021-02-16,196,10723,7.5
13077,Coweta County,2021-02-17,563,11286,7.9
13077,Coweta County,2021-02-18,184,11470,8
13077,Coweta County,2021-02-19,184,11654,8.1
13077,Coweta County,2021-02-20,45,11699,8.2
13077,Coweta County,2021-02-21,18,11717,8.2
13077,Coweta County,2021-02-22,177,11894,8.3
13077,Coweta County,2021-02-23,481,12375,8.6
13077,Coweta County,2021-02-24,712,13087,9.1
13077,Coweta County,2021-02-25,321,13408,9.4
13077,Coweta County,2021-02-26,322,13730,9.6
13077,Coweta County,2021-02-27,99,13829,9.7
13077,Coweta County,2021-02-28,93,13922,9.7
13077,Coweta County,2021-03-01,273,14195,9.9
13077,Coweta County,2021-03-02,460,14655,10.2
13077,Coweta County,2021-03-03,743,15398,10.7
13077,Coweta County,2021-03-04,462,15860,11.1
13077,Coweta County,2021-03-05,346,16206,11.3
13077,Coweta County,2021-03-06,88,16294,11.4
13077,Coweta County,2021-03-07,105,16399,11.4
13077,Coweta County,2021-03-08,465,16864,11.8
13077,Coweta County,2021-03-09,530,17394,12.1
13077,Coweta County,2021-03-10,693,18087,12.6
13077,Coweta County,2021-03-11,792,18879,13.2
13077,Coweta County,2021-03-12,1007,19886,13.9
13077,Coweta County,2021-03-13,135,20021,14
13077,Coweta County,2021-03-14,150,20171,14.1
13077,Coweta County,2021-03-15,901,21072,14.7
13077,Coweta County,2021-03-16,711,21783,15.2
13077,Coweta County,2021-03-17,780,22563,15.7
13077,Coweta County,2021-03-18,647,23210,16.2
13077,Coweta County,2021-03-19,1139,24349,17
13077,Coweta County,2021-03-20,215,24564,17.1
13077,Coweta County,2021-03-21,250,24814,17.3
13077,Coweta County,2021-03-22,851,25665,17.9
13077,Coweta County,2021-03-23,532,26197,18.3
13077,Coweta County,2021-03-24,743,26940,18.8
13077,Coweta County,2021-03-25,817,27757,19.4
13077,Coweta County,2021-03-26,750,28507,19.9
13077,Coweta County,2021-03-27,535,29042,20.3
13077,Coweta County,2021-03-28,201,29243,20.4
13077,Coweta County,2021-03-29,568,29811,20.8
13077,Coweta County,2021-03-30,850,30661,21.4
13077,Coweta County,2021-03-31,1024,31685,22.1
13077,Coweta County,2021-04-01,1056,32741,22.9
13077,Coweta County,2021-04-02,776,33517,23.4
13077,Coweta County,2021-04-03,379,33896,23.7
13077,Coweta County,2021-04-04,169,34065,23.8
13077,Coweta County,2021-04-05,638,34703,24.2
13077,Coweta County,2021-04-06,812,35515,24.8
13077,Coweta County,2021-04-07,1106,36621,25.6
13077,Coweta County,2021-04-08,780,37401,26.1
13077,Coweta County,2021-04-09,724,38125,26.6
13077,Coweta County,2021-04-10,619,38744,27
13077,Coweta County,2021-04-11,235,38979,27.2
13077,Coweta County,2021-04-12,529,39508,27.6
13077,Coweta County,2021-04-13,545,40053,28
13077,Coweta County,2021-04-14,398,40451,28.2
13077,Coweta County,2021-04-15,491,40942,28.6
13077,Coweta County,2021-04-16,449,41391,28.9
13077,Coweta County,2021-04-17,108,41499,29
13077,Coweta County,2021-04-18,93,41592,29
13077,Coweta County,2021-04-19,261,41853,29.2
13077,Coweta County,2021-04-20,433,42286,29.5
13077,Coweta County,2021-04-21,324,42610,29.7
13077,Coweta County,2021-04-22,300,42910,30
13077,Coweta County,2021-04-23,526,43436,30.3
13077,Coweta County,2021-04-24,121,43557,30.4
13077,Coweta County,2021-04-25,94,43651,30.5
13077,Coweta County,2021-04-26,231,43882,30.6
13077,Coweta County,2021-04-27,297,44179,30.8
13077,Coweta County,2021-04-28,317,44496,31.1
13077,Coweta County,2021-04-29,255,44751,31.2
13077,Coweta County,2021-04-30,421,45172,31.5
13077,Coweta County,2021-05-01,162,45334,31.6
13077,Coweta County,2021-05-02,74,45408,31.7
13077,Coweta County,2021-05-03,176,45584,31.8
13077,Coweta County,2021-05-04,252,45836,32
13077,Coweta County,2021-05-05,281,46117,32.2
13077,Coweta County,2021-05-06,228,46345,32.4
13077,Coweta County,2021-05-07,264,46609,32.5
13077,Coweta County,2021-05-08,153,46762,32.6
13077,Coweta County,2021-05-09,42,46804,32.7
13077,Coweta County,2021-05-10,178,46982,32.8
13077,Coweta County,2021-05-11,207,47189,32.9
13077,Coweta County,2021-05-12,203,47392,33.1
13077,Coweta County,2021-05-13,241,47633,33.2
13077,Coweta County,2021-05-14,342,47975,33.5
13077,Coweta County,2021-05-15,228,48203,33.6
13077,Coweta County,2021-05-16,145,48348,33.7
13077,Coweta County,2021-05-17,327,48675,34
13077,Coweta County,2021-05-18,320,48995,34.2
13077,Coweta County,2021-05-19,234,49229,34.4
13077,Coweta County,2021-05-20,190,49419,34.5
13077,Coweta County,2021-05-21,271,49690,34.7
13077,Coweta County,2021-05-22,164,49854,34.8
13077,Coweta County,2021-05-23,87,49941,34.9
13077,Coweta County,2021-05-24,193,50134,35
13077,Coweta County,2021-05-25,151,50285,35.1
13077,Coweta County,2021-05-26,169,50454,35.2
13077,Coweta County,2021-05-27,150,50604,35.3
13077,Coweta County,2021-05-28,147,50751,35.4
13077,Coweta County,2021-05-29,104,50855,35.5
13077,Coweta County,2021-05-30,44,50899,35.5
13077,Coweta County,2021-05-31,24,50923,35.5
13077,Coweta County,2021-06-01,149,51072,35.6
13077,Coweta County,2021-06-02,144,51216,35.8
13077,Coweta County,2021-06-03,130,51346,35.8
13077,Coweta County,2021-06-04,150,51496,35.9
13077,Coweta County,2021-06-05,78,51574,36
13077,Coweta County,2021-06-06,48,51622,36
13077,Coweta County,2021-06-07,162,51784,36.1
13077,Coweta County,2021-06-08,132,51916,36.2
13077,Coweta County,2021-06-09,117,52033,36.3
13077,Coweta County,2021-06-10,128,52161,36.4
13077,Coweta County,2021-06-11,146,52307,36.5
13077,Coweta County,2021-06-12,67,52374,36.6
13077,Coweta County,2021-06-13,16,52390,36.6
13077,Coweta County,2021-06-14,98,52488,36.6
13077,Coweta County,2021-06-15,95,52583,36.7
13077,Coweta County,2021-06-16,93,52676,36.8
13077,Coweta County,2021-06-17,94,52770,36.8
13077,Coweta County,2021-06-18,113,52883,36.9
13077,Coweta County,2021-06-19,53,52936,37
13077,Coweta County,2021-06-20,24,52960,37
13077,Coweta County,2021-06-21,92,53052,37
13077,Coweta County,2021-06-22,76,53128,37.1
13077,Coweta County,2021-06-23,89,53217,37.1
13077,Coweta County,2021-06-24,71,53288,37.2
13077,Coweta County,2021-06-25,113,53401,37.3
13077,Coweta County,2021-06-26,71,53472,37.3
13077,Coweta County,2021-06-27,39,53511,37.4
13077,Coweta County,2021-06-28,87,53598,37.4
13077,Coweta County,2021-06-29,78,53676,37.5
13077,Coweta County,2021-06-30,70,53746,37.5
13077,Coweta County,2021-07-01,78,53824,37.6
13077,Coweta County,2021-07-02,97,53921,37.6
13077,Coweta County,2021-07-03,54,53975,37.7
13077,Coweta County,2021-07-04,3,53978,37.7
13077,Coweta County,2021-07-05,54,54032,37.7
13077,Coweta County,2021-07-06,71,54103,37.8
13077,Coweta County,2021-07-07,50,54153,37.8
13077,Coweta County,2021-07-08,74,54227,37.9
13077,Coweta County,2021-07-09,102,54329,37.9
13077,Coweta County,2021-07-10,67,54396,38
13077,Coweta County,2021-07-11,35,54431,38
13077,Coweta County,2021-07-12,57,54488,38
13077,Coweta County,2021-07-13,75,54563,38.1
13077,Coweta County,2021-07-14,80,54643,38.1
13077,Coweta County,2021-07-15,91,54734,38.2
13077,Coweta County,2021-07-16,109,54843,38.3
13077,Coweta County,2021-07-17,56,54899,38.3
13077,Coweta County,2021-07-18,38,54937,38.3
13077,Coweta County,2021-07-19,125,55062,38.4
13077,Coweta County,2021-07-20,104,55166,38.5
13077,Coweta County,2021-07-21,131,55297,38.6
13077,Coweta County,2021-07-22,149,55446,38.7
13077,Coweta County,2021-07-23,199,55645,38.8
13077,Coweta County,2021-07-24,129,55774,38.9
13077,Coweta County,2021-07-25,77,55851,39
13077,Coweta County,2021-07-26,194,56045,39.1
13077,Coweta County,2021-07-27,161,56206,39.2
13077,Coweta County,2021-07-28,180,56386,39.4
13077,Coweta County,2021-07-29,167,56553,39.5
13077,Coweta County,2021-07-30,260,56813,39.7
13077,Coweta County,2021-07-31,157,56970,39.8
13077,Coweta County,2021-08-01,87,57057,39.8
13077,Coweta County,2021-08-02,231,57288,40
13077,Coweta County,2021-08-03,183,57471,40.1
13077,Coweta County,2021-08-04,239,57710,40.3
13077,Coweta County,2021-08-05,208,57918,40.4
13077,Coweta County,2021-08-06,276,58194,40.6
13077,Coweta County,2021-08-07,176,58370,40.7
13077,Coweta County,2021-08-08,108,58478,40.8
13077,Coweta County,2021-08-09,220,58698,41
13077,Coweta County,2021-08-10,242,58940,41.1
13077,Coweta County,2021-08-11,218,59158,41.3
13077,Coweta County,2021-08-12,228,59386,41.5
13077,Coweta County,2021-08-13,271,59657,41.6
13077,Coweta County,2021-08-14,161,59818,41.8
13077,Coweta County,2021-08-15,67,59885,41.8
13077,Coweta County,2021-08-16,227,60112,42
13077,Coweta County,2021-08-17,217,60329,42.1
13077,Coweta County,2021-08-18,277,60606,42.3
13077,Coweta County,2021-08-19,196,60802,42.4
13077,Coweta County,2021-08-20,298,61100,42.6
13077,Coweta County,2021-08-21,174,61274,42.8
13077,Coweta County,2021-08-22,99,61373,42.8
13077,Coweta County,2021-08-23,228,61601,43
13077,Coweta County,2021-08-24,201,61802,43.1
13077,Coweta County,2021-08-25,246,62048,43.3
13077,Coweta County,2021-08-26,276,62324,43.5
13077,Coweta County,2021-08-27,350,62674,43.7
13077,Coweta County,2021-08-28,161,62835,43.9
13077,Coweta County,2021-08-29,91,62926,43.9
13077,Coweta County,2021-08-30,296,63222,44.1
13077,Coweta County,2021-08-31,217,63439,44.3
13077,Coweta County,2021-09-01,272,63711,44.5
13077,Coweta County,2021-09-02,224,63935,44.6
13077,Coweta County,2021-09-03,312,64247,44.8
13077,Coweta County,2021-09-04,173,64420,45
13077,Coweta County,2021-09-05,95,64515,45
13077,Coweta County,2021-09-06,43,64558,45.1
13077,Coweta County,2021-09-07,190,64748,45.2
13077,Coweta County,2021-09-08,221,64969,45.4
13077,Coweta County,2021-09-09,225,65194,45.5
13077,Coweta County,2021-09-10,302,65496,45.7
13077,Coweta County,2021-09-11,154,65650,45.8
13077,Coweta County,2021-09-12,63,65713,45.9
13077,Coweta County,2021-09-13,323,66036,46.1
13077,Coweta County,2021-09-14,217,66253,46.2
13077,Coweta County,2021-09-15,201,66454,46.4
13077,Coweta County,2021-09-16,168,66622,46.5
13077,Coweta County,2021-09-17,225,66847,46.7
13077,Coweta County,2021-09-18,182,67029,46.8
13077,Coweta County,2021-09-19,50,67079,46.8
13077,Coweta County,2021-09-20,217,67296,47
13077,Coweta County,2021-09-21,149,67445,47.1
13077,Coweta County,2021-09-22,161,67606,47.2
13077,Coweta County,2021-09-23,121,67727,47.3
13077,Coweta County,2021-09-24,169,67896,47.4
13077,Coweta County,2021-09-25,87,67983,47.5
13077,Coweta County,2021-09-26,18,68001,47.5
13077,Coweta County,2021-09-27,89,68090,47.5
13077,Coweta County,2021-09-28,64,68154,47.6
13077,Coweta County,2021-09-29,76,68230,47.6
13077,Coweta County,2021-09-30,63,68293,47.7
13077,Coweta County,2021-10-01,91,68384,47.7
13077,Coweta County,2021-10-02,40,68424,47.8
13077,Coweta County,2021-10-03,18,68442,47.8
13077,Coweta County,2021-10-04,45,68487,47.8
13077,Coweta County,2021-10-05,27,68514,47.8
13077,Coweta County,2021-10-06,51,68565,47.9
13077,Coweta County,2021-10-07,28,68593,47.9
13079,Crawford County,2020-12-17,1,1,0
13079,Crawford County,2020-12-22,2,3,0
13079,Crawford County,2020-12-23,5,8,0.1
13079,Crawford County,2020-12-24,3,11,0.1
13079,Crawford County,2020-12-26,3,14,0.1
13079,Crawford County,2020-12-27,1,15,0.1
13079,Crawford County,2020-12-28,13,28,0.2
13079,Crawford County,2020-12-29,9,37,0.3
13079,Crawford County,2020-12-30,7,44,0.4
13079,Crawford County,2020-12-31,6,50,0.4
13079,Crawford County,2021-01-01,2,52,0.4
13079,Crawford County,2021-01-02,2,54,0.4
13079,Crawford County,2021-01-03,7,61,0.5
13079,Crawford County,2021-01-04,9,70,0.6
13079,Crawford County,2021-01-05,58,128,1
13079,Crawford County,2021-01-06,11,139,1.1
13079,Crawford County,2021-01-07,11,150,1.2
13079,Crawford County,2021-01-08,3,153,1.2
13079,Crawford County,2021-01-09,3,156,1.3
13079,Crawford County,2021-01-10,4,160,1.3
13079,Crawford County,2021-01-11,59,219,1.8
13079,Crawford County,2021-01-12,17,236,1.9
13079,Crawford County,2021-01-13,59,295,2.4
13079,Crawford County,2021-01-14,26,321,2.6
13079,Crawford County,2021-01-15,16,337,2.7
13079,Crawford County,2021-01-16,29,366,3
13079,Crawford County,2021-01-17,4,370,3
13079,Crawford County,2021-01-18,100,470,3.8
13079,Crawford County,2021-01-19,25,495,4
13079,Crawford County,2021-01-20,102,597,4.8
13079,Crawford County,2021-01-21,16,613,5
13079,Crawford County,2021-01-22,38,651,5.3
13079,Crawford County,2021-01-23,6,657,5.3
13079,Crawford County,2021-01-24,3,660,5.4
13079,Crawford County,2021-01-25,100,760,6.2
13079,Crawford County,2021-01-26,59,819,6.6
13079,Crawford County,2021-01-27,48,867,7
13079,Crawford County,2021-01-28,21,888,7.2
13079,Crawford County,2021-01-29,26,914,7.4
13079,Crawford County,2021-01-30,42,956,7.8
13079,Crawford County,2021-02-01,52,1008,8.2
13079,Crawford County,2021-02-02,6,1014,8.2
13079,Crawford County,2021-02-03,40,1054,8.6
13079,Crawford County,2021-02-04,12,1066,8.6
13079,Crawford County,2021-02-05,16,1082,8.8
13079,Crawford County,2021-02-06,1,1083,8.8
13079,Crawford County,2021-02-07,1,1084,8.8
13079,Crawford County,2021-02-08,19,1103,8.9
13079,Crawford County,2021-02-09,8,1111,9
13079,Crawford County,2021-02-10,31,1142,9.3
13079,Crawford County,2021-02-11,19,1161,9.4
13079,Crawford County,2021-02-12,12,1173,9.5
13079,Crawford County,2021-02-13,4,1177,9.5
13079,Crawford County,2021-02-14,2,1179,9.6
13079,Crawford County,2021-02-15,25,1204,9.8
13079,Crawford County,2021-02-16,15,1219,9.9
13079,Crawford County,2021-02-17,14,1233,10
13079,Crawford County,2021-02-18,9,1242,10.1
13079,Crawford County,2021-02-19,5,1247,10.1
13079,Crawford County,2021-02-20,4,1251,10.2
13079,Crawford County,2021-02-22,17,1268,10.3
13079,Crawford County,2021-02-23,11,1279,10.4
13079,Crawford County,2021-02-24,14,1293,10.5
13079,Crawford County,2021-02-25,16,1309,10.6
13079,Crawford County,2021-02-26,12,1321,10.7
13079,Crawford County,2021-02-27,5,1326,10.8
13079,Crawford County,2021-02-28,6,1332,10.8
13079,Crawford County,2021-03-01,34,1366,11.1
13079,Crawford County,2021-03-02,44,1410,11.4
13079,Crawford County,2021-03-03,46,1456,11.8
13079,Crawford County,2021-03-04,21,1477,12
13079,Crawford County,2021-03-05,26,1503,12.2
13079,Crawford County,2021-03-06,7,1510,12.3
13079,Crawford County,2021-03-07,2,1512,12.3
13079,Crawford County,2021-03-08,68,1580,12.8
13079,Crawford County,2021-03-09,26,1606,13
13079,Crawford County,2021-03-10,77,1683,13.7
13079,Crawford County,2021-03-11,23,1706,13.8
13079,Crawford County,2021-03-12,44,1750,14.2
13079,Crawford County,2021-03-13,65,1815,14.7
13079,Crawford County,2021-03-14,5,1820,14.8
13079,Crawford County,2021-03-15,100,1920,15.6
13079,Crawford County,2021-03-16,55,1975,16
13079,Crawford County,2021-03-17,90,2065,16.8
13079,Crawford County,2021-03-18,27,2092,17
13079,Crawford County,2021-03-19,60,2152,17.5
13079,Crawford County,2021-03-20,6,2158,17.5
13079,Crawford County,2021-03-21,3,2161,17.5
13079,Crawford County,2021-03-22,47,2208,17.9
13079,Crawford County,2021-03-23,26,2234,18.1
13079,Crawford County,2021-03-24,60,2294,18.6
13079,Crawford County,2021-03-25,44,2338,19
13079,Crawford County,2021-03-26,43,2381,19.3
13079,Crawford County,2021-03-27,8,2389,19.4
13079,Crawford County,2021-03-28,1,2390,19.4
13079,Crawford County,2021-03-29,60,2450,19.9
13079,Crawford County,2021-03-30,26,2476,20.1
13079,Crawford County,2021-03-31,150,2626,21.3
13079,Crawford County,2021-04-01,35,2661,21.6
13079,Crawford County,2021-04-02,47,2708,22
13079,Crawford County,2021-04-03,10,2718,22.1
13079,Crawford County,2021-04-04,1,2719,22.1
13079,Crawford County,2021-04-05,54,2773,22.5
13079,Crawford County,2021-04-06,26,2799,22.7
13079,Crawford County,2021-04-07,46,2845,23.1
13079,Crawford County,2021-04-08,39,2884,23.4
13079,Crawford County,2021-04-09,26,2910,23.6
13079,Crawford County,2021-04-10,6,2916,23.7
13079,Crawford County,2021-04-11,3,2919,23.7
13079,Crawford County,2021-04-12,36,2955,24
13079,Crawford County,2021-04-13,24,2979,24.2
13079,Crawford County,2021-04-14,43,3022,24.5
13079,Crawford County,2021-04-15,22,3044,24.7
13079,Crawford County,2021-04-16,22,3066,24.9
13079,Crawford County,2021-04-17,33,3099,25.1
13079,Crawford County,2021-04-18,4,3103,25.2
13079,Crawford County,2021-04-19,16,3119,25.3
13079,Crawford County,2021-04-20,9,3128,25.4
13079,Crawford County,2021-04-21,16,3144,25.5
13079,Crawford County,2021-04-22,77,3221,26.1
13079,Crawford County,2021-04-23,57,3278,26.6
13079,Crawford County,2021-04-25,2,3280,26.6
13079,Crawford County,2021-04-26,16,3296,26.7
13079,Crawford County,2021-04-27,9,3305,26.8
13079,Crawford County,2021-04-28,23,3328,27
13079,Crawford County,2021-04-29,11,3339,27.1
13079,Crawford County,2021-04-30,14,3353,27.2
13079,Crawford County,2021-05-01,4,3357,27.2
13079,Crawford County,2021-05-02,1,3358,27.2
13079,Crawford County,2021-05-03,10,3368,27.3
13079,Crawford County,2021-05-04,10,3378,27.4
13079,Crawford County,2021-05-05,14,3392,27.5
13079,Crawford County,2021-05-06,5,3397,27.6
13079,Crawford County,2021-05-07,15,3412,27.7
13079,Crawford County,2021-05-08,8,3420,27.7
13079,Crawford County,2021-05-09,1,3421,27.8
13079,Crawford County,2021-05-10,2,3423,27.8
13079,Crawford County,2021-05-11,11,3434,27.9
13079,Crawford County,2021-05-12,12,3446,28
13079,Crawford County,2021-05-13,7,3453,28
13079,Crawford County,2021-05-14,17,3470,28.2
13079,Crawford County,2021-05-15,8,3478,28.2
13079,Crawford County,2021-05-16,3,3481,28.2
13079,Crawford County,2021-05-17,5,3486,28.3
13079,Crawford County,2021-05-18,14,3500,28.4
13079,Crawford County,2021-05-19,18,3518,28.5
13079,Crawford County,2021-05-20,18,3536,28.7
13079,Crawford County,2021-05-21,15,3551,28.8
13079,Crawford County,2021-05-22,15,3566,28.9
13079,Crawford County,2021-05-23,1,3567,28.9
13079,Crawford County,2021-05-24,10,3577,29
13079,Crawford County,2021-05-25,13,3590,29.1
13079,Crawford County,2021-05-26,14,3604,29.2
13079,Crawford County,2021-05-27,8,3612,29.3
13079,Crawford County,2021-05-28,11,3623,29.4
13079,Crawford County,2021-05-29,2,3625,29.4
13079,Crawford County,2021-05-30,1,3626,29.4
13079,Crawford County,2021-05-31,2,3628,29.4
13079,Crawford County,2021-06-01,6,3634,29.5
13079,Crawford County,2021-06-02,18,3652,29.6
13079,Crawford County,2021-06-03,4,3656,29.7
13079,Crawford County,2021-06-04,5,3661,29.7
13079,Crawford County,2021-06-05,3,3664,29.7
13079,Crawford County,2021-06-06,1,3665,29.7
13079,Crawford County,2021-06-07,6,3671,29.8
13079,Crawford County,2021-06-08,4,3675,29.8
13079,Crawford County,2021-06-09,10,3685,29.9
13079,Crawford County,2021-06-10,10,3695,30
13079,Crawford County,2021-06-11,10,3705,30.1
13079,Crawford County,2021-06-12,4,3709,30.1
13079,Crawford County,2021-06-13,1,3710,30.1
13079,Crawford County,2021-06-14,8,3718,30.2
13079,Crawford County,2021-06-15,2,3720,30.2
13079,Crawford County,2021-06-16,9,3729,30.3
13079,Crawford County,2021-06-17,9,3738,30.3
13079,Crawford County,2021-06-18,7,3745,30.4
13079,Crawford County,2021-06-19,1,3746,30.4
13079,Crawford County,2021-06-20,1,3747,30.4
13079,Crawford County,2021-06-21,5,3752,30.4
13079,Crawford County,2021-06-22,3,3755,30.5
13079,Crawford County,2021-06-23,10,3765,30.5
13079,Crawford County,2021-06-24,3,3768,30.6
13079,Crawford County,2021-06-25,5,3773,30.6
13079,Crawford County,2021-06-26,2,3775,30.6
13079,Crawford County,2021-06-28,2,3777,30.6
13079,Crawford County,2021-06-29,6,3783,30.7
13079,Crawford County,2021-06-30,4,3787,30.7
13079,Crawford County,2021-07-01,3,3790,30.8
13079,Crawford County,2021-07-02,5,3795,30.8
13079,Crawford County,2021-07-03,4,3799,30.8
13079,Crawford County,2021-07-04,1,3800,30.8
13079,Crawford County,2021-07-06,6,3806,30.9
13079,Crawford County,2021-07-07,5,3811,30.9
13079,Crawford County,2021-07-08,4,3815,31
13079,Crawford County,2021-07-09,4,3819,31
13079,Crawford County,2021-07-10,5,3824,31
13079,Crawford County,2021-07-11,1,3825,31
13079,Crawford County,2021-07-12,6,3831,31.1
13079,Crawford County,2021-07-13,11,3842,31.2
13079,Crawford County,2021-07-14,6,3848,31.2
13079,Crawford County,2021-07-15,12,3860,31.3
13079,Crawford County,2021-07-16,7,3867,31.4
13079,Crawford County,2021-07-17,5,3872,31.4
13079,Crawford County,2021-07-18,3,3875,31.4
13079,Crawford County,2021-07-19,5,3880,31.5
13079,Crawford County,2021-07-20,5,3885,31.5
13079,Crawford County,2021-07-21,16,3901,31.7
13079,Crawford County,2021-07-22,12,3913,31.7
13079,Crawford County,2021-07-23,16,3929,31.9
13079,Crawford County,2021-07-24,11,3940,32
13079,Crawford County,2021-07-25,2,3942,32
13079,Crawford County,2021-07-26,7,3949,32
13079,Crawford County,2021-07-27,7,3956,32.1
13079,Crawford County,2021-07-28,25,3981,32.3
13079,Crawford County,2021-07-29,26,4007,32.5
13079,Crawford County,2021-07-30,27,4034,32.7
13079,Crawford County,2021-07-31,9,4043,32.8
13079,Crawford County,2021-08-01,9,4052,32.9
13079,Crawford County,2021-08-02,14,4066,33
13079,Crawford County,2021-08-03,14,4080,33.1
13079,Crawford County,2021-08-04,24,4104,33.3
13079,Crawford County,2021-08-05,15,4119,33.4
13079,Crawford County,2021-08-06,38,4157,33.7
13079,Crawford County,2021-08-07,21,4178,33.9
13079,Crawford County,2021-08-08,12,4190,34
13079,Crawford County,2021-08-09,29,4219,34.2
13079,Crawford County,2021-08-10,30,4249,34.5
13079,Crawford County,2021-08-11,26,4275,34.7
13079,Crawford County,2021-08-12,26,4301,34.9
13079,Crawford County,2021-08-13,37,4338,35.2
13079,Crawford County,2021-08-14,17,4355,35.3
13079,Crawford County,2021-08-15,6,4361,35.4
13079,Crawford County,2021-08-16,12,4373,35.5
13079,Crawford County,2021-08-17,24,4397,35.7
13079,Crawford County,2021-08-18,19,4416,35.8
13079,Crawford County,2021-08-19,29,4445,36.1
13079,Crawford County,2021-08-20,32,4477,36.3
13079,Crawford County,2021-08-21,18,4495,36.5
13079,Crawford County,2021-08-22,4,4499,36.5
13079,Crawford County,2021-08-23,17,4516,36.6
13079,Crawford County,2021-08-24,28,4544,36.9
13079,Crawford County,2021-08-25,39,4583,37.2
13079,Crawford County,2021-08-26,27,4610,37.4
13079,Crawford County,2021-08-27,21,4631,37.6
13079,Crawford County,2021-08-28,16,4647,37.7
13079,Crawford County,2021-08-29,6,4653,37.8
13079,Crawford County,2021-08-30,22,4675,37.9
13079,Crawford County,2021-08-31,13,4688,38
13079,Crawford County,2021-09-01,19,4707,38.2
13079,Crawford County,2021-09-02,13,4720,38.3
13079,Crawford County,2021-09-03,26,4746,38.5
13079,Crawford County,2021-09-04,16,4762,38.6
13079,Crawford County,2021-09-05,5,4767,38.7
13079,Crawford County,2021-09-06,3,4770,38.7
13079,Crawford County,2021-09-07,15,4785,38.8
13079,Crawford County,2021-09-08,18,4803,39
13079,Crawford County,2021-09-09,16,4819,39.1
13079,Crawford County,2021-09-10,30,4849,39.3
13079,Crawford County,2021-09-11,15,4864,39.5
13079,Crawford County,2021-09-12,6,4870,39.5
13079,Crawford County,2021-09-13,12,4882,39.6
13079,Crawford County,2021-09-14,11,4893,39.7
13079,Crawford County,2021-09-15,16,4909,39.8
13079,Crawford County,2021-09-16,11,4920,39.9
13079,Crawford County,2021-09-17,19,4939,40.1
13079,Crawford County,2021-09-18,11,4950,40.2
13079,Crawford County,2021-09-19,6,4956,40.2
13079,Crawford County,2021-09-20,19,4975,40.4
13079,Crawford County,2021-09-21,6,4981,40.4
13079,Crawford County,2021-09-22,10,4991,40.5
13079,Crawford County,2021-09-23,7,4998,40.6
13079,Crawford County,2021-09-24,5,5003,40.6
13079,Crawford County,2021-09-26,1,5004,40.6
13079,Crawford County,2021-09-27,3,5007,40.6
13079,Crawford County,2021-09-28,6,5013,40.7
13079,Crawford County,2021-09-29,2,5015,40.7
13079,Crawford County,2021-09-30,4,5019,40.7
13079,Crawford County,2021-10-01,5,5024,40.8
13079,Crawford County,2021-10-02,3,5027,40.8
13079,Crawford County,2021-10-04,3,5030,40.8
13079,Crawford County,2021-10-05,3,5033,40.8
13079,Crawford County,2021-10-06,6,5039,40.9
13079,Crawford County,2021-10-07,3,5042,40.9
13081,Crisp County,2020-12-17,1,1,0
13081,Crisp County,2020-12-18,5,6,0
13081,Crisp County,2020-12-21,5,11,0
13081,Crisp County,2020-12-22,8,19,0.1
13081,Crisp County,2020-12-23,60,79,0.3
13081,Crisp County,2020-12-24,44,123,0.5
13081,Crisp County,2020-12-26,4,127,0.6
13081,Crisp County,2020-12-27,5,132,0.6
13081,Crisp County,2020-12-28,71,203,0.9
13081,Crisp County,2020-12-29,68,271,1.2
13081,Crisp County,2020-12-30,29,300,1.3
13081,Crisp County,2020-12-31,43,343,1.5
13081,Crisp County,2021-01-01,4,347,1.5
13081,Crisp County,2021-01-02,2,349,1.5
13081,Crisp County,2021-01-03,3,352,1.5
13081,Crisp County,2021-01-04,69,421,1.9
13081,Crisp County,2021-01-05,56,477,2.1
13081,Crisp County,2021-01-06,43,520,2.3
13081,Crisp County,2021-01-07,60,580,2.6
13081,Crisp County,2021-01-08,78,658,2.9
13081,Crisp County,2021-01-09,1,659,2.9
13081,Crisp County,2021-01-10,4,663,2.9
13081,Crisp County,2021-01-11,203,866,3.8
13081,Crisp County,2021-01-12,90,956,4.2
13081,Crisp County,2021-01-13,91,1047,4.6
13081,Crisp County,2021-01-14,111,1158,5.1
13081,Crisp County,2021-01-15,123,1281,5.6
13081,Crisp County,2021-01-16,44,1325,5.8
13081,Crisp County,2021-01-17,5,1330,5.9
13081,Crisp County,2021-01-18,146,1476,6.5
13081,Crisp County,2021-01-19,118,1594,7
13081,Crisp County,2021-01-20,74,1668,7.3
13081,Crisp County,2021-01-21,415,2083,9.2
13081,Crisp County,2021-01-22,60,2143,9.4
13081,Crisp County,2021-01-23,10,2153,9.5
13081,Crisp County,2021-01-24,3,2156,9.5
13081,Crisp County,2021-01-25,40,2196,9.7
13081,Crisp County,2021-01-26,61,2257,9.9
13081,Crisp County,2021-01-27,61,2318,10.2
13081,Crisp County,2021-01-28,55,2373,10.4
13081,Crisp County,2021-01-29,41,2414,10.6
13081,Crisp County,2021-01-30,1,2415,10.6
13081,Crisp County,2021-01-31,1,2416,10.6
13081,Crisp County,2021-02-01,33,2449,10.8
13081,Crisp County,2021-02-02,45,2494,11
13081,Crisp County,2021-02-03,72,2566,11.3
13081,Crisp County,2021-02-04,164,2730,12
13081,Crisp County,2021-02-05,68,2798,12.3
13081,Crisp County,2021-02-06,9,2807,12.4
13081,Crisp County,2021-02-07,2,2809,12.4
13081,Crisp County,2021-02-08,7,2816,12.4
13081,Crisp County,2021-02-09,30,2846,12.5
13081,Crisp County,2021-02-10,36,2882,12.7
13081,Crisp County,2021-02-11,31,2913,12.8
13081,Crisp County,2021-02-12,37,2950,13
13081,Crisp County,2021-02-13,7,2957,13
13081,Crisp County,2021-02-14,11,2968,13.1
13081,Crisp County,2021-02-15,26,2994,13.2
13081,Crisp County,2021-02-16,46,3040,13.4
13081,Crisp County,2021-02-17,19,3059,13.5
13081,Crisp County,2021-02-18,60,3119,13.7
13081,Crisp County,2021-02-19,26,3145,13.8
13081,Crisp County,2021-02-20,6,3151,13.9
13081,Crisp County,2021-02-22,17,3168,13.9
13081,Crisp County,2021-02-23,43,3211,14.1
13081,Crisp County,2021-02-24,50,3261,14.4
13081,Crisp County,2021-02-25,65,3326,14.6
13081,Crisp County,2021-02-26,41,3367,14.8
13081,Crisp County,2021-02-27,19,3386,14.9
13081,Crisp County,2021-02-28,10,3396,15
13081,Crisp County,2021-03-01,73,3469,15.3
13081,Crisp County,2021-03-02,113,3582,15.8
13081,Crisp County,2021-03-03,41,3623,16
13081,Crisp County,2021-03-04,55,3678,16.2
13081,Crisp County,2021-03-05,75,3753,16.5
13081,Crisp County,2021-03-06,7,3760,16.6
13081,Crisp County,2021-03-07,19,3779,16.6
13081,Crisp County,2021-03-08,69,3848,16.9
13081,Crisp County,2021-03-09,47,3895,17.1
13081,Crisp County,2021-03-10,197,4092,18
13081,Crisp County,2021-03-11,45,4137,18.2
13081,Crisp County,2021-03-12,62,4199,18.5
13081,Crisp County,2021-03-13,14,4213,18.5
13081,Crisp County,2021-03-14,13,4226,18.6
13081,Crisp County,2021-03-15,154,4380,19.3
13081,Crisp County,2021-03-16,87,4467,19.7
13081,Crisp County,2021-03-17,76,4543,20
13081,Crisp County,2021-03-18,61,4604,20.3
13081,Crisp County,2021-03-19,242,4846,21.3
13081,Crisp County,2021-03-20,12,4858,21.4
13081,Crisp County,2021-03-21,17,4875,21.5
13081,Crisp County,2021-03-22,149,5024,22.1
13081,Crisp County,2021-03-23,82,5106,22.5
13081,Crisp County,2021-03-24,94,5200,22.9
13081,Crisp County,2021-03-25,81,5281,23.3
13081,Crisp County,2021-03-26,93,5374,23.7
13081,Crisp County,2021-03-27,9,5383,23.7
13081,Crisp County,2021-03-28,3,5386,23.7
13081,Crisp County,2021-03-29,80,5466,24.1
13081,Crisp County,2021-03-30,89,5555,24.5
13081,Crisp County,2021-03-31,99,5654,24.9
13081,Crisp County,2021-04-01,91,5745,25.3
13081,Crisp County,2021-04-02,82,5827,25.7
13081,Crisp County,2021-04-03,39,5866,25.8
13081,Crisp County,2021-04-04,5,5871,25.8
13081,Crisp County,2021-04-05,62,5933,26.1
13081,Crisp County,2021-04-06,57,5990,26.4
13081,Crisp County,2021-04-07,43,6033,26.6
13081,Crisp County,2021-04-08,102,6135,27
13081,Crisp County,2021-04-09,53,6188,27.2
13081,Crisp County,2021-04-10,17,6205,27.3
13081,Crisp County,2021-04-11,7,6212,27.3
13081,Crisp County,2021-04-12,80,6292,27.7
13081,Crisp County,2021-04-13,45,6337,27.9
13081,Crisp County,2021-04-14,30,6367,28
13081,Crisp County,2021-04-15,41,6408,28.2
13081,Crisp County,2021-04-16,33,6441,28.4
13081,Crisp County,2021-04-17,3,6444,28.4
13081,Crisp County,2021-04-18,3,6447,28.4
13081,Crisp County,2021-04-19,28,6475,28.5
13081,Crisp County,2021-04-20,32,6507,28.6
13081,Crisp County,2021-04-21,83,6590,29
13081,Crisp County,2021-04-22,23,6613,29.1
13081,Crisp County,2021-04-23,34,6647,29.3
13081,Crisp County,2021-04-24,14,6661,29.3
13081,Crisp County,2021-04-25,3,6664,29.3
13081,Crisp County,2021-04-26,33,6697,29.5
13081,Crisp County,2021-04-27,25,6722,29.6
13081,Crisp County,2021-04-28,26,6748,29.7
13081,Crisp County,2021-04-29,45,6793,29.9
13081,Crisp County,2021-04-30,38,6831,30.1
13081,Crisp County,2021-05-01,2,6833,30.1
13081,Crisp County,2021-05-02,7,6840,30.1
13081,Crisp County,2021-05-03,29,6869,30.2
13081,Crisp County,2021-05-04,37,6906,30.4
13081,Crisp County,2021-05-05,28,6934,30.5
13081,Crisp County,2021-05-06,38,6972,30.7
13081,Crisp County,2021-05-07,43,7015,30.9
13081,Crisp County,2021-05-08,10,7025,30.9
13081,Crisp County,2021-05-09,4,7029,30.9
13081,Crisp County,2021-05-10,18,7047,31
13081,Crisp County,2021-05-11,33,7080,31.2
13081,Crisp County,2021-05-12,26,7106,31.3
13081,Crisp County,2021-05-13,32,7138,31.4
13081,Crisp County,2021-05-14,20,7158,31.5
13081,Crisp County,2021-05-15,13,7171,31.6
13081,Crisp County,2021-05-16,10,7181,31.6
13081,Crisp County,2021-05-17,43,7224,31.8
13081,Crisp County,2021-05-18,45,7269,32
13081,Crisp County,2021-05-19,29,7298,32.1
13081,Crisp County,2021-05-20,48,7346,32.3
13081,Crisp County,2021-05-21,68,7414,32.6
13081,Crisp County,2021-05-22,13,7427,32.7
13081,Crisp County,2021-05-23,6,7433,32.7
13081,Crisp County,2021-05-24,23,7456,32.8
13081,Crisp County,2021-05-25,28,7484,33
13081,Crisp County,2021-05-26,14,7498,33
13081,Crisp County,2021-05-27,28,7526,33.1
13081,Crisp County,2021-05-28,14,7540,33.2
13081,Crisp County,2021-05-29,7,7547,33.2
13081,Crisp County,2021-05-30,7,7554,33.3
13081,Crisp County,2021-05-31,1,7555,33.3
13081,Crisp County,2021-06-01,21,7576,33.4
13081,Crisp County,2021-06-02,15,7591,33.4
13081,Crisp County,2021-06-03,20,7611,33.5
13081,Crisp County,2021-06-04,14,7625,33.6
13081,Crisp County,2021-06-05,2,7627,33.6
13081,Crisp County,2021-06-06,3,7630,33.6
13081,Crisp County,2021-06-07,9,7639,33.6
13081,Crisp County,2021-06-08,19,7658,33.7
13081,Crisp County,2021-06-09,19,7677,33.8
13081,Crisp County,2021-06-10,16,7693,33.9
13081,Crisp County,2021-06-11,16,7709,33.9
13081,Crisp County,2021-06-12,16,7725,34
13081,Crisp County,2021-06-13,2,7727,34
13081,Crisp County,2021-06-14,20,7747,34.1
13081,Crisp County,2021-06-15,13,7760,34.2
13081,Crisp County,2021-06-16,19,7779,34.2
13081,Crisp County,2021-06-17,14,7793,34.3
13081,Crisp County,2021-06-18,17,7810,34.4
13081,Crisp County,2021-06-19,8,7818,34.4
13081,Crisp County,2021-06-21,14,7832,34.5
13081,Crisp County,2021-06-22,16,7848,34.6
13081,Crisp County,2021-06-23,13,7861,34.6
13081,Crisp County,2021-06-24,12,7873,34.7
13081,Crisp County,2021-06-25,21,7894,34.8
13081,Crisp County,2021-06-26,11,7905,34.8
13081,Crisp County,2021-06-27,3,7908,34.8
13081,Crisp County,2021-06-28,12,7920,34.9
13081,Crisp County,2021-06-29,15,7935,34.9
13081,Crisp County,2021-06-30,13,7948,35
13081,Crisp County,2021-07-01,7,7955,35
13081,Crisp County,2021-07-02,12,7967,35.1
13081,Crisp County,2021-07-05,5,7972,35.1
13081,Crisp County,2021-07-06,3,7975,35.1
13081,Crisp County,2021-07-07,13,7988,35.2
13081,Crisp County,2021-07-08,13,8001,35.2
13081,Crisp County,2021-07-09,13,8014,35.3
13081,Crisp County,2021-07-10,4,8018,35.3
13081,Crisp County,2021-07-11,5,8023,35.3
13081,Crisp County,2021-07-12,11,8034,35.4
13081,Crisp County,2021-07-13,17,8051,35.4
13081,Crisp County,2021-07-14,19,8070,35.5
13081,Crisp County,2021-07-15,19,8089,35.6
13081,Crisp County,2021-07-16,21,8110,35.7
13081,Crisp County,2021-07-17,4,8114,35.7
13081,Crisp County,2021-07-18,1,8115,35.7
13081,Crisp County,2021-07-19,18,8133,35.8
13081,Crisp County,2021-07-20,22,8155,35.9
13081,Crisp County,2021-07-21,26,8181,36
13081,Crisp County,2021-07-22,25,8206,36.1
13081,Crisp County,2021-07-23,22,8228,36.2
13081,Crisp County,2021-07-24,14,8242,36.3
13081,Crisp County,2021-07-25,2,8244,36.3
13081,Crisp County,2021-07-26,26,8270,36.4
13081,Crisp County,2021-07-27,49,8319,36.6
13081,Crisp County,2021-07-28,31,8350,36.8
13081,Crisp County,2021-07-29,35,8385,36.9
13081,Crisp County,2021-07-30,44,8429,37.1
13081,Crisp County,2021-07-31,24,8453,37.2
13081,Crisp County,2021-08-01,14,8467,37.3
13081,Crisp County,2021-08-02,48,8515,37.5
13081,Crisp County,2021-08-03,31,8546,37.6
13081,Crisp County,2021-08-04,22,8568,37.7
13081,Crisp County,2021-08-05,52,8620,38
13081,Crisp County,2021-08-06,64,8684,38.2
13081,Crisp County,2021-08-07,21,8705,38.3
13081,Crisp County,2021-08-08,6,8711,38.4
13081,Crisp County,2021-08-09,41,8752,38.5
13081,Crisp County,2021-08-10,41,8793,38.7
13081,Crisp County,2021-08-11,51,8844,38.9
13081,Crisp County,2021-08-12,62,8906,39.2
13081,Crisp County,2021-08-13,69,8975,39.5
13081,Crisp County,2021-08-14,16,8991,39.6
13081,Crisp County,2021-08-15,21,9012,39.7
13081,Crisp County,2021-08-16,66,9078,40
13081,Crisp County,2021-08-17,46,9124,40.2
13081,Crisp County,2021-08-18,34,9158,40.3
13081,Crisp County,2021-08-19,48,9206,40.5
13081,Crisp County,2021-08-20,116,9322,41
13081,Crisp County,2021-08-21,12,9334,41.1
13081,Crisp County,2021-08-22,12,9346,41.1
13081,Crisp County,2021-08-23,41,9387,41.3
13081,Crisp County,2021-08-24,72,9459,41.6
13081,Crisp County,2021-08-25,44,9503,41.8
13081,Crisp County,2021-08-26,51,9554,42.1
13081,Crisp County,2021-08-27,64,9618,42.3
13081,Crisp County,2021-08-28,15,9633,42.4
13081,Crisp County,2021-08-29,8,9641,42.4
13081,Crisp County,2021-08-30,30,9671,42.6
13081,Crisp County,2021-08-31,38,9709,42.7
13081,Crisp County,2021-09-01,29,9738,42.9
13081,Crisp County,2021-09-02,37,9775,43
13081,Crisp County,2021-09-03,41,9816,43.2
13081,Crisp County,2021-09-04,11,9827,43.3
13081,Crisp County,2021-09-05,10,9837,43.3
13081,Crisp County,2021-09-06,7,9844,43.3
13081,Crisp County,2021-09-07,31,9875,43.5
13081,Crisp County,2021-09-08,43,9918,43.7
13081,Crisp County,2021-09-09,26,9944,43.8
13081,Crisp County,2021-09-10,39,9983,44
13081,Crisp County,2021-09-11,21,10004,44
13081,Crisp County,2021-09-12,11,10015,44.1
13081,Crisp County,2021-09-13,27,10042,44.2
13081,Crisp County,2021-09-14,28,10070,44.3
13081,Crisp County,2021-09-15,30,10100,44.5
13081,Crisp County,2021-09-16,21,10121,44.6
13081,Crisp County,2021-09-17,27,10148,44.7
13081,Crisp County,2021-09-18,12,10160,44.7
13081,Crisp County,2021-09-19,8,10168,44.8
13081,Crisp County,2021-09-20,30,10198,44.9
13081,Crisp County,2021-09-21,16,10214,45
13081,Crisp County,2021-09-22,20,10234,45.1
13081,Crisp County,2021-09-23,10,10244,45.1
13081,Crisp County,2021-09-24,15,10259,45.2
13081,Crisp County,2021-09-25,4,10263,45.2
13081,Crisp County,2021-09-26,1,10264,45.2
13081,Crisp County,2021-09-27,9,10273,45.2
13081,Crisp County,2021-09-28,10,10283,45.3
13081,Crisp County,2021-09-29,4,10287,45.3
13081,Crisp County,2021-09-30,13,10300,45.3
13081,Crisp County,2021-10-01,14,10314,45.4
13081,Crisp County,2021-10-02,4,10318,45.4
13081,Crisp County,2021-10-03,3,10321,45.4
13081,Crisp County,2021-10-04,5,10326,45.5
13081,Crisp County,2021-10-05,5,10331,45.5
13081,Crisp County,2021-10-06,7,10338,45.5
13081,Crisp County,2021-10-07,6,10344,45.5
13083,Dade County,2020-12-14,1,1,0
13083,Dade County,2020-12-19,1,2,0
13083,Dade County,2020-12-21,4,6,0
13083,Dade County,2020-12-22,5,11,0.1
13083,Dade County,2020-12-23,8,19,0.1
13083,Dade County,2020-12-24,1,20,0.1
13083,Dade County,2020-12-27,2,22,0.1
13083,Dade County,2020-12-28,2,24,0.1
13083,Dade County,2020-12-29,3,27,0.2
13083,Dade County,2020-12-30,9,36,0.2
13083,Dade County,2020-12-31,9,45,0.3
13083,Dade County,2021-01-01,1,46,0.3
13083,Dade County,2021-01-03,3,49,0.3
13083,Dade County,2021-01-04,13,62,0.4
13083,Dade County,2021-01-05,31,93,0.6
13083,Dade County,2021-01-06,7,100,0.6
13083,Dade County,2021-01-07,20,120,0.7
13083,Dade County,2021-01-08,10,130,0.8
13083,Dade County,2021-01-09,6,136,0.8
13083,Dade County,2021-01-11,104,240,1.5
13083,Dade County,2021-01-12,104,344,2.1
13083,Dade County,2021-01-13,5,349,2.2
13083,Dade County,2021-01-14,137,486,3
13083,Dade County,2021-01-15,78,564,3.5
13083,Dade County,2021-01-16,11,575,3.6
13083,Dade County,2021-01-17,44,619,3.8
13083,Dade County,2021-01-18,8,627,3.9
13083,Dade County,2021-01-19,131,758,4.7
13083,Dade County,2021-01-20,13,771,4.8
13083,Dade County,2021-01-21,165,936,5.8
13083,Dade County,2021-01-22,75,1011,6.2
13083,Dade County,2021-01-23,1,1012,6.2
13083,Dade County,2021-01-25,157,1169,7.2
13083,Dade County,2021-01-26,150,1319,8.1
13083,Dade County,2021-01-27,98,1417,8.7
13083,Dade County,2021-01-28,135,1552,9.6
13083,Dade County,2021-01-29,62,1614,10
13083,Dade County,2021-02-01,85,1699,10.5
13083,Dade County,2021-02-02,77,1776,11
13083,Dade County,2021-02-03,3,1779,11
13083,Dade County,2021-02-04,113,1892,11.7
13083,Dade County,2021-02-05,38,1930,11.9
13083,Dade County,2021-02-07,3,1933,11.9
13083,Dade County,2021-02-08,8,1941,12
13083,Dade County,2021-02-09,14,1955,12.1
13083,Dade County,2021-02-10,28,1983,12.2
13083,Dade County,2021-02-11,10,1993,12.3
13083,Dade County,2021-02-12,16,2009,12.4
13083,Dade County,2021-02-15,39,2048,12.6
13083,Dade County,2021-02-17,8,2056,12.7
13083,Dade County,2021-02-18,24,2080,12.8
13083,Dade County,2021-02-19,15,2095,12.9
13083,Dade County,2021-02-22,5,2100,13
13083,Dade County,2021-02-23,14,2114,13.1
13083,Dade County,2021-02-24,7,2121,13.1
13083,Dade County,2021-02-25,10,2131,13.2
13083,Dade County,2021-02-26,4,2135,13.2
13083,Dade County,2021-02-27,1,2136,13.2
13083,Dade County,2021-02-28,2,2138,13.2
13083,Dade County,2021-03-01,16,2154,13.3
13083,Dade County,2021-03-02,27,2181,13.5
13083,Dade County,2021-03-03,39,2220,13.7
13083,Dade County,2021-03-04,27,2247,13.9
13083,Dade County,2021-03-05,16,2263,14
13083,Dade County,2021-03-06,1,2264,14
13083,Dade County,2021-03-07,2,2266,14
13083,Dade County,2021-03-08,52,2318,14.3
13083,Dade County,2021-03-09,47,2365,14.6
13083,Dade County,2021-03-10,40,2405,14.8
13083,Dade County,2021-03-11,59,2464,15.2
13083,Dade County,2021-03-12,63,2527,15.6
13083,Dade County,2021-03-14,1,2528,15.6
13083,Dade County,2021-03-15,92,2620,16.2
13083,Dade County,2021-03-16,130,2750,17
13083,Dade County,2021-03-17,119,2869,17.7
13083,Dade County,2021-03-18,78,2947,18.2
13083,Dade County,2021-03-19,68,3015,18.6
13083,Dade County,2021-03-20,2,3017,18.6
13083,Dade County,2021-03-21,1,3018,18.6
13083,Dade County,2021-03-22,20,3038,18.8
13083,Dade County,2021-03-23,75,3113,19.2
13083,Dade County,2021-03-24,44,3157,19.5
13083,Dade County,2021-03-25,80,3237,20
13083,Dade County,2021-03-26,92,3329,20.6
13083,Dade County,2021-03-27,3,3332,20.6
13083,Dade County,2021-03-29,69,3401,21
13083,Dade County,2021-03-30,38,3439,21.2
13083,Dade County,2021-03-31,72,3511,21.7
13083,Dade County,2021-04-01,50,3561,22
13083,Dade County,2021-04-02,65,3626,22.4
13083,Dade County,2021-04-03,2,3628,22.4
13083,Dade County,2021-04-05,29,3657,22.6
13083,Dade County,2021-04-06,19,3676,22.7
13083,Dade County,2021-04-07,72,3748,23.1
13083,Dade County,2021-04-08,39,3787,23.4
13083,Dade County,2021-04-09,38,3825,23.6
13083,Dade County,2021-04-10,5,3830,23.6
13083,Dade County,2021-04-11,2,3832,23.7
13083,Dade County,2021-04-12,17,3849,23.8
13083,Dade County,2021-04-13,16,3865,23.9
13083,Dade County,2021-04-14,25,3890,24
13083,Dade County,2021-04-15,24,3914,24.2
13083,Dade County,2021-04-16,15,3929,24.3
13083,Dade County,2021-04-17,3,3932,24.3
13083,Dade County,2021-04-19,26,3958,24.4
13083,Dade County,2021-04-20,9,3967,24.5
13083,Dade County,2021-04-21,25,3992,24.6
13083,Dade County,2021-04-22,12,4004,24.7
13083,Dade County,2021-04-23,18,4022,24.8
13083,Dade County,2021-04-24,4,4026,24.9
13083,Dade County,2021-04-26,10,4036,24.9
13083,Dade County,2021-04-27,14,4050,25
13083,Dade County,2021-04-28,15,4065,25.1
13083,Dade County,2021-04-29,12,4077,25.2
13083,Dade County,2021-04-30,17,4094,25.3
13083,Dade County,2021-05-01,2,4096,25.3
13083,Dade County,2021-05-02,1,4097,25.3
13083,Dade County,2021-05-03,10,4107,25.4
13083,Dade County,2021-05-04,12,4119,25.4
13083,Dade County,2021-05-05,21,4140,25.6
13083,Dade County,2021-05-06,20,4160,25.7
13083,Dade County,2021-05-07,11,4171,25.8
13083,Dade County,2021-05-08,2,4173,25.8
13083,Dade County,2021-05-09,1,4174,25.8
13083,Dade County,2021-05-10,3,4177,25.8
13083,Dade County,2021-05-11,15,4192,25.9
13083,Dade County,2021-05-12,11,4203,25.9
13083,Dade County,2021-05-13,8,4211,26
13083,Dade County,2021-05-14,21,4232,26.1
13083,Dade County,2021-05-15,2,4234,26.1
13083,Dade County,2021-05-16,6,4240,26.2
13083,Dade County,2021-05-17,7,4247,26.2
13083,Dade County,2021-05-18,11,4258,26.3
13083,Dade County,2021-05-19,12,4270,26.4
13083,Dade County,2021-05-20,14,4284,26.4
13083,Dade County,2021-05-21,11,4295,26.5
13083,Dade County,2021-05-22,7,4302,26.6
13083,Dade County,2021-05-23,2,4304,26.6
13083,Dade County,2021-05-24,7,4311,26.6
13083,Dade County,2021-05-25,10,4321,26.7
13083,Dade County,2021-05-26,7,4328,26.7
13083,Dade County,2021-05-27,5,4333,26.8
13083,Dade County,2021-05-28,3,4336,26.8
13083,Dade County,2021-05-29,1,4337,26.8
13083,Dade County,2021-05-31,1,4338,26.8
13083,Dade County,2021-06-01,15,4353,26.9
13083,Dade County,2021-06-02,13,4366,27
13083,Dade County,2021-06-03,5,4371,27
13083,Dade County,2021-06-04,7,4378,27
13083,Dade County,2021-06-05,2,4380,27
13083,Dade County,2021-06-07,5,4385,27.1
13083,Dade County,2021-06-08,9,4394,27.1
13083,Dade County,2021-06-09,1,4395,27.1
13083,Dade County,2021-06-10,6,4401,27.2
13083,Dade County,2021-06-11,4,4405,27.2
13083,Dade County,2021-06-12,1,4406,27.2
13083,Dade County,2021-06-13,1,4407,27.2
13083,Dade County,2021-06-14,8,4415,27.3
13083,Dade County,2021-06-16,4,4419,27.3
13083,Dade County,2021-06-17,8,4427,27.3
13083,Dade County,2021-06-18,4,4431,27.4
13083,Dade County,2021-06-21,4,4435,27.4
13083,Dade County,2021-06-22,3,4438,27.4
13083,Dade County,2021-06-23,6,4444,27.4
13083,Dade County,2021-06-24,5,4449,27.5
13083,Dade County,2021-06-25,9,4458,27.5
13083,Dade County,2021-06-27,3,4461,27.5
13083,Dade County,2021-06-28,1,4462,27.5
13083,Dade County,2021-06-29,2,4464,27.6
13083,Dade County,2021-06-30,3,4467,27.6
13083,Dade County,2021-07-01,4,4471,27.6
13083,Dade County,2021-07-02,10,4481,27.7
13083,Dade County,2021-07-03,3,4484,27.7
13083,Dade County,2021-07-05,1,4485,27.7
13083,Dade County,2021-07-06,3,4488,27.7
13083,Dade County,2021-07-07,12,4500,27.8
13083,Dade County,2021-07-08,8,4508,27.8
13083,Dade County,2021-07-09,11,4519,27.9
13083,Dade County,2021-07-10,1,4520,27.9
13083,Dade County,2021-07-11,2,4522,27.9
13083,Dade County,2021-07-12,2,4524,27.9
13083,Dade County,2021-07-13,2,4526,27.9
13083,Dade County,2021-07-14,3,4529,28
13083,Dade County,2021-07-15,8,4537,28
13083,Dade County,2021-07-16,14,4551,28.1
13083,Dade County,2021-07-17,3,4554,28.1
13083,Dade County,2021-07-18,2,4556,28.1
13083,Dade County,2021-07-19,12,4568,28.2
13083,Dade County,2021-07-20,8,4576,28.3
13083,Dade County,2021-07-21,11,4587,28.3
13083,Dade County,2021-07-22,13,4600,28.4
13083,Dade County,2021-07-23,14,4614,28.5
13083,Dade County,2021-07-24,12,4626,28.6
13083,Dade County,2021-07-25,5,4631,28.6
13083,Dade County,2021-07-26,15,4646,28.7
13083,Dade County,2021-07-27,18,4664,28.8
13083,Dade County,2021-07-28,15,4679,28.9
13083,Dade County,2021-07-29,21,4700,29
13083,Dade County,2021-07-30,27,4727,29.2
13083,Dade County,2021-08-01,2,4729,29.2
13083,Dade County,2021-08-02,14,4743,29.3
13083,Dade County,2021-08-03,23,4766,29.4
13083,Dade County,2021-08-04,18,4784,29.5
13083,Dade County,2021-08-05,14,4798,29.6
13083,Dade County,2021-08-06,14,4812,29.7
13083,Dade County,2021-08-07,11,4823,29.8
13083,Dade County,2021-08-08,6,4829,29.8
13083,Dade County,2021-08-09,14,4843,29.9
13083,Dade County,2021-08-10,6,4849,29.9
13083,Dade County,2021-08-11,18,4867,30
13083,Dade County,2021-08-12,37,4904,30.3
13083,Dade County,2021-08-13,17,4921,30.4
13083,Dade County,2021-08-14,12,4933,30.5
13083,Dade County,2021-08-15,1,4934,30.5
13083,Dade County,2021-08-16,23,4957,30.6
13083,Dade County,2021-08-17,28,4985,30.8
13083,Dade County,2021-08-18,27,5012,30.9
13083,Dade County,2021-08-19,36,5048,31.2
13083,Dade County,2021-08-20,28,5076,31.3
13083,Dade County,2021-08-21,12,5088,31.4
13083,Dade County,2021-08-22,8,5096,31.5
13083,Dade County,2021-08-23,22,5118,31.6
13083,Dade County,2021-08-24,21,5139,31.7
13083,Dade County,2021-08-25,35,5174,31.9
13083,Dade County,2021-08-26,26,5200,32.1
13083,Dade County,2021-08-27,20,5220,32.2
13083,Dade County,2021-08-28,8,5228,32.3
13083,Dade County,2021-08-29,5,5233,32.3
13083,Dade County,2021-08-30,26,5259,32.5
13083,Dade County,2021-08-31,23,5282,32.6
13083,Dade County,2021-09-01,22,5304,32.7
13083,Dade County,2021-09-02,30,5334,32.9
13083,Dade County,2021-09-03,31,5365,33.1
13083,Dade County,2021-09-04,5,5370,33.2
13083,Dade County,2021-09-05,6,5376,33.2
13083,Dade County,2021-09-06,3,5379,33.2
13083,Dade County,2021-09-07,13,5392,33.3
13083,Dade County,2021-09-08,13,5405,33.4
13083,Dade County,2021-09-09,12,5417,33.4
13083,Dade County,2021-09-10,23,5440,33.6
13083,Dade County,2021-09-11,5,5445,33.6
13083,Dade County,2021-09-12,1,5446,33.6
13083,Dade County,2021-09-13,12,5458,33.7
13083,Dade County,2021-09-14,13,5471,33.8
13083,Dade County,2021-09-15,6,5477,33.8
13083,Dade County,2021-09-16,7,5484,33.9
13083,Dade County,2021-09-17,15,5499,34
13083,Dade County,2021-09-18,4,5503,34
13083,Dade County,2021-09-19,4,5507,34
13083,Dade County,2021-09-20,6,5513,34
13083,Dade County,2021-09-21,3,5516,34.1
13083,Dade County,2021-09-22,6,5522,34.1
13083,Dade County,2021-09-23,2,5524,34.1
13083,Dade County,2021-09-24,5,5529,34.1
13083,Dade County,2021-09-25,2,5531,34.1
13083,Dade County,2021-09-27,2,5533,34.2
13083,Dade County,2021-09-28,2,5535,34.2
13083,Dade County,2021-09-30,5,5540,34.2
13083,Dade County,2021-10-01,6,5546,34.2
13083,Dade County,2021-10-02,3,5549,34.3
13083,Dade County,2021-10-04,1,5550,34.3
13083,Dade County,2021-10-05,1,5551,34.3
13083,Dade County,2021-10-06,5,5556,34.3
13083,Dade County,2021-10-07,3,5559,34.3
13085,Dawson County,2020-12-17,1,1,0
13085,Dawson County,2020-12-18,6,7,0
13085,Dawson County,2020-12-19,6,13,0.1
13085,Dawson County,2020-12-20,7,20,0.1
13085,Dawson County,2020-12-21,10,30,0.1
13085,Dawson County,2020-12-22,13,43,0.2
13085,Dawson County,2020-12-23,12,55,0.2
13085,Dawson County,2020-12-24,2,57,0.2
13085,Dawson County,2020-12-26,3,60,0.2
13085,Dawson County,2020-12-27,5,65,0.3
13085,Dawson County,2020-12-28,27,92,0.4
13085,Dawson County,2020-12-29,37,129,0.5
13085,Dawson County,2020-12-30,30,159,0.6
13085,Dawson County,2020-12-31,9,168,0.7
13085,Dawson County,2021-01-01,21,189,0.8
13085,Dawson County,2021-01-02,3,192,0.8
13085,Dawson County,2021-01-03,4,196,0.8
13085,Dawson County,2021-01-04,45,241,1
13085,Dawson County,2021-01-05,34,275,1.1
13085,Dawson County,2021-01-06,54,329,1.3
13085,Dawson County,2021-01-07,39,368,1.5
13085,Dawson County,2021-01-08,24,392,1.6
13085,Dawson County,2021-01-09,4,396,1.6
13085,Dawson County,2021-01-10,8,404,1.6
13085,Dawson County,2021-01-11,68,472,1.9
13085,Dawson County,2021-01-12,61,533,2.2
13085,Dawson County,2021-01-13,65,598,2.4
13085,Dawson County,2021-01-14,94,692,2.8
13085,Dawson County,2021-01-15,58,750,3.1
13085,Dawson County,2021-01-16,46,796,3.2
13085,Dawson County,2021-01-17,18,814,3.3
13085,Dawson County,2021-01-18,113,927,3.8
13085,Dawson County,2021-01-19,79,1006,4.1
13085,Dawson County,2021-01-20,99,1105,4.5
13085,Dawson County,2021-01-21,616,1721,7
13085,Dawson County,2021-01-22,116,1837,7.5
13085,Dawson County,2021-01-23,32,1869,7.6
13085,Dawson County,2021-01-24,15,1884,7.7
13085,Dawson County,2021-01-25,59,1943,7.9
13085,Dawson County,2021-01-26,70,2013,8.2
13085,Dawson County,2021-01-27,106,2119,8.6
13085,Dawson County,2021-01-28,57,2176,8.9
13085,Dawson County,2021-01-29,46,2222,9.1
13085,Dawson County,2021-01-30,37,2259,9.2
13085,Dawson County,2021-01-31,2,2261,9.2
13085,Dawson County,2021-02-01,38,2299,9.4
13085,Dawson County,2021-02-02,50,2349,9.6
13085,Dawson County,2021-02-03,39,2388,9.7
13085,Dawson County,2021-02-04,78,2466,10.1
13085,Dawson County,2021-02-05,38,2504,10.2
13085,Dawson County,2021-02-06,12,2516,10.3
13085,Dawson County,2021-02-07,3,2519,10.3
13085,Dawson County,2021-02-08,56,2575,10.5
13085,Dawson County,2021-02-09,57,2632,10.7
13085,Dawson County,2021-02-10,74,2706,11
13085,Dawson County,2021-02-11,31,2737,11.2
13085,Dawson County,2021-02-12,27,2764,11.3
13085,Dawson County,2021-02-13,12,2776,11.3
13085,Dawson County,2021-02-14,1,2777,11.3
13085,Dawson County,2021-02-15,26,2803,11.4
13085,Dawson County,2021-02-16,31,2834,11.6
13085,Dawson County,2021-02-17,35,2869,11.7
13085,Dawson County,2021-02-18,31,2900,11.8
13085,Dawson County,2021-02-19,18,2918,11.9
13085,Dawson County,2021-02-20,4,2922,11.9
13085,Dawson County,2021-02-21,8,2930,11.9
13085,Dawson County,2021-02-22,45,2975,12.1
13085,Dawson County,2021-02-23,40,3015,12.3
13085,Dawson County,2021-02-24,33,3048,12.4
13085,Dawson County,2021-02-25,42,3090,12.6
13085,Dawson County,2021-02-26,53,3143,12.8
13085,Dawson County,2021-02-27,9,3152,12.8
13085,Dawson County,2021-02-28,28,3180,13
13085,Dawson County,2021-03-01,57,3237,13.2
13085,Dawson County,2021-03-02,36,3273,13.3
13085,Dawson County,2021-03-03,92,3365,13.7
13085,Dawson County,2021-03-04,115,3480,14.2
13085,Dawson County,2021-03-05,68,3548,14.5
13085,Dawson County,2021-03-06,4,3552,14.5
13085,Dawson County,2021-03-07,16,3568,14.5
13085,Dawson County,2021-03-08,96,3664,14.9
13085,Dawson County,2021-03-09,96,3760,15.3
13085,Dawson County,2021-03-10,108,3868,15.8
13085,Dawson County,2021-03-11,97,3965,16.2
13085,Dawson County,2021-03-12,120,4085,16.6
13085,Dawson County,2021-03-13,91,4176,17
13085,Dawson County,2021-03-14,15,4191,17.1
13085,Dawson County,2021-03-15,124,4315,17.6
13085,Dawson County,2021-03-16,124,4439,18.1
13085,Dawson County,2021-03-17,118,4557,18.6
13085,Dawson County,2021-03-18,123,4680,19.1
13085,Dawson County,2021-03-19,161,4841,19.7
13085,Dawson County,2021-03-20,27,4868,19.8
13085,Dawson County,2021-03-21,17,4885,19.9
13085,Dawson County,2021-03-22,93,4978,20.3
13085,Dawson County,2021-03-23,137,5115,20.8
13085,Dawson County,2021-03-24,103,5218,21.3
13085,Dawson County,2021-03-25,152,5370,21.9
13085,Dawson County,2021-03-26,126,5496,22.4
13085,Dawson County,2021-03-27,24,5520,22.5
13085,Dawson County,2021-03-28,9,5529,22.5
13085,Dawson County,2021-03-29,77,5606,22.8
13085,Dawson County,2021-03-30,125,5731,23.4
13085,Dawson County,2021-03-31,115,5846,23.8
13085,Dawson County,2021-04-01,124,5970,24.3
13085,Dawson County,2021-04-02,64,6034,24.6
13085,Dawson County,2021-04-03,26,6060,24.7
13085,Dawson County,2021-04-04,17,6077,24.8
13085,Dawson County,2021-04-05,117,6194,25.2
13085,Dawson County,2021-04-06,102,6296,25.7
13085,Dawson County,2021-04-07,107,6403,26.1
13085,Dawson County,2021-04-08,80,6483,26.4
13085,Dawson County,2021-04-09,86,6569,26.8
13085,Dawson County,2021-04-10,27,6596,26.9
13085,Dawson County,2021-04-11,26,6622,27
13085,Dawson County,2021-04-12,72,6694,27.3
13085,Dawson County,2021-04-13,47,6741,27.5
13085,Dawson County,2021-04-14,49,6790,27.7
13085,Dawson County,2021-04-15,71,6861,28
13085,Dawson County,2021-04-16,31,6892,28.1
13085,Dawson County,2021-04-17,16,6908,28.2
13085,Dawson County,2021-04-18,7,6915,28.2
13085,Dawson County,2021-04-19,26,6941,28.3
13085,Dawson County,2021-04-20,61,7002,28.5
13085,Dawson County,2021-04-21,45,7047,28.7
13085,Dawson County,2021-04-22,53,7100,28.9
13085,Dawson County,2021-04-23,46,7146,29.1
13085,Dawson County,2021-04-24,14,7160,29.2
13085,Dawson County,2021-04-25,9,7169,29.2
13085,Dawson County,2021-04-26,25,7194,29.3
13085,Dawson County,2021-04-27,55,7249,29.5
13085,Dawson County,2021-04-28,46,7295,29.7
13085,Dawson County,2021-04-29,66,7361,30
13085,Dawson County,2021-04-30,57,7418,30.2
13085,Dawson County,2021-05-01,14,7432,30.3
13085,Dawson County,2021-05-02,12,7444,30.3
13085,Dawson County,2021-05-03,29,7473,30.5
13085,Dawson County,2021-05-04,50,7523,30.7
13085,Dawson County,2021-05-05,44,7567,30.8
13085,Dawson County,2021-05-06,51,7618,31
13085,Dawson County,2021-05-07,56,7674,31.3
13085,Dawson County,2021-05-08,18,7692,31.3
13085,Dawson County,2021-05-09,11,7703,31.4
13085,Dawson County,2021-05-10,24,7727,31.5
13085,Dawson County,2021-05-11,37,7764,31.6
13085,Dawson County,2021-05-12,17,7781,31.7
13085,Dawson County,2021-05-13,37,7818,31.9
13085,Dawson County,2021-05-14,36,7854,32
13085,Dawson County,2021-05-15,14,7868,32.1
13085,Dawson County,2021-05-16,17,7885,32.1
13085,Dawson County,2021-05-17,38,7923,32.3
13085,Dawson County,2021-05-18,41,7964,32.5
13085,Dawson County,2021-05-19,36,8000,32.6
13085,Dawson County,2021-05-20,48,8048,32.8
13085,Dawson County,2021-05-21,45,8093,33
13085,Dawson County,2021-05-22,19,8112,33.1
13085,Dawson County,2021-05-23,12,8124,33.1
13085,Dawson County,2021-05-24,28,8152,33.2
13085,Dawson County,2021-05-25,24,8176,33.3
13085,Dawson County,2021-05-26,34,8210,33.5
13085,Dawson County,2021-05-27,21,8231,33.5
13085,Dawson County,2021-05-28,23,8254,33.6
13085,Dawson County,2021-05-29,16,8270,33.7
13085,Dawson County,2021-05-30,6,8276,33.7
13085,Dawson County,2021-05-31,7,8283,33.8
13085,Dawson County,2021-06-01,29,8312,33.9
13085,Dawson County,2021-06-02,23,8335,34
13085,Dawson County,2021-06-03,19,8354,34
13085,Dawson County,2021-06-04,23,8377,34.1
13085,Dawson County,2021-06-05,12,8389,34.2
13085,Dawson County,2021-06-06,7,8396,34.2
13085,Dawson County,2021-06-07,18,8414,34.3
13085,Dawson County,2021-06-08,12,8426,34.3
13085,Dawson County,2021-06-09,22,8448,34.4
13085,Dawson County,2021-06-10,22,8470,34.5
13085,Dawson County,2021-06-11,17,8487,34.6
13085,Dawson County,2021-06-12,4,8491,34.6
13085,Dawson County,2021-06-13,3,8494,34.6
13085,Dawson County,2021-06-14,15,8509,34.7
13085,Dawson County,2021-06-15,12,8521,34.7
13085,Dawson County,2021-06-16,13,8534,34.8
13085,Dawson County,2021-06-17,20,8554,34.9
13085,Dawson County,2021-06-18,11,8565,34.9
13085,Dawson County,2021-06-19,8,8573,34.9
13085,Dawson County,2021-06-20,2,8575,34.9
13085,Dawson County,2021-06-21,21,8596,35
13085,Dawson County,2021-06-22,15,8611,35.1
13085,Dawson County,2021-06-23,12,8623,35.1
13085,Dawson County,2021-06-24,9,8632,35.2
13085,Dawson County,2021-06-25,9,8641,35.2
13085,Dawson County,2021-06-26,4,8645,35.2
13085,Dawson County,2021-06-27,7,8652,35.3
13085,Dawson County,2021-06-28,12,8664,35.3
13085,Dawson County,2021-06-29,9,8673,35.3
13085,Dawson County,2021-06-30,8,8681,35.4
13085,Dawson County,2021-07-01,11,8692,35.4
13085,Dawson County,2021-07-02,15,8707,35.5
13085,Dawson County,2021-07-03,11,8718,35.5
13085,Dawson County,2021-07-05,5,8723,35.6
13085,Dawson County,2021-07-06,10,8733,35.6
13085,Dawson County,2021-07-07,12,8745,35.6
13085,Dawson County,2021-07-08,10,8755,35.7
13085,Dawson County,2021-07-09,26,8781,35.8
13085,Dawson County,2021-07-10,9,8790,35.8
13085,Dawson County,2021-07-11,6,8796,35.8
13085,Dawson County,2021-07-12,10,8806,35.9
13085,Dawson County,2021-07-13,7,8813,35.9
13085,Dawson County,2021-07-14,10,8823,36
13085,Dawson County,2021-07-15,8,8831,36
13085,Dawson County,2021-07-16,18,8849,36.1
13085,Dawson County,2021-07-17,7,8856,36.1
13085,Dawson County,2021-07-18,4,8860,36.1
13085,Dawson County,2021-07-19,11,8871,36.2
13085,Dawson County,2021-07-20,17,8888,36.2
13085,Dawson County,2021-07-21,17,8905,36.3
13085,Dawson County,2021-07-22,17,8922,36.4
13085,Dawson County,2021-07-23,30,8952,36.5
13085,Dawson County,2021-07-24,24,8976,36.6
13085,Dawson County,2021-07-25,14,8990,36.6
13085,Dawson County,2021-07-26,19,9009,36.7
13085,Dawson County,2021-07-27,18,9027,36.8
13085,Dawson County,2021-07-28,27,9054,36.9
13085,Dawson County,2021-07-29,23,9077,37
13085,Dawson County,2021-07-30,30,9107,37.1
13085,Dawson County,2021-07-31,19,9126,37.2
13085,Dawson County,2021-08-01,14,9140,37.3
13085,Dawson County,2021-08-02,33,9173,37.4
13085,Dawson County,2021-08-03,32,9205,37.5
13085,Dawson County,2021-08-04,31,9236,37.6
13085,Dawson County,2021-08-05,34,9270,37.8
13085,Dawson County,2021-08-06,45,9315,38
13085,Dawson County,2021-08-07,26,9341,38.1
13085,Dawson County,2021-08-08,15,9356,38.1
13085,Dawson County,2021-08-09,33,9389,38.3
13085,Dawson County,2021-08-10,28,9417,38.4
13085,Dawson County,2021-08-11,31,9448,38.5
13085,Dawson County,2021-08-12,38,9486,38.7
13085,Dawson County,2021-08-13,58,9544,38.9
13085,Dawson County,2021-08-14,23,9567,39
13085,Dawson County,2021-08-15,10,9577,39
13085,Dawson County,2021-08-16,32,9609,39.2
13085,Dawson County,2021-08-17,29,9638,39.3
13085,Dawson County,2021-08-18,47,9685,39.5
13085,Dawson County,2021-08-19,33,9718,39.6
13085,Dawson County,2021-08-20,56,9774,39.8
13085,Dawson County,2021-08-21,27,9801,39.9
13085,Dawson County,2021-08-22,15,9816,40
13085,Dawson County,2021-08-23,37,9853,40.2
13085,Dawson County,2021-08-24,36,9889,40.3
13085,Dawson County,2021-08-25,29,9918,40.4
13085,Dawson County,2021-08-26,49,9967,40.6
13085,Dawson County,2021-08-27,46,10013,40.8
13085,Dawson County,2021-08-28,25,10038,40.9
13085,Dawson County,2021-08-29,17,10055,41
13085,Dawson County,2021-08-30,31,10086,41.1
13085,Dawson County,2021-08-31,41,10127,41.3
13085,Dawson County,2021-09-01,43,10170,41.4
13085,Dawson County,2021-09-02,45,10215,41.6
13085,Dawson County,2021-09-03,44,10259,41.8
13085,Dawson County,2021-09-04,11,10270,41.9
13085,Dawson County,2021-09-05,14,10284,41.9
13085,Dawson County,2021-09-06,12,10296,42
13085,Dawson County,2021-09-07,25,10321,42.1
13085,Dawson County,2021-09-08,25,10346,42.2
13085,Dawson County,2021-09-09,36,10382,42.3
13085,Dawson County,2021-09-10,37,10419,42.5
13085,Dawson County,2021-09-11,17,10436,42.5
13085,Dawson County,2021-09-12,15,10451,42.6
13085,Dawson County,2021-09-13,19,10470,42.7
13085,Dawson County,2021-09-14,23,10493,42.8
13085,Dawson County,2021-09-15,26,10519,42.9
13085,Dawson County,2021-09-16,15,10534,42.9
13085,Dawson County,2021-09-17,30,10564,43.1
13085,Dawson County,2021-09-18,6,10570,43.1
13085,Dawson County,2021-09-19,8,10578,43.1
13085,Dawson County,2021-09-20,12,10590,43.2
13085,Dawson County,2021-09-21,8,10598,43.2
13085,Dawson County,2021-09-22,14,10612,43.3
13085,Dawson County,2021-09-23,10,10622,43.3
13085,Dawson County,2021-09-24,17,10639,43.4
13085,Dawson County,2021-09-25,3,10642,43.4
13085,Dawson County,2021-09-26,3,10645,43.4
13085,Dawson County,2021-09-27,6,10651,43.4
13085,Dawson County,2021-09-28,14,10665,43.5
13085,Dawson County,2021-09-29,12,10677,43.5
13085,Dawson County,2021-09-30,6,10683,43.5
13085,Dawson County,2021-10-01,8,10691,43.6
13085,Dawson County,2021-10-02,4,10695,43.6
13085,Dawson County,2021-10-03,2,10697,43.6
13085,Dawson County,2021-10-04,4,10701,43.6
13085,Dawson County,2021-10-05,9,10710,43.7
13085,Dawson County,2021-10-06,7,10717,43.7
13085,Dawson County,2021-10-07,5,10722,43.7
13087,Decatur County,2020-12-18,2,2,0
13087,Decatur County,2020-12-19,3,5,0
13087,Decatur County,2020-12-20,1,6,0
13087,Decatur County,2020-12-21,6,12,0
13087,Decatur County,2020-12-22,2,14,0.1
13087,Decatur County,2020-12-23,45,59,0.2
13087,Decatur County,2020-12-24,4,63,0.2
13087,Decatur County,2020-12-26,1,64,0.2
13087,Decatur County,2020-12-27,3,67,0.3
13087,Decatur County,2020-12-28,38,105,0.4
13087,Decatur County,2020-12-29,38,143,0.5
13087,Decatur County,2020-12-30,42,185,0.7
13087,Decatur County,2020-12-31,15,200,0.7
13087,Decatur County,2021-01-03,1,201,0.8
13087,Decatur County,2021-01-04,43,244,0.9
13087,Decatur County,2021-01-05,52,296,1.1
13087,Decatur County,2021-01-06,65,361,1.4
13087,Decatur County,2021-01-07,117,478,1.8
13087,Decatur County,2021-01-08,25,503,1.9
13087,Decatur County,2021-01-09,2,505,1.9
13087,Decatur County,2021-01-10,1,506,1.9
13087,Decatur County,2021-01-11,112,618,2.3
13087,Decatur County,2021-01-12,161,779,2.9
13087,Decatur County,2021-01-13,131,910,3.4
13087,Decatur County,2021-01-14,226,1136,4.3
13087,Decatur County,2021-01-15,129,1265,4.7
13087,Decatur County,2021-01-16,11,1276,4.8
13087,Decatur County,2021-01-17,3,1279,4.8
13087,Decatur County,2021-01-18,143,1422,5.3
13087,Decatur County,2021-01-19,127,1549,5.8
13087,Decatur County,2021-01-20,153,1702,6.4
13087,Decatur County,2021-01-21,157,1859,7
13087,Decatur County,2021-01-22,128,1987,7.4
13087,Decatur County,2021-01-23,5,1992,7.5
13087,Decatur County,2021-01-25,117,2109,7.9
13087,Decatur County,2021-01-26,131,2240,8.4
13087,Decatur County,2021-01-27,118,2358,8.8
13087,Decatur County,2021-01-28,152,2510,9.4
13087,Decatur County,2021-01-29,57,2567,9.6
13087,Decatur County,2021-01-30,2,2569,9.6
13087,Decatur County,2021-02-01,94,2663,10
13087,Decatur County,2021-02-02,89,2752,10.3
13087,Decatur County,2021-02-03,112,2864,10.7
13087,Decatur County,2021-02-04,106,2970,11.1
13087,Decatur County,2021-02-05,66,3036,11.4
13087,Decatur County,2021-02-06,3,3039,11.4
13087,Decatur County,2021-02-07,2,3041,11.4
13087,Decatur County,2021-02-08,37,3078,11.5
13087,Decatur County,2021-02-09,135,3213,12
13087,Decatur County,2021-02-10,35,3248,12.2
13087,Decatur County,2021-02-11,41,3289,12.3
13087,Decatur County,2021-02-12,31,3320,12.4
13087,Decatur County,2021-02-13,27,3347,12.5
13087,Decatur County,2021-02-14,7,3354,12.6
13087,Decatur County,2021-02-15,56,3410,12.8
13087,Decatur County,2021-02-16,76,3486,13.1
13087,Decatur County,2021-02-17,50,3536,13.3
13087,Decatur County,2021-02-18,62,3598,13.5
13087,Decatur County,2021-02-19,11,3609,13.5
13087,Decatur County,2021-02-20,2,3611,13.5
13087,Decatur County,2021-02-22,10,3621,13.6
13087,Decatur County,2021-02-23,23,3644,13.7
13087,Decatur County,2021-02-24,22,3666,13.7
13087,Decatur County,2021-02-25,54,3720,13.9
13087,Decatur County,2021-02-26,64,3784,14.2
13087,Decatur County,2021-02-27,28,3812,14.3
13087,Decatur County,2021-02-28,11,3823,14.3
13087,Decatur County,2021-03-01,58,3881,14.5
13087,Decatur County,2021-03-02,36,3917,14.7
13087,Decatur County,2021-03-03,69,3986,14.9
13087,Decatur County,2021-03-04,56,4042,15.1
13087,Decatur County,2021-03-05,40,4082,15.3
13087,Decatur County,2021-03-06,11,4093,15.3
13087,Decatur County,2021-03-07,7,4100,15.4
13087,Decatur County,2021-03-08,71,4171,15.6
13087,Decatur County,2021-03-09,82,4253,15.9
13087,Decatur County,2021-03-10,90,4343,16.3
13087,Decatur County,2021-03-11,116,4459,16.7
13087,Decatur County,2021-03-12,214,4673,17.5
13087,Decatur County,2021-03-13,7,4680,17.5
13087,Decatur County,2021-03-14,8,4688,17.6
13087,Decatur County,2021-03-15,150,4838,18.1
13087,Decatur County,2021-03-16,111,4949,18.5
13087,Decatur County,2021-03-17,145,5094,19.1
13087,Decatur County,2021-03-18,103,5197,19.5
13087,Decatur County,2021-03-19,47,5244,19.7
13087,Decatur County,2021-03-20,10,5254,19.7
13087,Decatur County,2021-03-21,14,5268,19.7
13087,Decatur County,2021-03-22,150,5418,20.3
13087,Decatur County,2021-03-23,69,5487,20.6
13087,Decatur County,2021-03-24,54,5541,20.8
13087,Decatur County,2021-03-25,206,5747,21.5
13087,Decatur County,2021-03-26,49,5796,21.7
13087,Decatur County,2021-03-27,15,5811,21.8
13087,Decatur County,2021-03-28,10,5821,21.8
13087,Decatur County,2021-03-29,143,5964,22.4
13087,Decatur County,2021-03-30,179,6143,23
13087,Decatur County,2021-03-31,127,6270,23.5
13087,Decatur County,2021-04-01,168,6438,24.1
13087,Decatur County,2021-04-02,59,6497,24.3
13087,Decatur County,2021-04-03,12,6509,24.4
13087,Decatur County,2021-04-04,7,6516,24.4
13087,Decatur County,2021-04-05,84,6600,24.7
13087,Decatur County,2021-04-06,88,6688,25.1
13087,Decatur County,2021-04-07,67,6755,25.3
13087,Decatur County,2021-04-08,121,6876,25.8
13087,Decatur County,2021-04-09,30,6906,25.9
13087,Decatur County,2021-04-10,13,6919,25.9
13087,Decatur County,2021-04-11,17,6936,26
13087,Decatur County,2021-04-12,89,7025,26.3
13087,Decatur County,2021-04-13,60,7085,26.6
13087,Decatur County,2021-04-14,106,7191,27
13087,Decatur County,2021-04-15,69,7260,27.2
13087,Decatur County,2021-04-16,28,7288,27.3
13087,Decatur County,2021-04-17,9,7297,27.3
13087,Decatur County,2021-04-19,51,7348,27.5
13087,Decatur County,2021-04-20,38,7386,27.7
13087,Decatur County,2021-04-21,45,7431,27.9
13087,Decatur County,2021-04-22,61,7492,28.1
13087,Decatur County,2021-04-23,29,7521,28.2
13087,Decatur County,2021-04-24,2,7523,28.2
13087,Decatur County,2021-04-25,5,7528,28.2
13087,Decatur County,2021-04-26,30,7558,28.3
13087,Decatur County,2021-04-27,36,7594,28.5
13087,Decatur County,2021-04-28,70,7664,28.7
13087,Decatur County,2021-04-29,60,7724,28.9
13087,Decatur County,2021-04-30,26,7750,29
13087,Decatur County,2021-05-01,17,7767,29.1
13087,Decatur County,2021-05-02,8,7775,29.1
13087,Decatur County,2021-05-03,82,7857,29.4
13087,Decatur County,2021-05-04,28,7885,29.6
13087,Decatur County,2021-05-05,36,7921,29.7
13087,Decatur County,2021-05-06,51,7972,29.9
13087,Decatur County,2021-05-07,41,8013,30
13087,Decatur County,2021-05-08,17,8030,30.1
13087,Decatur County,2021-05-09,2,8032,30.1
13087,Decatur County,2021-05-10,39,8071,30.2
13087,Decatur County,2021-05-11,31,8102,30.4
13087,Decatur County,2021-05-12,48,8150,30.5
13087,Decatur County,2021-05-13,29,8179,30.7
13087,Decatur County,2021-05-14,77,8256,30.9
13087,Decatur County,2021-05-15,19,8275,31
13087,Decatur County,2021-05-16,9,8284,31
13087,Decatur County,2021-05-17,28,8312,31.2
13087,Decatur County,2021-05-18,31,8343,31.3
13087,Decatur County,2021-05-19,48,8391,31.4
13087,Decatur County,2021-05-20,33,8424,31.6
13087,Decatur County,2021-05-21,30,8454,31.7
13087,Decatur County,2021-05-22,12,8466,31.7
13087,Decatur County,2021-05-23,10,8476,31.8
13087,Decatur County,2021-05-24,20,8496,31.8
13087,Decatur County,2021-05-25,20,8516,31.9
13087,Decatur County,2021-05-26,21,8537,32
13087,Decatur County,2021-05-27,33,8570,32.1
13087,Decatur County,2021-05-28,14,8584,32.2
13087,Decatur County,2021-05-29,23,8607,32.3
13087,Decatur County,2021-05-30,3,8610,32.3
13087,Decatur County,2021-05-31,1,8611,32.3
13087,Decatur County,2021-06-01,21,8632,32.4
13087,Decatur County,2021-06-02,52,8684,32.5
13087,Decatur County,2021-06-03,32,8716,32.7
13087,Decatur County,2021-06-04,28,8744,32.8
13087,Decatur County,2021-06-05,13,8757,32.8
13087,Decatur County,2021-06-06,4,8761,32.8
13087,Decatur County,2021-06-07,17,8778,32.9
13087,Decatur County,2021-06-08,22,8800,33
13087,Decatur County,2021-06-09,29,8829,33.1
13087,Decatur County,2021-06-10,39,8868,33.2
13087,Decatur County,2021-06-11,10,8878,33.3
13087,Decatur County,2021-06-12,6,8884,33.3
13087,Decatur County,2021-06-13,1,8885,33.3
13087,Decatur County,2021-06-14,17,8902,33.4
13087,Decatur County,2021-06-15,18,8920,33.4
13087,Decatur County,2021-06-16,15,8935,33.5
13087,Decatur County,2021-06-17,22,8957,33.6
13087,Decatur County,2021-06-18,12,8969,33.6
13087,Decatur County,2021-06-19,9,8978,33.6
13087,Decatur County,2021-06-20,2,8980,33.7
13087,Decatur County,2021-06-21,21,9001,33.7
13087,Decatur County,2021-06-22,27,9028,33.8
13087,Decatur County,2021-06-23,31,9059,34
13087,Decatur County,2021-06-24,34,9093,34.1
13087,Decatur County,2021-06-25,14,9107,34.1
13087,Decatur County,2021-06-26,5,9112,34.2
13087,Decatur County,2021-06-27,4,9116,34.2
13087,Decatur County,2021-06-28,14,9130,34.2
13087,Decatur County,2021-06-29,15,9145,34.3
13087,Decatur County,2021-06-30,81,9226,34.6
13087,Decatur County,2021-07-01,17,9243,34.6
13087,Decatur County,2021-07-02,10,9253,34.7
13087,Decatur County,2021-07-03,11,9264,34.7
13087,Decatur County,2021-07-04,2,9266,34.7
13087,Decatur County,2021-07-05,3,9269,34.7
13087,Decatur County,2021-07-06,12,9281,34.8
13087,Decatur County,2021-07-07,26,9307,34.9
13087,Decatur County,2021-07-08,19,9326,35
13087,Decatur County,2021-07-09,12,9338,35
13087,Decatur County,2021-07-10,11,9349,35
13087,Decatur County,2021-07-11,3,9352,35
13087,Decatur County,2021-07-12,17,9369,35.1
13087,Decatur County,2021-07-13,19,9388,35.2
13087,Decatur County,2021-07-14,22,9410,35.3
13087,Decatur County,2021-07-15,28,9438,35.4
13087,Decatur County,2021-07-16,14,9452,35.4
13087,Decatur County,2021-07-17,10,9462,35.5
13087,Decatur County,2021-07-18,5,9467,35.5
13087,Decatur County,2021-07-19,35,9502,35.6
13087,Decatur County,2021-07-20,45,9547,35.8
13087,Decatur County,2021-07-21,45,9592,35.9
13087,Decatur County,2021-07-22,41,9633,36.1
13087,Decatur County,2021-07-23,35,9668,36.2
13087,Decatur County,2021-07-24,27,9695,36.3
13087,Decatur County,2021-07-25,8,9703,36.4
13087,Decatur County,2021-07-26,60,9763,36.6
13087,Decatur County,2021-07-27,48,9811,36.8
13087,Decatur County,2021-07-28,59,9870,37
13087,Decatur County,2021-07-29,100,9970,37.4
13087,Decatur County,2021-07-30,65,10035,37.6
13087,Decatur County,2021-07-31,30,10065,37.7
13087,Decatur County,2021-08-01,12,10077,37.8
13087,Decatur County,2021-08-02,112,10189,38.2
13087,Decatur County,2021-08-03,92,10281,38.5
13087,Decatur County,2021-08-04,103,10384,38.9
13087,Decatur County,2021-08-05,77,10461,39.2
13087,Decatur County,2021-08-06,49,10510,39.4
13087,Decatur County,2021-08-07,70,10580,39.7
13087,Decatur County,2021-08-08,17,10597,39.7
13087,Decatur County,2021-08-09,105,10702,40.1
13087,Decatur County,2021-08-10,96,10798,40.5
13087,Decatur County,2021-08-11,96,10894,40.8
13087,Decatur County,2021-08-12,165,11059,41.4
13087,Decatur County,2021-08-13,108,11167,41.9
13087,Decatur County,2021-08-14,45,11212,42
13087,Decatur County,2021-08-15,29,11241,42.1
13087,Decatur County,2021-08-16,129,11370,42.6
13087,Decatur County,2021-08-17,112,11482,43
13087,Decatur County,2021-08-18,136,11618,43.5
13087,Decatur County,2021-08-19,112,11730,44
13087,Decatur County,2021-08-20,71,11801,44.2
13087,Decatur County,2021-08-21,46,11847,44.4
13087,Decatur County,2021-08-22,12,11859,44.4
13087,Decatur County,2021-08-23,92,11951,44.8
13087,Decatur County,2021-08-24,94,12045,45.1
13087,Decatur County,2021-08-25,95,12140,45.5
13087,Decatur County,2021-08-26,70,12210,45.8
13087,Decatur County,2021-08-27,67,12277,46
13087,Decatur County,2021-08-28,36,12313,46.1
13087,Decatur County,2021-08-29,10,12323,46.2
13087,Decatur County,2021-08-30,70,12393,46.4
13087,Decatur County,2021-08-31,44,12437,46.6
13087,Decatur County,2021-09-01,53,12490,46.8
13087,Decatur County,2021-09-02,88,12578,47.1
13087,Decatur County,2021-09-03,60,12638,47.4
13087,Decatur County,2021-09-04,19,12657,47.4
13087,Decatur County,2021-09-05,7,12664,47.5
13087,Decatur County,2021-09-06,11,12675,47.5
13087,Decatur County,2021-09-07,50,12725,47.7
13087,Decatur County,2021-09-08,39,12764,47.8
13087,Decatur County,2021-09-09,52,12816,48
13087,Decatur County,2021-09-10,49,12865,48.2
13087,Decatur County,2021-09-11,20,12885,48.3
13087,Decatur County,2021-09-12,6,12891,48.3
13087,Decatur County,2021-09-13,52,12943,48.5
13087,Decatur County,2021-09-14,25,12968,48.6
13087,Decatur County,2021-09-15,60,13028,48.8
13087,Decatur County,2021-09-16,26,13054,48.9
13087,Decatur County,2021-09-17,19,13073,49
13087,Decatur County,2021-09-18,13,13086,49
13087,Decatur County,2021-09-19,2,13088,49.1
13087,Decatur County,2021-09-20,26,13114,49.1
13087,Decatur County,2021-09-21,15,13129,49.2
13087,Decatur County,2021-09-22,22,13151,49.3
13087,Decatur County,2021-09-23,18,13169,49.4
13087,Decatur County,2021-09-24,16,13185,49.4
13087,Decatur County,2021-09-25,3,13188,49.4
13087,Decatur County,2021-09-26,4,13192,49.4
13087,Decatur County,2021-09-27,18,13210,49.5
13087,Decatur County,2021-09-28,7,13217,49.5
13087,Decatur County,2021-09-29,18,13235,49.6
13087,Decatur County,2021-09-30,13,13248,49.7
13087,Decatur County,2021-10-01,10,13258,49.7
13087,Decatur County,2021-10-02,2,13260,49.7
13087,Decatur County,2021-10-03,1,13261,49.7
13087,Decatur County,2021-10-04,3,13264,49.7
13087,Decatur County,2021-10-05,14,13278,49.8
13087,Decatur County,2021-10-06,6,13284,49.8
13087,Decatur County,2021-10-07,11,13295,49.8
13089,DeKalb County,2020-12-12,1,1,0
13089,DeKalb County,2020-12-13,1,2,0
13089,DeKalb County,2020-12-15,5,7,0
13089,DeKalb County,2020-12-16,12,19,0
13089,DeKalb County,2020-12-17,223,242,0
13089,DeKalb County,2020-12-18,527,769,0.1
13089,DeKalb County,2020-12-19,1054,1823,0.2
13089,DeKalb County,2020-12-20,793,2616,0.3
13089,DeKalb County,2020-12-21,632,3248,0.4
13089,DeKalb County,2020-12-22,737,3985,0.5
13089,DeKalb County,2020-12-23,1029,5014,0.7
13089,DeKalb County,2020-12-24,259,5273,0.7
13089,DeKalb County,2020-12-25,13,5286,0.7
13089,DeKalb County,2020-12-26,144,5430,0.7
13089,DeKalb County,2020-12-27,93,5523,0.7
13089,DeKalb County,2020-12-28,1116,6639,0.9
13089,DeKalb County,2020-12-29,1028,7667,1
13089,DeKalb County,2020-12-30,1023,8690,1.2
13089,DeKalb County,2020-12-31,553,9243,1.2
13089,DeKalb County,2021-01-01,182,9425,1.3
13089,DeKalb County,2021-01-02,169,9594,1.3
13089,DeKalb County,2021-01-03,245,9839,1.3
13089,DeKalb County,2021-01-04,1026,10865,1.4
13089,DeKalb County,2021-01-05,932,11797,1.6
13089,DeKalb County,2021-01-06,1331,13128,1.8
13089,DeKalb County,2021-01-07,1269,14397,1.9
13089,DeKalb County,2021-01-08,1554,15951,2.1
13089,DeKalb County,2021-01-09,642,16593,2.2
13089,DeKalb County,2021-01-10,315,16908,2.3
13089,DeKalb County,2021-01-11,1691,18599,2.5
13089,DeKalb County,2021-01-12,1604,20203,2.7
13089,DeKalb County,2021-01-13,2505,22708,3
13089,DeKalb County,2021-01-14,2391,25099,3.3
13089,DeKalb County,2021-01-15,2352,27451,3.7
13089,DeKalb County,2021-01-16,1447,28898,3.9
13089,DeKalb County,2021-01-17,560,29458,3.9
13089,DeKalb County,2021-01-18,1537,30995,4.1
13089,DeKalb County,2021-01-19,2628,33623,4.5
13089,DeKalb County,2021-01-20,2637,36260,4.8
13089,DeKalb County,2021-01-21,2563,38823,5.2
13089,DeKalb County,2021-01-22,2302,41125,5.5
13089,DeKalb County,2021-01-23,756,41881,5.6
13089,DeKalb County,2021-01-24,332,42213,5.6
13089,DeKalb County,2021-01-25,1906,44119,5.9
13089,DeKalb County,2021-01-26,1762,45881,6.1
13089,DeKalb County,2021-01-27,2110,47991,6.4
13089,DeKalb County,2021-01-28,2306,50297,6.7
13089,DeKalb County,2021-01-29,2456,52753,7
13089,DeKalb County,2021-01-30,616,53369,7.1
13089,DeKalb County,2021-01-31,336,53705,7.2
13089,DeKalb County,2021-02-01,1506,55211,7.4
13089,DeKalb County,2021-02-02,1392,56603,7.6
13089,DeKalb County,2021-02-03,1726,58329,7.8
13089,DeKalb County,2021-02-04,1926,60255,8
13089,DeKalb County,2021-02-05,1472,61727,8.2
13089,DeKalb County,2021-02-06,654,62381,8.3
13089,DeKalb County,2021-02-07,234,62615,8.4
13089,DeKalb County,2021-02-08,1115,63730,8.5
13089,DeKalb County,2021-02-09,1134,64864,8.7
13089,DeKalb County,2021-02-10,1133,65997,8.8
13089,DeKalb County,2021-02-11,1543,67540,9
13089,DeKalb County,2021-02-12,1211,68751,9.2
13089,DeKalb County,2021-02-13,655,69406,9.3
13089,DeKalb County,2021-02-14,423,69829,9.3
13089,DeKalb County,2021-02-15,1630,71459,9.5
13089,DeKalb County,2021-02-16,1613,73072,9.8
13089,DeKalb County,2021-02-17,2211,75283,10
13089,DeKalb County,2021-02-18,2150,77433,10.3
13089,DeKalb County,2021-02-19,1939,79372,10.6
13089,DeKalb County,2021-02-20,510,79882,10.7
13089,DeKalb County,2021-02-21,243,80125,10.7
13089,DeKalb County,2021-02-22,1016,81141,10.8
13089,DeKalb County,2021-02-23,1627,82768,11
13089,DeKalb County,2021-02-24,1793,84561,11.3
13089,DeKalb County,2021-02-25,1959,86520,11.5
13089,DeKalb County,2021-02-26,1607,88127,11.8
13089,DeKalb County,2021-02-27,974,89101,11.9
13089,DeKalb County,2021-02-28,562,89663,12
13089,DeKalb County,2021-03-01,1550,91213,12.2
13089,DeKalb County,2021-03-02,1812,93025,12.4
13089,DeKalb County,2021-03-03,2068,95093,12.7
13089,DeKalb County,2021-03-04,2748,97841,13.1
13089,DeKalb County,2021-03-05,2535,100376,13.4
13089,DeKalb County,2021-03-06,1274,101650,13.6
13089,DeKalb County,2021-03-07,829,102479,13.7
13089,DeKalb County,2021-03-08,3848,106327,14.2
13089,DeKalb County,2021-03-09,4169,110496,14.7
13089,DeKalb County,2021-03-10,4235,114731,15.3
13089,DeKalb County,2021-03-11,4485,119216,15.9
13089,DeKalb County,2021-03-12,4050,123266,16.5
13089,DeKalb County,2021-03-13,1994,125260,16.7
13089,DeKalb County,2021-03-14,1582,126842,16.9
13089,DeKalb County,2021-03-15,4169,131011,17.5
13089,DeKalb County,2021-03-16,5355,136366,18.2
13089,DeKalb County,2021-03-17,5497,141863,18.9
13089,DeKalb County,2021-03-18,5703,147566,19.7
13089,DeKalb County,2021-03-19,5846,153412,20.5
13089,DeKalb County,2021-03-20,3191,156603,20.9
13089,DeKalb County,2021-03-21,1434,158037,21.1
13089,DeKalb County,2021-03-22,5559,163596,21.8
13089,DeKalb County,2021-03-23,5896,169492,22.6
13089,DeKalb County,2021-03-24,6224,175716,23.4
13089,DeKalb County,2021-03-25,7391,183107,24.4
13089,DeKalb County,2021-03-26,6237,189344,25.3
13089,DeKalb County,2021-03-27,4067,193411,25.8
13089,DeKalb County,2021-03-28,1620,195031,26
13089,DeKalb County,2021-03-29,5195,200226,26.7
13089,DeKalb County,2021-03-30,7022,207248,27.7
13089,DeKalb County,2021-03-31,7614,214862,28.7
13089,DeKalb County,2021-04-01,6183,221045,29.5
13089,DeKalb County,2021-04-02,4756,225801,30.1
13089,DeKalb County,2021-04-03,2092,227893,30.4
13089,DeKalb County,2021-04-04,933,228826,30.5
13089,DeKalb County,2021-04-05,4212,233038,31.1
13089,DeKalb County,2021-04-06,5943,238981,31.9
13089,DeKalb County,2021-04-07,6117,245098,32.7
13089,DeKalb County,2021-04-08,5717,250815,33.5
13089,DeKalb County,2021-04-09,5732,256547,34.2
13089,DeKalb County,2021-04-10,4032,260579,34.8
13089,DeKalb County,2021-04-11,1057,261636,34.9
13089,DeKalb County,2021-04-12,3243,264879,35.3
13089,DeKalb County,2021-04-13,3563,268442,35.8
13089,DeKalb County,2021-04-14,2928,271370,36.2
13089,DeKalb County,2021-04-15,2537,273907,36.6
13089,DeKalb County,2021-04-16,2274,276181,36.9
13089,DeKalb County,2021-04-17,1305,277486,37
13089,DeKalb County,2021-04-18,1220,278706,37.2
13089,DeKalb County,2021-04-19,2420,281126,37.5
13089,DeKalb County,2021-04-20,2645,283771,37.9
13089,DeKalb County,2021-04-21,2756,286527,38.2
13089,DeKalb County,2021-04-22,2426,288953,38.6
13089,DeKalb County,2021-04-23,2217,291170,38.9
13089,DeKalb County,2021-04-24,1319,292489,39
13089,DeKalb County,2021-04-25,658,293147,39.1
13089,DeKalb County,2021-04-26,1874,295021,39.4
13089,DeKalb County,2021-04-27,1812,296833,39.6
13089,DeKalb County,2021-04-28,2311,299144,39.9
13089,DeKalb County,2021-04-29,1865,301009,40.2
13089,DeKalb County,2021-04-30,2353,303362,40.5
13089,DeKalb County,2021-05-01,1550,304912,40.7
13089,DeKalb County,2021-05-02,672,305584,40.8
13089,DeKalb County,2021-05-03,1167,306751,40.9
13089,DeKalb County,2021-05-04,1631,308382,41.2
13089,DeKalb County,2021-05-05,1655,310037,41.4
13089,DeKalb County,2021-05-06,1447,311484,41.6
13089,DeKalb County,2021-05-07,1600,313084,41.8
13089,DeKalb County,2021-05-08,959,314043,41.9
13089,DeKalb County,2021-05-09,387,314430,42
13089,DeKalb County,2021-05-10,1050,315480,42.1
13089,DeKalb County,2021-05-11,1772,317252,42.3
13089,DeKalb County,2021-05-12,2490,319742,42.7
13089,DeKalb County,2021-05-13,1684,321426,42.9
13089,DeKalb County,2021-05-14,2189,323615,43.2
13089,DeKalb County,2021-05-15,2111,325726,43.5
13089,DeKalb County,2021-05-16,1045,326771,43.6
13089,DeKalb County,2021-05-17,1800,328571,43.8
13089,DeKalb County,2021-05-18,1776,330347,44.1
13089,DeKalb County,2021-05-19,2072,332419,44.4
13089,DeKalb County,2021-05-20,1431,333850,44.6
13089,DeKalb County,2021-05-21,1613,335463,44.8
13089,DeKalb County,2021-05-22,1424,336887,45
13089,DeKalb County,2021-05-23,782,337669,45.1
13089,DeKalb County,2021-05-24,1214,338883,45.2
13089,DeKalb County,2021-05-25,1092,339975,45.4
13089,DeKalb County,2021-05-26,1265,341240,45.5
13089,DeKalb County,2021-05-27,978,342218,45.7
13089,DeKalb County,2021-05-28,1137,343355,45.8
13089,DeKalb County,2021-05-29,666,344021,45.9
13089,DeKalb County,2021-05-30,421,344442,46
13089,DeKalb County,2021-05-31,134,344576,46
13089,DeKalb County,2021-06-01,1159,345735,46.1
13089,DeKalb County,2021-06-02,1207,346942,46.3
13089,DeKalb County,2021-06-03,938,347880,46.4
13089,DeKalb County,2021-06-04,1163,349043,46.6
13089,DeKalb County,2021-06-05,890,349933,46.7
13089,DeKalb County,2021-06-06,588,350521,46.8
13089,DeKalb County,2021-06-07,848,351369,46.9
13089,DeKalb County,2021-06-08,842,352211,47
13089,DeKalb County,2021-06-09,816,353027,47.1
13089,DeKalb County,2021-06-10,787,353814,47.2
13089,DeKalb County,2021-06-11,828,354642,47.3
13089,DeKalb County,2021-06-12,596,355238,47.4
13089,DeKalb County,2021-06-13,256,355494,47.4
13089,DeKalb County,2021-06-14,726,356220,47.5
13089,DeKalb County,2021-06-15,655,356875,47.6
13089,DeKalb County,2021-06-16,749,357624,47.7
13089,DeKalb County,2021-06-17,690,358314,47.8
13089,DeKalb County,2021-06-18,825,359139,47.9
13089,DeKalb County,2021-06-19,463,359602,48
13089,DeKalb County,2021-06-20,262,359864,48
13089,DeKalb County,2021-06-21,610,360474,48.1
13089,DeKalb County,2021-06-22,641,361115,48.2
13089,DeKalb County,2021-06-23,700,361815,48.3
13089,DeKalb County,2021-06-24,564,362379,48.4
13089,DeKalb County,2021-06-25,741,363120,48.5
13089,DeKalb County,2021-06-26,485,363605,48.5
13089,DeKalb County,2021-06-27,313,363918,48.6
13089,DeKalb County,2021-06-28,597,364515,48.6
13089,DeKalb County,2021-06-29,602,365117,48.7
13089,DeKalb County,2021-06-30,611,365728,48.8
13089,DeKalb County,2021-07-01,541,366269,48.9
13089,DeKalb County,2021-07-02,675,366944,49
13089,DeKalb County,2021-07-03,414,367358,49
13089,DeKalb County,2021-07-04,36,367394,49
13089,DeKalb County,2021-07-05,515,367909,49.1
13089,DeKalb County,2021-07-06,549,368458,49.2
13089,DeKalb County,2021-07-07,568,369026,49.2
13089,DeKalb County,2021-07-08,491,369517,49.3
13089,DeKalb County,2021-07-09,718,370235,49.4
13089,DeKalb County,2021-07-10,532,370767,49.5
13089,DeKalb County,2021-07-11,336,371103,49.5
13089,DeKalb County,2021-07-12,518,371621,49.6
13089,DeKalb County,2021-07-13,543,372164,49.7
13089,DeKalb County,2021-07-14,590,372754,49.7
13089,DeKalb County,2021-07-15,667,373421,49.8
13089,DeKalb County,2021-07-16,722,374143,49.9
13089,DeKalb County,2021-07-17,524,374667,50
13089,DeKalb County,2021-07-18,393,375060,50.1
13089,DeKalb County,2021-07-19,758,375818,50.2
13089,DeKalb County,2021-07-20,804,376622,50.3
13089,DeKalb County,2021-07-21,826,377448,50.4
13089,DeKalb County,2021-07-22,841,378289,50.5
13089,DeKalb County,2021-07-23,1046,379335,50.6
13089,DeKalb County,2021-07-24,875,380210,50.7
13089,DeKalb County,2021-07-25,544,380754,50.8
13089,DeKalb County,2021-07-26,959,381713,50.9
13089,DeKalb County,2021-07-27,1009,382722,51.1
13089,DeKalb County,2021-07-28,1090,383812,51.2
13089,DeKalb County,2021-07-29,1065,384877,51.4
13089,DeKalb County,2021-07-30,1164,386041,51.5
13089,DeKalb County,2021-07-31,1022,387063,51.7
13089,DeKalb County,2021-08-01,645,387708,51.7
13089,DeKalb County,2021-08-02,1046,388754,51.9
13089,DeKalb County,2021-08-03,1043,389797,52
13089,DeKalb County,2021-08-04,1142,390939,52.2
13089,DeKalb County,2021-08-05,1107,392046,52.3
13089,DeKalb County,2021-08-06,1291,393337,52.5
13089,DeKalb County,2021-08-07,970,394307,52.6
13089,DeKalb County,2021-08-08,682,394989,52.7
13089,DeKalb County,2021-08-09,1102,396091,52.9
13089,DeKalb County,2021-08-10,1177,397268,53
13089,DeKalb County,2021-08-11,1030,398298,53.2
13089,DeKalb County,2021-08-12,1115,399413,53.3
13089,DeKalb County,2021-08-13,1128,400541,53.5
13089,DeKalb County,2021-08-14,1384,401925,53.6
13089,DeKalb County,2021-08-15,543,402468,53.7
13089,DeKalb County,2021-08-16,845,403313,53.8
13089,DeKalb County,2021-08-17,961,404274,54
13089,DeKalb County,2021-08-18,980,405254,54.1
13089,DeKalb County,2021-08-19,919,406173,54.2
13089,DeKalb County,2021-08-20,1044,407217,54.3
13089,DeKalb County,2021-08-21,862,408079,54.5
13089,DeKalb County,2021-08-22,494,408573,54.5
13089,DeKalb County,2021-08-23,807,409380,54.6
13089,DeKalb County,2021-08-24,841,410221,54.7
13089,DeKalb County,2021-08-25,821,411042,54.9
13089,DeKalb County,2021-08-26,931,411973,55
13089,DeKalb County,2021-08-27,858,412831,55.1
13089,DeKalb County,2021-08-28,1485,414316,55.3
13089,DeKalb County,2021-08-29,400,414716,55.3
13089,DeKalb County,2021-08-30,780,415496,55.4
13089,DeKalb County,2021-08-31,745,416241,55.5
13089,DeKalb County,2021-09-01,737,416978,55.6
13089,DeKalb County,2021-09-02,741,417719,55.7
13089,DeKalb County,2021-09-03,891,418610,55.9
13089,DeKalb County,2021-09-04,578,419188,55.9
13089,DeKalb County,2021-09-05,484,419672,56
13089,DeKalb County,2021-09-06,126,419798,56
13089,DeKalb County,2021-09-07,710,420508,56.1
13089,DeKalb County,2021-09-08,758,421266,56.2
13089,DeKalb County,2021-09-09,772,422038,56.3
13089,DeKalb County,2021-09-10,863,422901,56.4
13089,DeKalb County,2021-09-11,676,423577,56.5
13089,DeKalb County,2021-09-12,456,424033,56.6
13089,DeKalb County,2021-09-13,678,424711,56.7
13089,DeKalb County,2021-09-14,663,425374,56.8
13089,DeKalb County,2021-09-15,572,425946,56.8
13089,DeKalb County,2021-09-16,540,426486,56.9
13089,DeKalb County,2021-09-17,634,427120,57
13089,DeKalb County,2021-09-18,502,427622,57.1
13089,DeKalb County,2021-09-19,326,427948,57.1
13089,DeKalb County,2021-09-20,485,428433,57.2
13089,DeKalb County,2021-09-21,531,428964,57.2
13089,DeKalb County,2021-09-22,471,429435,57.3
13089,DeKalb County,2021-09-23,469,429904,57.4
13089,DeKalb County,2021-09-24,395,430299,57.4
13089,DeKalb County,2021-09-25,312,430611,57.5
13089,DeKalb County,2021-09-26,216,430827,57.5
13089,DeKalb County,2021-09-27,274,431101,57.5
13089,DeKalb County,2021-09-28,337,431438,57.6
13089,DeKalb County,2021-09-29,314,431752,57.6
13089,DeKalb County,2021-09-30,324,432076,57.7
13089,DeKalb County,2021-10-01,348,432424,57.7
13089,DeKalb County,2021-10-02,319,432743,57.8
13089,DeKalb County,2021-10-03,146,432889,57.8
13089,DeKalb County,2021-10-04,185,433074,57.8
13089,DeKalb County,2021-10-05,146,433220,57.8
13089,DeKalb County,2021-10-06,185,433405,57.8
13089,DeKalb County,2021-10-07,127,433532,57.9
13091,Dodge County,2020-12-13,1,1,0
13091,Dodge County,2020-12-16,1,2,0
13091,Dodge County,2020-12-18,3,5,0
13091,Dodge County,2020-12-19,1,6,0
13091,Dodge County,2020-12-20,2,8,0
13091,Dodge County,2020-12-21,3,11,0.1
13091,Dodge County,2020-12-22,4,15,0.1
13091,Dodge County,2020-12-23,8,23,0.1
13091,Dodge County,2020-12-24,5,28,0.1
13091,Dodge County,2020-12-26,1,29,0.1
13091,Dodge County,2020-12-28,7,36,0.2
13091,Dodge County,2020-12-29,34,70,0.3
13091,Dodge County,2020-12-30,17,87,0.4
13091,Dodge County,2020-12-31,8,95,0.5
13091,Dodge County,2021-01-01,2,97,0.5
13091,Dodge County,2021-01-02,1,98,0.5
13091,Dodge County,2021-01-03,34,132,0.6
13091,Dodge County,2021-01-04,37,169,0.8
13091,Dodge County,2021-01-05,61,230,1.1
13091,Dodge County,2021-01-06,46,276,1.3
13091,Dodge County,2021-01-07,29,305,1.5
13091,Dodge County,2021-01-08,58,363,1.7
13091,Dodge County,2021-01-09,11,374,1.8
13091,Dodge County,2021-01-11,84,458,2.2
13091,Dodge County,2021-01-12,114,572,2.7
13091,Dodge County,2021-01-13,295,867,4.2
13091,Dodge County,2021-01-14,50,917,4.4
13091,Dodge County,2021-01-15,26,943,4.5
13091,Dodge County,2021-01-16,1,944,4.5
13091,Dodge County,2021-01-17,5,949,4.6
13091,Dodge County,2021-01-18,41,990,4.8
13091,Dodge County,2021-01-19,166,1156,5.5
13091,Dodge County,2021-01-20,438,1594,7.7
13091,Dodge County,2021-01-21,75,1669,8
13091,Dodge County,2021-01-22,32,1701,8.2
13091,Dodge County,2021-01-23,3,1704,8.2
13091,Dodge County,2021-01-24,12,1716,8.2
13091,Dodge County,2021-01-25,42,1758,8.4
13091,Dodge County,2021-01-26,31,1789,8.6
13091,Dodge County,2021-01-27,38,1827,8.8
13091,Dodge County,2021-01-28,51,1878,9
13091,Dodge County,2021-01-29,17,1895,9.1
13091,Dodge County,2021-01-30,35,1930,9.3
13091,Dodge County,2021-01-31,1,1931,9.3
13091,Dodge County,2021-02-01,15,1946,9.3
13091,Dodge County,2021-02-02,57,2003,9.6
13091,Dodge County,2021-02-03,261,2264,10.9
13091,Dodge County,2021-02-04,31,2295,11
13091,Dodge County,2021-02-05,6,2301,11
13091,Dodge County,2021-02-06,8,2309,11.1
13091,Dodge County,2021-02-08,21,2330,11.2
13091,Dodge County,2021-02-09,15,2345,11.3
13091,Dodge County,2021-02-10,115,2460,11.8
13091,Dodge County,2021-02-11,26,2486,11.9
13091,Dodge County,2021-02-12,18,2504,12
13091,Dodge County,2021-02-13,4,2508,12
13091,Dodge County,2021-02-14,3,2511,12.1
13091,Dodge County,2021-02-15,22,2533,12.2
13091,Dodge County,2021-02-16,56,2589,12.4
13091,Dodge County,2021-02-17,91,2680,12.9
13091,Dodge County,2021-02-18,19,2699,13
13091,Dodge County,2021-02-19,1,2700,13
13091,Dodge County,2021-02-22,7,2707,13
13091,Dodge County,2021-02-23,14,2721,13.1
13091,Dodge County,2021-02-24,26,2747,13.2
13091,Dodge County,2021-02-25,12,2759,13.2
13091,Dodge County,2021-02-26,14,2773,13.3
13091,Dodge County,2021-02-27,9,2782,13.4
13091,Dodge County,2021-02-28,2,2784,13.4
13091,Dodge County,2021-03-01,24,2808,13.5
13091,Dodge County,2021-03-02,15,2823,13.6
13091,Dodge County,2021-03-03,8,2831,13.6
13091,Dodge County,2021-03-04,11,2842,13.6
13091,Dodge County,2021-03-05,18,2860,13.7
13091,Dodge County,2021-03-06,2,2862,13.7
13091,Dodge County,2021-03-07,4,2866,13.8
13091,Dodge County,2021-03-08,22,2888,13.9
13091,Dodge County,2021-03-09,31,2919,14
13091,Dodge County,2021-03-10,110,3029,14.5
13091,Dodge County,2021-03-11,45,3074,14.8
13091,Dodge County,2021-03-12,126,3200,15.4
13091,Dodge County,2021-03-13,17,3217,15.4
13091,Dodge County,2021-03-14,4,3221,15.5
13091,Dodge County,2021-03-15,150,3371,16.2
13091,Dodge County,2021-03-16,50,3421,16.4
13091,Dodge County,2021-03-17,167,3588,17.2
13091,Dodge County,2021-03-18,56,3644,17.5
13091,Dodge County,2021-03-19,27,3671,17.6
13091,Dodge County,2021-03-20,11,3682,17.7
13091,Dodge County,2021-03-21,2,3684,17.7
13091,Dodge County,2021-03-22,24,3708,17.8
13091,Dodge County,2021-03-23,28,3736,17.9
13091,Dodge County,2021-03-24,178,3914,18.8
13091,Dodge County,2021-03-25,68,3982,19.1
13091,Dodge County,2021-03-26,44,4026,19.3
13091,Dodge County,2021-03-27,12,4038,19.4
13091,Dodge County,2021-03-28,9,4047,19.4
13091,Dodge County,2021-03-29,29,4076,19.6
13091,Dodge County,2021-03-30,49,4125,19.8
13091,Dodge County,2021-03-31,92,4217,20.2
13091,Dodge County,2021-04-01,71,4288,20.6
13091,Dodge County,2021-04-02,29,4317,20.7
13091,Dodge County,2021-04-03,17,4334,20.8
13091,Dodge County,2021-04-04,9,4343,20.9
13091,Dodge County,2021-04-05,26,4369,21
13091,Dodge County,2021-04-06,19,4388,21.1
13091,Dodge County,2021-04-07,90,4478,21.5
13091,Dodge County,2021-04-08,62,4540,21.8
13091,Dodge County,2021-04-09,21,4561,21.9
13091,Dodge County,2021-04-10,19,4580,22
13091,Dodge County,2021-04-11,7,4587,22
13091,Dodge County,2021-04-12,23,4610,22.1
13091,Dodge County,2021-04-13,20,4630,22.2
13091,Dodge County,2021-04-14,54,4684,22.5
13091,Dodge County,2021-04-15,52,4736,22.7
13091,Dodge County,2021-04-16,10,4746,22.8
13091,Dodge County,2021-04-17,10,4756,22.8
13091,Dodge County,2021-04-18,1,4757,22.8
13091,Dodge County,2021-04-19,13,4770,22.9
13091,Dodge County,2021-04-20,20,4790,23
13091,Dodge County,2021-04-21,66,4856,23.3
13091,Dodge County,2021-04-22,19,4875,23.4
13091,Dodge County,2021-04-23,10,4885,23.5
13091,Dodge County,2021-04-24,7,4892,23.5
13091,Dodge County,2021-04-25,2,4894,23.5
13091,Dodge County,2021-04-26,3,4897,23.5
13091,Dodge County,2021-04-27,22,4919,23.6
13091,Dodge County,2021-04-28,58,4977,23.9
13091,Dodge County,2021-04-29,19,4996,24
13091,Dodge County,2021-04-30,22,5018,24.1
13091,Dodge County,2021-05-01,3,5021,24.1
13091,Dodge County,2021-05-03,7,5028,24.1
13091,Dodge County,2021-05-04,12,5040,24.2
13091,Dodge County,2021-05-05,40,5080,24.4
13091,Dodge County,2021-05-06,15,5095,24.5
13091,Dodge County,2021-05-07,12,5107,24.5
13091,Dodge County,2021-05-08,5,5112,24.5
13091,Dodge County,2021-05-09,1,5113,24.5
13091,Dodge County,2021-05-10,12,5125,24.6
13091,Dodge County,2021-05-11,7,5132,24.6
13091,Dodge County,2021-05-12,21,5153,24.7
13091,Dodge County,2021-05-13,18,5171,24.8
13091,Dodge County,2021-05-14,27,5198,25
13091,Dodge County,2021-05-15,16,5214,25
13091,Dodge County,2021-05-16,4,5218,25.1
13091,Dodge County,2021-05-17,27,5245,25.2
13091,Dodge County,2021-05-18,22,5267,25.3
13091,Dodge County,2021-05-19,40,5307,25.5
13091,Dodge County,2021-05-20,28,5335,25.6
13091,Dodge County,2021-05-21,23,5358,25.7
13091,Dodge County,2021-05-22,13,5371,25.8
13091,Dodge County,2021-05-23,6,5377,25.8
13091,Dodge County,2021-05-24,7,5384,25.8
13091,Dodge County,2021-05-25,8,5392,25.9
13091,Dodge County,2021-05-26,16,5408,26
13091,Dodge County,2021-05-27,21,5429,26.1
13091,Dodge County,2021-05-28,10,5439,26.1
13091,Dodge County,2021-05-29,4,5443,26.1
13091,Dodge County,2021-05-30,3,5446,26.1
13091,Dodge County,2021-05-31,1,5447,26.2
13091,Dodge County,2021-06-01,10,5457,26.2
13091,Dodge County,2021-06-02,20,5477,26.3
13091,Dodge County,2021-06-03,9,5486,26.3
13091,Dodge County,2021-06-04,14,5500,26.4
13091,Dodge County,2021-06-05,5,5505,26.4
13091,Dodge County,2021-06-06,2,5507,26.4
13091,Dodge County,2021-06-07,11,5518,26.5
13091,Dodge County,2021-06-08,11,5529,26.5
13091,Dodge County,2021-06-09,7,5536,26.6
13091,Dodge County,2021-06-10,7,5543,26.6
13091,Dodge County,2021-06-11,12,5555,26.7
13091,Dodge County,2021-06-12,6,5561,26.7
13091,Dodge County,2021-06-13,5,5566,26.7
13091,Dodge County,2021-06-14,11,5577,26.8
13091,Dodge County,2021-06-15,8,5585,26.8
13091,Dodge County,2021-06-16,7,5592,26.8
13091,Dodge County,2021-06-17,5,5597,26.9
13091,Dodge County,2021-06-18,4,5601,26.9
13091,Dodge County,2021-06-19,3,5604,26.9
13091,Dodge County,2021-06-20,4,5608,26.9
13091,Dodge County,2021-06-21,10,5618,27
13091,Dodge County,2021-06-22,9,5627,27
13091,Dodge County,2021-06-23,10,5637,27.1
13091,Dodge County,2021-06-24,7,5644,27.1
13091,Dodge County,2021-06-25,10,5654,27.1
13091,Dodge County,2021-06-26,5,5659,27.2
13091,Dodge County,2021-06-27,1,5660,27.2
13091,Dodge County,2021-06-28,9,5669,27.2
13091,Dodge County,2021-06-29,7,5676,27.3
13091,Dodge County,2021-06-30,8,5684,27.3
13091,Dodge County,2021-07-01,11,5695,27.3
13091,Dodge County,2021-07-02,11,5706,27.4
13091,Dodge County,2021-07-03,6,5712,27.4
13091,Dodge County,2021-07-04,1,5713,27.4
13091,Dodge County,2021-07-05,7,5720,27.5
13091,Dodge County,2021-07-06,8,5728,27.5
13091,Dodge County,2021-07-07,8,5736,27.5
13091,Dodge County,2021-07-08,16,5752,27.6
13091,Dodge County,2021-07-09,13,5765,27.7
13091,Dodge County,2021-07-10,4,5769,27.7
13091,Dodge County,2021-07-11,3,5772,27.7
13091,Dodge County,2021-07-12,12,5784,27.8
13091,Dodge County,2021-07-13,10,5794,27.8
13091,Dodge County,2021-07-14,10,5804,27.9
13091,Dodge County,2021-07-15,21,5825,28
13091,Dodge County,2021-07-16,13,5838,28
13091,Dodge County,2021-07-17,6,5844,28.1
13091,Dodge County,2021-07-19,26,5870,28.2
13091,Dodge County,2021-07-20,28,5898,28.3
13091,Dodge County,2021-07-21,23,5921,28.4
13091,Dodge County,2021-07-22,14,5935,28.5
13091,Dodge County,2021-07-23,23,5958,28.6
13091,Dodge County,2021-07-24,11,5969,28.7
13091,Dodge County,2021-07-25,6,5975,28.7
13091,Dodge County,2021-07-26,35,6010,28.9
13091,Dodge County,2021-07-27,40,6050,29
13091,Dodge County,2021-07-28,44,6094,29.3
13091,Dodge County,2021-07-29,30,6124,29.4
13091,Dodge County,2021-07-30,43,6167,29.6
13091,Dodge County,2021-07-31,10,6177,29.7
13091,Dodge County,2021-08-01,8,6185,29.7
13091,Dodge County,2021-08-02,42,6227,29.9
13091,Dodge County,2021-08-03,36,6263,30.1
13091,Dodge County,2021-08-04,36,6299,30.2
13091,Dodge County,2021-08-05,26,6325,30.4
13091,Dodge County,2021-08-06,35,6360,30.5
13091,Dodge County,2021-08-07,11,6371,30.6
13091,Dodge County,2021-08-08,13,6384,30.6
13091,Dodge County,2021-08-09,54,6438,30.9
13091,Dodge County,2021-08-10,74,6512,31.3
13091,Dodge County,2021-08-11,37,6549,31.4
13091,Dodge County,2021-08-12,36,6585,31.6
13091,Dodge County,2021-08-13,58,6643,31.9
13091,Dodge County,2021-08-14,33,6676,32.1
13091,Dodge County,2021-08-15,13,6689,32.1
13091,Dodge County,2021-08-16,46,6735,32.3
13091,Dodge County,2021-08-17,40,6775,32.5
13091,Dodge County,2021-08-18,40,6815,32.7
13091,Dodge County,2021-08-19,40,6855,32.9
13091,Dodge County,2021-08-20,59,6914,33.2
13091,Dodge County,2021-08-21,24,6938,33.3
13091,Dodge County,2021-08-22,10,6948,33.4
13091,Dodge County,2021-08-23,46,6994,33.6
13091,Dodge County,2021-08-24,37,7031,33.8
13091,Dodge County,2021-08-25,43,7074,34
13091,Dodge County,2021-08-26,51,7125,34.2
13091,Dodge County,2021-08-27,47,7172,34.4
13091,Dodge County,2021-08-28,22,7194,34.5
13091,Dodge County,2021-08-29,10,7204,34.6
13091,Dodge County,2021-08-30,32,7236,34.7
13091,Dodge County,2021-08-31,35,7271,34.9
13091,Dodge County,2021-09-01,52,7323,35.2
13091,Dodge County,2021-09-02,39,7362,35.3
13091,Dodge County,2021-09-03,36,7398,35.5
13091,Dodge County,2021-09-04,25,7423,35.6
13091,Dodge County,2021-09-05,6,7429,35.7
13091,Dodge County,2021-09-06,8,7437,35.7
13091,Dodge County,2021-09-07,30,7467,35.8
13091,Dodge County,2021-09-08,27,7494,36
13091,Dodge County,2021-09-09,22,7516,36.1
13091,Dodge County,2021-09-10,33,7549,36.2
13091,Dodge County,2021-09-11,17,7566,36.3
13091,Dodge County,2021-09-12,6,7572,36.4
13091,Dodge County,2021-09-13,13,7585,36.4
13091,Dodge County,2021-09-14,18,7603,36.5
13091,Dodge County,2021-09-15,14,7617,36.6
13091,Dodge County,2021-09-16,22,7639,36.7
13091,Dodge County,2021-09-17,14,7653,36.7
13091,Dodge County,2021-09-18,7,7660,36.8
13091,Dodge County,2021-09-19,3,7663,36.8
13091,Dodge County,2021-09-20,13,7676,36.9
13091,Dodge County,2021-09-21,8,7684,36.9
13091,Dodge County,2021-09-22,15,7699,37
13091,Dodge County,2021-09-23,8,7707,37
13091,Dodge County,2021-09-24,12,7719,37.1
13091,Dodge County,2021-09-25,4,7723,37.1
13091,Dodge County,2021-09-26,5,7728,37.1
13091,Dodge County,2021-09-27,8,7736,37.1
13091,Dodge County,2021-09-28,9,7745,37.2
13091,Dodge County,2021-09-29,12,7757,37.2
13091,Dodge County,2021-09-30,8,7765,37.3
13091,Dodge County,2021-10-01,14,7779,37.3
13091,Dodge County,2021-10-02,5,7784,37.4
13091,Dodge County,2021-10-03,4,7788,37.4
13091,Dodge County,2021-10-04,3,7791,37.4
13091,Dodge County,2021-10-05,6,7797,37.4
13091,Dodge County,2021-10-06,4,7801,37.5
13091,Dodge County,2021-10-07,5,7806,37.5
13093,Dooly County,2020-12-18,1,1,0
13093,Dooly County,2020-12-21,3,4,0
13093,Dooly County,2020-12-22,6,10,0.1
13093,Dooly County,2020-12-23,12,22,0.2
13093,Dooly County,2020-12-24,7,29,0.2
13093,Dooly County,2020-12-26,3,32,0.2
13093,Dooly County,2020-12-27,1,33,0.2
13093,Dooly County,2020-12-28,20,53,0.4
13093,Dooly County,2020-12-29,15,68,0.5
13093,Dooly County,2020-12-30,32,100,0.7
13093,Dooly County,2020-12-31,6,106,0.8
13093,Dooly County,2021-01-01,33,139,1
13093,Dooly County,2021-01-03,2,141,1
13093,Dooly County,2021-01-04,36,177,1.3
13093,Dooly County,2021-01-05,78,255,1.9
13093,Dooly County,2021-01-06,10,265,1.9
13093,Dooly County,2021-01-07,7,272,2
13093,Dooly County,2021-01-08,8,280,2
13093,Dooly County,2021-01-10,2,282,2.1
13093,Dooly County,2021-01-11,48,330,2.4
13093,Dooly County,2021-01-12,50,380,2.8
13093,Dooly County,2021-01-13,60,440,3.2
13093,Dooly County,2021-01-14,214,654,4.8
13093,Dooly County,2021-01-15,45,699,5.1
13093,Dooly County,2021-01-16,1,700,5.1
13093,Dooly County,2021-01-17,2,702,5.1
13093,Dooly County,2021-01-18,182,884,6.4
13093,Dooly County,2021-01-19,79,963,7
13093,Dooly County,2021-01-20,102,1065,7.8
13093,Dooly County,2021-01-21,50,1115,8.1
13093,Dooly County,2021-01-22,18,1133,8.2
13093,Dooly County,2021-01-24,1,1134,8.3
13093,Dooly County,2021-01-25,13,1147,8.4
13093,Dooly County,2021-01-26,14,1161,8.5
13093,Dooly County,2021-01-27,28,1189,8.7
13093,Dooly County,2021-01-28,30,1219,8.9
13093,Dooly County,2021-01-29,25,1244,9.1
13093,Dooly County,2021-01-30,1,1245,9.1
13093,Dooly County,2021-02-01,11,1256,9.1
13093,Dooly County,2021-02-02,21,1277,9.3
13093,Dooly County,2021-02-03,95,1372,10
13093,Dooly County,2021-02-04,41,1413,10.3
13093,Dooly County,2021-02-05,17,1430,10.4
13093,Dooly County,2021-02-06,1,1431,10.4
13093,Dooly County,2021-02-08,6,1437,10.5
13093,Dooly County,2021-02-09,8,1445,10.5
13093,Dooly County,2021-02-10,4,1449,10.5
13093,Dooly County,2021-02-11,10,1459,10.6
13093,Dooly County,2021-02-12,16,1475,10.7
13093,Dooly County,2021-02-13,6,1481,10.8
13093,Dooly County,2021-02-14,2,1483,10.8
13093,Dooly County,2021-02-15,5,1488,10.8
13093,Dooly County,2021-02-16,12,1500,10.9
13093,Dooly County,2021-02-17,11,1511,11
13093,Dooly County,2021-02-18,19,1530,11.1
13093,Dooly County,2021-02-19,26,1556,11.3
13093,Dooly County,2021-02-22,53,1609,11.7
13093,Dooly County,2021-02-23,33,1642,12
13093,Dooly County,2021-02-24,28,1670,12.2
13093,Dooly County,2021-02-25,38,1708,12.4
13093,Dooly County,2021-02-26,35,1743,12.7
13093,Dooly County,2021-02-27,4,1747,12.7
13093,Dooly County,2021-02-28,2,1749,12.7
13093,Dooly County,2021-03-01,32,1781,13
13093,Dooly County,2021-03-02,29,1810,13.2
13093,Dooly County,2021-03-03,25,1835,13.4
13093,Dooly County,2021-03-04,17,1852,13.5
13093,Dooly County,2021-03-05,64,1916,13.9
13093,Dooly County,2021-03-06,6,1922,14
13093,Dooly County,2021-03-07,6,1928,14
13093,Dooly County,2021-03-08,70,1998,14.5
13093,Dooly County,2021-03-09,18,2016,14.7
13093,Dooly County,2021-03-10,47,2063,15
13093,Dooly County,2021-03-11,49,2112,15.4
13093,Dooly County,2021-03-12,49,2161,15.7
13093,Dooly County,2021-03-13,4,2165,15.8
13093,Dooly County,2021-03-14,4,2169,15.8
13093,Dooly County,2021-03-15,41,2210,16.1
13093,Dooly County,2021-03-16,86,2296,16.7
13093,Dooly County,2021-03-17,17,2313,16.8
13093,Dooly County,2021-03-18,28,2341,17
13093,Dooly County,2021-03-19,121,2462,17.9
13093,Dooly County,2021-03-20,6,2468,18
13093,Dooly County,2021-03-21,5,2473,18
13093,Dooly County,2021-03-22,84,2557,18.6
13093,Dooly County,2021-03-23,19,2576,18.8
13093,Dooly County,2021-03-24,34,2610,19
13093,Dooly County,2021-03-25,62,2672,19.5
13093,Dooly County,2021-03-26,42,2714,19.8
13093,Dooly County,2021-03-27,7,2721,19.8
13093,Dooly County,2021-03-28,5,2726,19.8
13093,Dooly County,2021-03-29,32,2758,20.1
13093,Dooly County,2021-03-30,51,2809,20.4
13093,Dooly County,2021-03-31,25,2834,20.6
13093,Dooly County,2021-04-01,70,2904,21.1
13093,Dooly County,2021-04-02,24,2928,21.3
13093,Dooly County,2021-04-03,14,2942,21.4
13093,Dooly County,2021-04-04,4,2946,21.4
13093,Dooly County,2021-04-05,19,2965,21.6
13093,Dooly County,2021-04-06,23,2988,21.8
13093,Dooly County,2021-04-07,10,2998,21.8
13093,Dooly County,2021-04-08,70,3068,22.3
13093,Dooly County,2021-04-09,38,3106,22.6
13093,Dooly County,2021-04-10,7,3113,22.7
13093,Dooly County,2021-04-11,2,3115,22.7
13093,Dooly County,2021-04-12,28,3143,22.9
13093,Dooly County,2021-04-13,26,3169,23.1
13093,Dooly County,2021-04-14,15,3184,23.2
13093,Dooly County,2021-04-15,24,3208,23.4
13093,Dooly County,2021-04-16,15,3223,23.5
13093,Dooly County,2021-04-17,2,3225,23.5
13093,Dooly County,2021-04-18,1,3226,23.5
13093,Dooly County,2021-04-19,18,3244,23.6
13093,Dooly County,2021-04-20,16,3260,23.7
13093,Dooly County,2021-04-21,25,3285,23.9
13093,Dooly County,2021-04-22,14,3299,24
13093,Dooly County,2021-04-23,37,3336,24.3
13093,Dooly County,2021-04-24,5,3341,24.3
13093,Dooly County,2021-04-25,1,3342,24.3
13093,Dooly County,2021-04-26,14,3356,24.4
13093,Dooly County,2021-04-27,13,3369,24.5
13093,Dooly County,2021-04-28,13,3382,24.6
13093,Dooly County,2021-04-29,18,3400,24.8
13093,Dooly County,2021-04-30,16,3416,24.9
13093,Dooly County,2021-05-01,6,3422,24.9
13093,Dooly County,2021-05-02,4,3426,24.9
13093,Dooly County,2021-05-03,9,3435,25
13093,Dooly County,2021-05-04,22,3457,25.2
13093,Dooly County,2021-05-05,11,3468,25.2
13093,Dooly County,2021-05-06,18,3486,25.4
13093,Dooly County,2021-05-07,23,3509,25.5
13093,Dooly County,2021-05-08,2,3511,25.6
13093,Dooly County,2021-05-09,5,3516,25.6
13093,Dooly County,2021-05-10,10,3526,25.7
13093,Dooly County,2021-05-11,4,3530,25.7
13093,Dooly County,2021-05-12,7,3537,25.7
13093,Dooly County,2021-05-13,11,3548,25.8
13093,Dooly County,2021-05-14,5,3553,25.9
13093,Dooly County,2021-05-15,11,3564,25.9
13093,Dooly County,2021-05-16,1,3565,26
13093,Dooly County,2021-05-17,12,3577,26
13093,Dooly County,2021-05-18,15,3592,26.2
13093,Dooly County,2021-05-19,11,3603,26.2
13093,Dooly County,2021-05-20,20,3623,26.4
13093,Dooly County,2021-05-21,20,3643,26.5
13093,Dooly County,2021-05-22,7,3650,26.6
13093,Dooly County,2021-05-23,1,3651,26.6
13093,Dooly County,2021-05-24,6,3657,26.6
13093,Dooly County,2021-05-25,7,3664,26.7
13093,Dooly County,2021-05-26,11,3675,26.8
13093,Dooly County,2021-05-27,4,3679,26.8
13093,Dooly County,2021-05-28,3,3682,26.8
13093,Dooly County,2021-05-30,1,3683,26.8
13093,Dooly County,2021-06-01,12,3695,26.9
13093,Dooly County,2021-06-02,8,3703,27
13093,Dooly County,2021-06-03,15,3718,27.1
13093,Dooly County,2021-06-04,4,3722,27.1
13093,Dooly County,2021-06-05,5,3727,27.1
13093,Dooly County,2021-06-06,1,3728,27.1
13093,Dooly County,2021-06-07,11,3739,27.2
13093,Dooly County,2021-06-08,6,3745,27.3
13093,Dooly County,2021-06-09,17,3762,27.4
13093,Dooly County,2021-06-10,8,3770,27.4
13093,Dooly County,2021-06-11,14,3784,27.5
13093,Dooly County,2021-06-12,3,3787,27.6
13093,Dooly County,2021-06-13,1,3788,27.6
13093,Dooly County,2021-06-14,6,3794,27.6
13093,Dooly County,2021-06-15,9,3803,27.7
13093,Dooly County,2021-06-16,10,3813,27.8
13093,Dooly County,2021-06-17,6,3819,27.8
13093,Dooly County,2021-06-18,11,3830,27.9
13093,Dooly County,2021-06-19,4,3834,27.9
13093,Dooly County,2021-06-21,4,3838,27.9
13093,Dooly County,2021-06-22,2,3840,28
13093,Dooly County,2021-06-23,7,3847,28
13093,Dooly County,2021-06-24,4,3851,28
13093,Dooly County,2021-06-25,11,3862,28.1
13093,Dooly County,2021-06-26,4,3866,28.1
13093,Dooly County,2021-06-27,1,3867,28.2
13093,Dooly County,2021-06-28,3,3870,28.2
13093,Dooly County,2021-06-29,4,3874,28.2
13093,Dooly County,2021-06-30,10,3884,28.3
13093,Dooly County,2021-07-01,7,3891,28.3
13093,Dooly County,2021-07-02,5,3896,28.4
13093,Dooly County,2021-07-03,2,3898,28.4
13093,Dooly County,2021-07-04,2,3900,28.4
13093,Dooly County,2021-07-05,4,3904,28.4
13093,Dooly County,2021-07-06,4,3908,28.5
13093,Dooly County,2021-07-07,5,3913,28.5
13093,Dooly County,2021-07-08,12,3925,28.6
13093,Dooly County,2021-07-09,4,3929,28.6
13093,Dooly County,2021-07-10,2,3931,28.6
13093,Dooly County,2021-07-11,2,3933,28.6
13093,Dooly County,2021-07-12,12,3945,28.7
13093,Dooly County,2021-07-13,5,3950,28.8
13093,Dooly County,2021-07-14,9,3959,28.8
13093,Dooly County,2021-07-15,7,3966,28.9
13093,Dooly County,2021-07-16,8,3974,28.9
13093,Dooly County,2021-07-17,3,3977,29
13093,Dooly County,2021-07-19,9,3986,29
13093,Dooly County,2021-07-20,8,3994,29.1
13093,Dooly County,2021-07-21,15,4009,29.2
13093,Dooly County,2021-07-22,11,4020,29.3
13093,Dooly County,2021-07-23,24,4044,29.4
13093,Dooly County,2021-07-24,9,4053,29.5
13093,Dooly County,2021-07-25,4,4057,29.5
13093,Dooly County,2021-07-26,13,4070,29.6
13093,Dooly County,2021-07-27,11,4081,29.7
13093,Dooly County,2021-07-28,19,4100,29.8
13093,Dooly County,2021-07-29,17,4117,30
13093,Dooly County,2021-07-30,15,4132,30.1
13093,Dooly County,2021-07-31,5,4137,30.1
13093,Dooly County,2021-08-01,3,4140,30.1
13093,Dooly County,2021-08-02,14,4154,30.2
13093,Dooly County,2021-08-03,16,4170,30.4
13093,Dooly County,2021-08-04,19,4189,30.5
13093,Dooly County,2021-08-05,21,4210,30.6
13093,Dooly County,2021-08-06,35,4245,30.9
13093,Dooly County,2021-08-07,10,4255,31
13093,Dooly County,2021-08-08,1,4256,31
13093,Dooly County,2021-08-09,23,4279,31.2
13093,Dooly County,2021-08-10,30,4309,31.4
13093,Dooly County,2021-08-11,27,4336,31.6
13093,Dooly County,2021-08-12,31,4367,31.8
13093,Dooly County,2021-08-13,35,4402,32
13093,Dooly County,2021-08-14,11,4413,32.1
13093,Dooly County,2021-08-15,4,4417,32.2
13093,Dooly County,2021-08-16,32,4449,32.4
13093,Dooly County,2021-08-17,27,4476,32.6
13093,Dooly County,2021-08-18,29,4505,32.8
13093,Dooly County,2021-08-19,17,4522,32.9
13093,Dooly County,2021-08-20,31,4553,33.1
13093,Dooly County,2021-08-21,9,4562,33.2
13093,Dooly County,2021-08-22,5,4567,33.2
13093,Dooly County,2021-08-23,24,4591,33.4
13093,Dooly County,2021-08-24,19,4610,33.6
13093,Dooly County,2021-08-25,16,4626,33.7
13093,Dooly County,2021-08-26,39,4665,34
13093,Dooly County,2021-08-27,29,4694,34.2
13093,Dooly County,2021-08-28,7,4701,34.2
13093,Dooly County,2021-08-29,8,4709,34.3
13093,Dooly County,2021-08-30,18,4727,34.4
13093,Dooly County,2021-08-31,20,4747,34.6
13093,Dooly County,2021-09-01,16,4763,34.7
13093,Dooly County,2021-09-02,34,4797,34.9
13093,Dooly County,2021-09-03,37,4834,35.2
13093,Dooly County,2021-09-04,7,4841,35.2
13093,Dooly County,2021-09-05,9,4850,35.3
13093,Dooly County,2021-09-06,2,4852,35.3
13093,Dooly County,2021-09-07,28,4880,35.5
13093,Dooly County,2021-09-08,29,4909,35.7
13093,Dooly County,2021-09-09,25,4934,35.9
13093,Dooly County,2021-09-10,32,4966,36.2
13093,Dooly County,2021-09-11,13,4979,36.2
13093,Dooly County,2021-09-12,3,4982,36.3
13093,Dooly County,2021-09-13,20,5002,36.4
13093,Dooly County,2021-09-14,16,5018,36.5
13093,Dooly County,2021-09-15,19,5037,36.7
13093,Dooly County,2021-09-16,14,5051,36.8
13093,Dooly County,2021-09-17,22,5073,36.9
13093,Dooly County,2021-09-18,7,5080,37
13093,Dooly County,2021-09-19,5,5085,37
13093,Dooly County,2021-09-20,19,5104,37.2
13093,Dooly County,2021-09-21,12,5116,37.2
13093,Dooly County,2021-09-22,12,5128,37.3
13093,Dooly County,2021-09-23,9,5137,37.4
13093,Dooly County,2021-09-24,12,5149,37.5
13093,Dooly County,2021-09-25,11,5160,37.6
13093,Dooly County,2021-09-26,3,5163,37.6
13093,Dooly County,2021-09-27,6,5169,37.6
13093,Dooly County,2021-09-28,9,5178,37.7
13093,Dooly County,2021-09-29,12,5190,37.8
13093,Dooly County,2021-09-30,7,5197,37.8
13093,Dooly County,2021-10-01,6,5203,37.9
13093,Dooly County,2021-10-02,3,5206,37.9
13093,Dooly County,2021-10-03,2,5208,37.9
13093,Dooly County,2021-10-04,5,5213,38
13093,Dooly County,2021-10-05,2,5215,38
13093,Dooly County,2021-10-06,7,5222,38
13093,Dooly County,2021-10-07,4,5226,38
13095,Dougherty County,2020-12-12,1,1,0
13095,Dougherty County,2020-12-16,2,3,0
13095,Dougherty County,2020-12-17,63,66,0.1
13095,Dougherty County,2020-12-18,160,226,0.3
13095,Dougherty County,2020-12-19,57,283,0.3
13095,Dougherty County,2020-12-20,34,317,0.4
13095,Dougherty County,2020-12-21,93,410,0.5
13095,Dougherty County,2020-12-22,130,540,0.6
13095,Dougherty County,2020-12-23,115,655,0.7
13095,Dougherty County,2020-12-24,21,676,0.8
13095,Dougherty County,2020-12-26,40,716,0.8
13095,Dougherty County,2020-12-27,5,721,0.8
13095,Dougherty County,2020-12-28,89,810,0.9
13095,Dougherty County,2020-12-29,92,902,1
13095,Dougherty County,2020-12-30,123,1025,1.1
13095,Dougherty County,2020-12-31,65,1090,1.2
13095,Dougherty County,2021-01-01,26,1116,1.2
13095,Dougherty County,2021-01-02,8,1124,1.3
13095,Dougherty County,2021-01-03,6,1130,1.3
13095,Dougherty County,2021-01-04,87,1217,1.4
13095,Dougherty County,2021-01-05,89,1306,1.5
13095,Dougherty County,2021-01-06,124,1430,1.6
13095,Dougherty County,2021-01-07,167,1597,1.8
13095,Dougherty County,2021-01-08,165,1762,2
13095,Dougherty County,2021-01-09,36,1798,2
13095,Dougherty County,2021-01-10,81,1879,2.1
13095,Dougherty County,2021-01-11,507,2386,2.7
13095,Dougherty County,2021-01-12,633,3019,3.4
13095,Dougherty County,2021-01-13,686,3705,4.1
13095,Dougherty County,2021-01-14,692,4397,4.9
13095,Dougherty County,2021-01-15,667,5064,5.6
13095,Dougherty County,2021-01-16,530,5594,6.2
13095,Dougherty County,2021-01-17,40,5634,6.3
13095,Dougherty County,2021-01-18,809,6443,7.2
13095,Dougherty County,2021-01-19,697,7140,8
13095,Dougherty County,2021-01-20,641,7781,8.7
13095,Dougherty County,2021-01-21,635,8416,9.4
13095,Dougherty County,2021-01-22,545,8961,10
13095,Dougherty County,2021-01-23,159,9120,10.2
13095,Dougherty County,2021-01-24,6,9126,10.2
13095,Dougherty County,2021-01-25,378,9504,10.6
13095,Dougherty County,2021-01-26,407,9911,11
13095,Dougherty County,2021-01-27,345,10256,11.4
13095,Dougherty County,2021-01-28,298,10554,11.8
13095,Dougherty County,2021-01-29,395,10949,12.2
13095,Dougherty County,2021-01-30,32,10981,12.2
13095,Dougherty County,2021-01-31,49,11030,12.3
13095,Dougherty County,2021-02-01,263,11293,12.6
13095,Dougherty County,2021-02-02,263,11556,12.9
13095,Dougherty County,2021-02-03,187,11743,13.1
13095,Dougherty County,2021-02-04,191,11934,13.3
13095,Dougherty County,2021-02-05,185,12119,13.5
13095,Dougherty County,2021-02-06,45,12164,13.6
13095,Dougherty County,2021-02-07,9,12173,13.6
13095,Dougherty County,2021-02-08,135,12308,13.7
13095,Dougherty County,2021-02-09,184,12492,13.9
13095,Dougherty County,2021-02-10,156,12648,14.1
13095,Dougherty County,2021-02-11,156,12804,14.3
13095,Dougherty County,2021-02-12,226,13030,14.5
13095,Dougherty County,2021-02-13,119,13149,14.7
13095,Dougherty County,2021-02-14,8,13157,14.7
13095,Dougherty County,2021-02-15,145,13302,14.8
13095,Dougherty County,2021-02-16,227,13529,15.1
13095,Dougherty County,2021-02-17,169,13698,15.3
13095,Dougherty County,2021-02-18,150,13848,15.4
13095,Dougherty County,2021-02-19,93,13941,15.5
13095,Dougherty County,2021-02-20,103,14044,15.7
13095,Dougherty County,2021-02-21,3,14047,15.7
13095,Dougherty County,2021-02-22,81,14128,15.7
13095,Dougherty County,2021-02-23,216,14344,16
13095,Dougherty County,2021-02-24,203,14547,16.2
13095,Dougherty County,2021-02-25,213,14760,16.5
13095,Dougherty County,2021-02-26,141,14901,16.6
13095,Dougherty County,2021-02-27,79,14980,16.7
13095,Dougherty County,2021-02-28,18,14998,16.7
13095,Dougherty County,2021-03-01,257,15255,17
13095,Dougherty County,2021-03-02,251,15506,17.3
13095,Dougherty County,2021-03-03,184,15690,17.5
13095,Dougherty County,2021-03-04,189,15879,17.7
13095,Dougherty County,2021-03-05,130,16009,17.8
13095,Dougherty County,2021-03-06,27,16036,17.9
13095,Dougherty County,2021-03-07,27,16063,17.9
13095,Dougherty County,2021-03-08,204,16267,18.1
13095,Dougherty County,2021-03-09,348,16615,18.5
13095,Dougherty County,2021-03-10,242,16857,18.8
13095,Dougherty County,2021-03-11,236,17093,19.1
13095,Dougherty County,2021-03-12,538,17631,19.7
13095,Dougherty County,2021-03-13,142,17773,19.8
13095,Dougherty County,2021-03-14,22,17795,19.8
13095,Dougherty County,2021-03-15,292,18087,20.2
13095,Dougherty County,2021-03-16,609,18696,20.8
13095,Dougherty County,2021-03-17,413,19109,21.3
13095,Dougherty County,2021-03-18,296,19405,21.6
13095,Dougherty County,2021-03-19,529,19934,22.2
13095,Dougherty County,2021-03-20,324,20258,22.6
13095,Dougherty County,2021-03-21,44,20302,22.6
13095,Dougherty County,2021-03-22,214,20516,22.9
13095,Dougherty County,2021-03-23,454,20970,23.4
13095,Dougherty County,2021-03-24,279,21249,23.7
13095,Dougherty County,2021-03-25,409,21658,24.1
13095,Dougherty County,2021-03-26,256,21914,24.4
13095,Dougherty County,2021-03-27,83,21997,24.5
13095,Dougherty County,2021-03-28,50,22047,24.6
13095,Dougherty County,2021-03-29,189,22236,24.8
13095,Dougherty County,2021-03-30,566,22802,25.4
13095,Dougherty County,2021-03-31,394,23196,25.9
13095,Dougherty County,2021-04-01,369,23565,26.3
13095,Dougherty County,2021-04-02,190,23755,26.5
13095,Dougherty County,2021-04-03,56,23811,26.5
13095,Dougherty County,2021-04-04,54,23865,26.6
13095,Dougherty County,2021-04-05,197,24062,26.8
13095,Dougherty County,2021-04-06,488,24550,27.4
13095,Dougherty County,2021-04-07,340,24890,27.7
13095,Dougherty County,2021-04-08,398,25288,28.2
13095,Dougherty County,2021-04-09,270,25558,28.5
13095,Dougherty County,2021-04-10,124,25682,28.6
13095,Dougherty County,2021-04-11,29,25711,28.7
13095,Dougherty County,2021-04-12,128,25839,28.8
13095,Dougherty County,2021-04-13,349,26188,29.2
13095,Dougherty County,2021-04-14,117,26305,29.3
13095,Dougherty County,2021-04-15,214,26519,29.6
13095,Dougherty County,2021-04-16,124,26643,29.7
13095,Dougherty County,2021-04-17,25,26668,29.7
13095,Dougherty County,2021-04-18,35,26703,29.8
13095,Dougherty County,2021-04-19,74,26777,29.9
13095,Dougherty County,2021-04-20,201,26978,30.1
13095,Dougherty County,2021-04-21,103,27081,30.2
13095,Dougherty County,2021-04-22,193,27274,30.4
13095,Dougherty County,2021-04-23,150,27424,30.6
13095,Dougherty County,2021-04-24,23,27447,30.6
13095,Dougherty County,2021-04-25,16,27463,30.6
13095,Dougherty County,2021-04-26,61,27524,30.7
13095,Dougherty County,2021-04-27,195,27719,30.9
13095,Dougherty County,2021-04-28,164,27883,31.1
13095,Dougherty County,2021-04-29,211,28094,31.3
13095,Dougherty County,2021-04-30,130,28224,31.5
13095,Dougherty County,2021-05-01,50,28274,31.5
13095,Dougherty County,2021-05-02,44,28318,31.6
13095,Dougherty County,2021-05-03,57,28375,31.6
13095,Dougherty County,2021-05-04,154,28529,31.8
13095,Dougherty County,2021-05-05,90,28619,31.9
13095,Dougherty County,2021-05-06,82,28701,32
13095,Dougherty County,2021-05-07,98,28799,32.1
13095,Dougherty County,2021-05-08,75,28874,32.2
13095,Dougherty County,2021-05-09,14,28888,32.2
13095,Dougherty County,2021-05-10,44,28932,32.3
13095,Dougherty County,2021-05-11,144,29076,32.4
13095,Dougherty County,2021-05-12,71,29147,32.5
13095,Dougherty County,2021-05-13,113,29260,32.6
13095,Dougherty County,2021-05-14,112,29372,32.7
13095,Dougherty County,2021-05-15,55,29427,32.8
13095,Dougherty County,2021-05-16,38,29465,32.8
13095,Dougherty County,2021-05-17,124,29589,33
13095,Dougherty County,2021-05-18,179,29768,33.2
13095,Dougherty County,2021-05-19,140,29908,33.3
13095,Dougherty County,2021-05-20,154,30062,33.5
13095,Dougherty County,2021-05-21,114,30176,33.6
13095,Dougherty County,2021-05-22,77,30253,33.7
13095,Dougherty County,2021-05-23,56,30309,33.8
13095,Dougherty County,2021-05-24,87,30396,33.9
13095,Dougherty County,2021-05-25,125,30521,34
13095,Dougherty County,2021-05-26,99,30620,34.1
13095,Dougherty County,2021-05-27,138,30758,34.3
13095,Dougherty County,2021-05-28,72,30830,34.4
13095,Dougherty County,2021-05-29,51,30881,34.4
13095,Dougherty County,2021-05-30,15,30896,34.4
13095,Dougherty County,2021-05-31,8,30904,34.5
13095,Dougherty County,2021-06-01,111,31015,34.6
13095,Dougherty County,2021-06-02,95,31110,34.7
13095,Dougherty County,2021-06-03,113,31223,34.8
13095,Dougherty County,2021-06-04,63,31286,34.9
13095,Dougherty County,2021-06-05,47,31333,34.9
13095,Dougherty County,2021-06-06,28,31361,35
13095,Dougherty County,2021-06-07,67,31428,35
13095,Dougherty County,2021-06-08,73,31501,35.1
13095,Dougherty County,2021-06-09,68,31569,35.2
13095,Dougherty County,2021-06-10,91,31660,35.3
13095,Dougherty County,2021-06-11,45,31705,35.3
13095,Dougherty County,2021-06-12,78,31783,35.4
13095,Dougherty County,2021-06-13,8,31791,35.4
13095,Dougherty County,2021-06-14,86,31877,35.5
13095,Dougherty County,2021-06-15,73,31950,35.6
13095,Dougherty County,2021-06-16,45,31995,35.7
13095,Dougherty County,2021-06-17,54,32049,35.7
13095,Dougherty County,2021-06-18,71,32120,35.8
13095,Dougherty County,2021-06-19,38,32158,35.8
13095,Dougherty County,2021-06-20,20,32178,35.9
13095,Dougherty County,2021-06-21,64,32242,35.9
13095,Dougherty County,2021-06-22,65,32307,36
13095,Dougherty County,2021-06-23,69,32376,36.1
13095,Dougherty County,2021-06-24,83,32459,36.2
13095,Dougherty County,2021-06-25,66,32525,36.3
13095,Dougherty County,2021-06-26,74,32599,36.3
13095,Dougherty County,2021-06-27,20,32619,36.4
13095,Dougherty County,2021-06-28,51,32670,36.4
13095,Dougherty County,2021-06-29,78,32748,36.5
13095,Dougherty County,2021-06-30,67,32815,36.6
13095,Dougherty County,2021-07-01,70,32885,36.7
13095,Dougherty County,2021-07-02,63,32948,36.7
13095,Dougherty County,2021-07-03,20,32968,36.8
13095,Dougherty County,2021-07-04,3,32971,36.8
13095,Dougherty County,2021-07-05,39,33010,36.8
13095,Dougherty County,2021-07-06,57,33067,36.9
13095,Dougherty County,2021-07-07,60,33127,36.9
13095,Dougherty County,2021-07-08,62,33189,37
13095,Dougherty County,2021-07-09,51,33240,37.1
13095,Dougherty County,2021-07-10,64,33304,37.1
13095,Dougherty County,2021-07-11,17,33321,37.1
13095,Dougherty County,2021-07-12,63,33384,37.2
13095,Dougherty County,2021-07-13,70,33454,37.3
13095,Dougherty County,2021-07-14,48,33502,37.3
13095,Dougherty County,2021-07-15,80,33582,37.4
13095,Dougherty County,2021-07-16,87,33669,37.5
13095,Dougherty County,2021-07-17,63,33732,37.6
13095,Dougherty County,2021-07-18,24,33756,37.6
13095,Dougherty County,2021-07-19,87,33843,37.7
13095,Dougherty County,2021-07-20,103,33946,37.8
13095,Dougherty County,2021-07-21,72,34018,37.9
13095,Dougherty County,2021-07-22,137,34155,38.1
13095,Dougherty County,2021-07-23,138,34293,38.2
13095,Dougherty County,2021-07-24,71,34364,38.3
13095,Dougherty County,2021-07-25,41,34405,38.4
13095,Dougherty County,2021-07-26,136,34541,38.5
13095,Dougherty County,2021-07-27,190,34731,38.7
13095,Dougherty County,2021-07-28,179,34910,38.9
13095,Dougherty County,2021-07-29,202,35112,39.1
13095,Dougherty County,2021-07-30,202,35314,39.4
13095,Dougherty County,2021-07-31,109,35423,39.5
13095,Dougherty County,2021-08-01,71,35494,39.6
13095,Dougherty County,2021-08-02,151,35645,39.7
13095,Dougherty County,2021-08-03,180,35825,39.9
13095,Dougherty County,2021-08-04,204,36029,40.2
13095,Dougherty County,2021-08-05,235,36264,40.4
13095,Dougherty County,2021-08-06,230,36494,40.7
13095,Dougherty County,2021-08-07,177,36671,40.9
13095,Dougherty County,2021-08-08,163,36834,41.1
13095,Dougherty County,2021-08-09,201,37035,41.3
13095,Dougherty County,2021-08-10,268,37303,41.6
13095,Dougherty County,2021-08-11,221,37524,41.8
13095,Dougherty County,2021-08-12,256,37780,42.1
13095,Dougherty County,2021-08-13,281,38061,42.4
13095,Dougherty County,2021-08-14,151,38212,42.6
13095,Dougherty County,2021-08-15,96,38308,42.7
13095,Dougherty County,2021-08-16,171,38479,42.9
13095,Dougherty County,2021-08-17,255,38734,43.2
13095,Dougherty County,2021-08-18,237,38971,43.4
13095,Dougherty County,2021-08-19,242,39213,43.7
13095,Dougherty County,2021-08-20,225,39438,44
13095,Dougherty County,2021-08-21,99,39537,44.1
13095,Dougherty County,2021-08-22,61,39598,44.1
13095,Dougherty County,2021-08-23,124,39722,44.3
13095,Dougherty County,2021-08-24,214,39936,44.5
13095,Dougherty County,2021-08-25,149,40085,44.7
13095,Dougherty County,2021-08-26,189,40274,44.9
13095,Dougherty County,2021-08-27,182,40456,45.1
13095,Dougherty County,2021-08-28,103,40559,45.2
13095,Dougherty County,2021-08-29,106,40665,45.3
13095,Dougherty County,2021-08-30,153,40818,45.5
13095,Dougherty County,2021-08-31,159,40977,45.7
13095,Dougherty County,2021-09-01,159,41136,45.9
13095,Dougherty County,2021-09-02,162,41298,46
13095,Dougherty County,2021-09-03,207,41505,46.3
13095,Dougherty County,2021-09-04,98,41603,46.4
13095,Dougherty County,2021-09-05,43,41646,46.4
13095,Dougherty County,2021-09-06,39,41685,46.5
13095,Dougherty County,2021-09-07,108,41793,46.6
13095,Dougherty County,2021-09-08,137,41930,46.7
13095,Dougherty County,2021-09-09,122,42052,46.9
13095,Dougherty County,2021-09-10,141,42193,47
13095,Dougherty County,2021-09-11,79,42272,47.1
13095,Dougherty County,2021-09-12,50,42322,47.2
13095,Dougherty County,2021-09-13,103,42425,47.3
13095,Dougherty County,2021-09-14,119,42544,47.4
13095,Dougherty County,2021-09-15,92,42636,47.5
13095,Dougherty County,2021-09-16,79,42715,47.6
13095,Dougherty County,2021-09-17,89,42804,47.7
13095,Dougherty County,2021-09-18,68,42872,47.8
13095,Dougherty County,2021-09-19,26,42898,47.8
13095,Dougherty County,2021-09-20,62,42960,47.9
13095,Dougherty County,2021-09-21,84,43044,48
13095,Dougherty County,2021-09-22,82,43126,48.1
13095,Dougherty County,2021-09-23,88,43214,48.2
13095,Dougherty County,2021-09-24,74,43288,48.3
13095,Dougherty County,2021-09-25,48,43336,48.3
13095,Dougherty County,2021-09-26,20,43356,48.3
13095,Dougherty County,2021-09-27,47,43403,48.4
13095,Dougherty County,2021-09-28,51,43454,48.4
13095,Dougherty County,2021-09-29,50,43504,48.5
13095,Dougherty County,2021-09-30,57,43561,48.6
13095,Dougherty County,2021-10-01,56,43617,48.6
13095,Dougherty County,2021-10-02,26,43643,48.7
13095,Dougherty County,2021-10-03,11,43654,48.7
13095,Dougherty County,2021-10-04,18,43672,48.7
13095,Dougherty County,2021-10-05,36,43708,48.7
13095,Dougherty County,2021-10-06,30,43738,48.8
13095,Dougherty County,2021-10-07,30,43768,48.8
13097,Douglas County,2020-12-17,8,8,0
13097,Douglas County,2020-12-18,21,29,0
13097,Douglas County,2020-12-19,15,44,0
13097,Douglas County,2020-12-20,21,65,0
13097,Douglas County,2020-12-21,64,129,0.1
13097,Douglas County,2020-12-22,166,295,0.2
13097,Douglas County,2020-12-23,151,446,0.3
13097,Douglas County,2020-12-24,17,463,0.3
13097,Douglas County,2020-12-26,5,468,0.3
13097,Douglas County,2020-12-27,10,478,0.3
13097,Douglas County,2020-12-28,139,617,0.4
13097,Douglas County,2020-12-29,128,745,0.5
13097,Douglas County,2020-12-30,150,895,0.6
13097,Douglas County,2020-12-31,65,960,0.7
13097,Douglas County,2021-01-01,20,980,0.7
13097,Douglas County,2021-01-02,26,1006,0.7
13097,Douglas County,2021-01-03,15,1021,0.7
13097,Douglas County,2021-01-04,192,1213,0.8
13097,Douglas County,2021-01-05,159,1372,1
13097,Douglas County,2021-01-06,104,1476,1
13097,Douglas County,2021-01-07,196,1672,1.2
13097,Douglas County,2021-01-08,154,1826,1.3
13097,Douglas County,2021-01-09,52,1878,1.3
13097,Douglas County,2021-01-10,26,1904,1.3
13097,Douglas County,2021-01-11,141,2045,1.4
13097,Douglas County,2021-01-12,260,2305,1.6
13097,Douglas County,2021-01-13,256,2561,1.8
13097,Douglas County,2021-01-14,347,2908,2
13097,Douglas County,2021-01-15,276,3184,2.2
13097,Douglas County,2021-01-16,178,3362,2.3
13097,Douglas County,2021-01-17,94,3456,2.4
13097,Douglas County,2021-01-18,264,3720,2.6
13097,Douglas County,2021-01-19,456,4176,2.9
13097,Douglas County,2021-01-20,464,4640,3.2
13097,Douglas County,2021-01-21,375,5015,3.5
13097,Douglas County,2021-01-22,413,5428,3.8
13097,Douglas County,2021-01-23,109,5537,3.9
13097,Douglas County,2021-01-24,22,5559,3.9
13097,Douglas County,2021-01-25,358,5917,4.1
13097,Douglas County,2021-01-26,345,6262,4.4
13097,Douglas County,2021-01-27,493,6755,4.7
13097,Douglas County,2021-01-28,551,7306,5.1
13097,Douglas County,2021-01-29,344,7650,5.3
13097,Douglas County,2021-01-30,125,7775,5.4
13097,Douglas County,2021-01-31,56,7831,5.5
13097,Douglas County,2021-02-01,246,8077,5.6
13097,Douglas County,2021-02-02,300,8377,5.8
13097,Douglas County,2021-02-03,269,8646,6
13097,Douglas County,2021-02-04,364,9010,6.3
13097,Douglas County,2021-02-05,224,9234,6.4
13097,Douglas County,2021-02-06,51,9285,6.5
13097,Douglas County,2021-02-07,16,9301,6.5
13097,Douglas County,2021-02-08,158,9459,6.6
13097,Douglas County,2021-02-09,170,9629,6.7
13097,Douglas County,2021-02-10,150,9779,6.8
13097,Douglas County,2021-02-11,108,9887,6.9
13097,Douglas County,2021-02-12,109,9996,7
13097,Douglas County,2021-02-13,76,10072,7
13097,Douglas County,2021-02-14,25,10097,7
13097,Douglas County,2021-02-15,123,10220,7.1
13097,Douglas County,2021-02-16,152,10372,7.2
13097,Douglas County,2021-02-17,208,10580,7.4
13097,Douglas County,2021-02-18,244,10824,7.6
13097,Douglas County,2021-02-19,176,11000,7.7
13097,Douglas County,2021-02-20,39,11039,7.7
13097,Douglas County,2021-02-21,16,11055,7.7
13097,Douglas County,2021-02-22,108,11163,7.8
13097,Douglas County,2021-02-23,294,11457,8
13097,Douglas County,2021-02-24,194,11651,8.1
13097,Douglas County,2021-02-25,266,11917,8.3
13097,Douglas County,2021-02-26,368,12285,8.6
13097,Douglas County,2021-02-27,167,12452,8.7
13097,Douglas County,2021-02-28,116,12568,8.8
13097,Douglas County,2021-03-01,246,12814,8.9
13097,Douglas County,2021-03-02,371,13185,9.2
13097,Douglas County,2021-03-03,359,13544,9.5
13097,Douglas County,2021-03-04,279,13823,9.6
13097,Douglas County,2021-03-05,417,14240,9.9
13097,Douglas County,2021-03-06,132,14372,10
13097,Douglas County,2021-03-07,115,14487,10.1
13097,Douglas County,2021-03-08,479,14966,10.4
13097,Douglas County,2021-03-09,644,15610,10.9
13097,Douglas County,2021-03-10,620,16230,11.3
13097,Douglas County,2021-03-11,470,16700,11.7
13097,Douglas County,2021-03-12,785,17485,12.2
13097,Douglas County,2021-03-13,517,18002,12.6
13097,Douglas County,2021-03-14,119,18121,12.6
13097,Douglas County,2021-03-15,626,18747,13.1
13097,Douglas County,2021-03-16,853,19600,13.7
13097,Douglas County,2021-03-17,849,20449,14.3
13097,Douglas County,2021-03-18,569,21018,14.7
13097,Douglas County,2021-03-19,766,21784,15.2
13097,Douglas County,2021-03-20,380,22164,15.5
13097,Douglas County,2021-03-21,218,22382,15.6
13097,Douglas County,2021-03-22,509,22891,16
13097,Douglas County,2021-03-23,868,23759,16.6
13097,Douglas County,2021-03-24,860,24619,17.2
13097,Douglas County,2021-03-25,884,25503,17.8
13097,Douglas County,2021-03-26,656,26159,18.3
13097,Douglas County,2021-03-27,450,26609,18.6
13097,Douglas County,2021-03-28,237,26846,18.7
13097,Douglas County,2021-03-29,709,27555,19.2
13097,Douglas County,2021-03-30,1062,28617,20
13097,Douglas County,2021-03-31,1086,29703,20.7
13097,Douglas County,2021-04-01,964,30667,21.4
13097,Douglas County,2021-04-02,670,31337,21.9
13097,Douglas County,2021-04-03,382,31719,22.1
13097,Douglas County,2021-04-04,233,31952,22.3
13097,Douglas County,2021-04-05,645,32597,22.7
13097,Douglas County,2021-04-06,1046,33643,23.5
13097,Douglas County,2021-04-07,830,34473,24.1
13097,Douglas County,2021-04-08,970,35443,24.7
13097,Douglas County,2021-04-09,786,36229,25.3
13097,Douglas County,2021-04-10,566,36795,25.7
13097,Douglas County,2021-04-11,190,36985,25.8
13097,Douglas County,2021-04-12,564,37549,26.2
13097,Douglas County,2021-04-13,643,38192,26.6
13097,Douglas County,2021-04-14,560,38752,27
13097,Douglas County,2021-04-15,498,39250,27.4
13097,Douglas County,2021-04-16,387,39637,27.7
13097,Douglas County,2021-04-17,170,39807,27.8
13097,Douglas County,2021-04-18,144,39951,27.9
13097,Douglas County,2021-04-19,334,40285,28.1
13097,Douglas County,2021-04-20,476,40761,28.4
13097,Douglas County,2021-04-21,370,41131,28.7
13097,Douglas County,2021-04-22,412,41543,29
13097,Douglas County,2021-04-23,413,41956,29.3
13097,Douglas County,2021-04-24,200,42156,29.4
13097,Douglas County,2021-04-25,80,42236,29.5
13097,Douglas County,2021-04-26,378,42614,29.7
13097,Douglas County,2021-04-27,341,42955,30
13097,Douglas County,2021-04-28,411,43366,30.3
13097,Douglas County,2021-04-29,315,43681,30.5
13097,Douglas County,2021-04-30,429,44110,30.8
13097,Douglas County,2021-05-01,231,44341,30.9
13097,Douglas County,2021-05-02,95,44436,31
13097,Douglas County,2021-05-03,217,44653,31.2
13097,Douglas County,2021-05-04,283,44936,31.4
13097,Douglas County,2021-05-05,267,45203,31.5
13097,Douglas County,2021-05-06,257,45460,31.7
13097,Douglas County,2021-05-07,295,45755,31.9
13097,Douglas County,2021-05-08,204,45959,32.1
13097,Douglas County,2021-05-09,77,46036,32.1
13097,Douglas County,2021-05-10,153,46189,32.2
13097,Douglas County,2021-05-11,273,46462,32.4
13097,Douglas County,2021-05-12,230,46692,32.6
13097,Douglas County,2021-05-13,250,46942,32.8
13097,Douglas County,2021-05-14,384,47326,33
13097,Douglas County,2021-05-15,417,47743,33.3
13097,Douglas County,2021-05-16,112,47855,33.4
13097,Douglas County,2021-05-17,319,48174,33.6
13097,Douglas County,2021-05-18,286,48460,33.8
13097,Douglas County,2021-05-19,302,48762,34
13097,Douglas County,2021-05-20,219,48981,34.2
13097,Douglas County,2021-05-21,312,49293,34.4
13097,Douglas County,2021-05-22,265,49558,34.6
13097,Douglas County,2021-05-23,95,49653,34.6
13097,Douglas County,2021-05-24,177,49830,34.8
13097,Douglas County,2021-05-25,188,50018,34.9
13097,Douglas County,2021-05-26,220,50238,35.1
13097,Douglas County,2021-05-27,194,50432,35.2
13097,Douglas County,2021-05-28,203,50635,35.3
13097,Douglas County,2021-05-29,106,50741,35.4
13097,Douglas County,2021-05-30,77,50818,35.5
13097,Douglas County,2021-05-31,20,50838,35.5
13097,Douglas County,2021-06-01,177,51015,35.6
13097,Douglas County,2021-06-02,221,51236,35.8
13097,Douglas County,2021-06-03,163,51399,35.9
13097,Douglas County,2021-06-04,188,51587,36
13097,Douglas County,2021-06-05,130,51717,36.1
13097,Douglas County,2021-06-06,63,51780,36.1
13097,Douglas County,2021-06-07,129,51909,36.2
13097,Douglas County,2021-06-08,136,52045,36.3
13097,Douglas County,2021-06-09,130,52175,36.4
13097,Douglas County,2021-06-10,165,52340,36.5
13097,Douglas County,2021-06-11,173,52513,36.6
13097,Douglas County,2021-06-12,100,52613,36.7
13097,Douglas County,2021-06-13,66,52679,36.8
13097,Douglas County,2021-06-14,147,52826,36.9
13097,Douglas County,2021-06-15,116,52942,36.9
13097,Douglas County,2021-06-16,158,53100,37.1
13097,Douglas County,2021-06-17,119,53219,37.1
13097,Douglas County,2021-06-18,153,53372,37.2
13097,Douglas County,2021-06-19,128,53500,37.3
13097,Douglas County,2021-06-20,50,53550,37.4
13097,Douglas County,2021-06-21,168,53718,37.5
13097,Douglas County,2021-06-22,203,53921,37.6
13097,Douglas County,2021-06-23,204,54125,37.8
13097,Douglas County,2021-06-24,105,54230,37.8
13097,Douglas County,2021-06-25,126,54356,37.9
13097,Douglas County,2021-06-26,82,54438,38
13097,Douglas County,2021-06-27,49,54487,38
13097,Douglas County,2021-06-28,100,54587,38.1
13097,Douglas County,2021-06-29,124,54711,38.2
13097,Douglas County,2021-06-30,121,54832,38.3
13097,Douglas County,2021-07-01,104,54936,38.3
13097,Douglas County,2021-07-02,107,55043,38.4
13097,Douglas County,2021-07-03,88,55131,38.5
13097,Douglas County,2021-07-04,3,55134,38.5
13097,Douglas County,2021-07-05,101,55235,38.5
13097,Douglas County,2021-07-06,100,55335,38.6
13097,Douglas County,2021-07-07,110,55445,38.7
13097,Douglas County,2021-07-08,115,55560,38.8
13097,Douglas County,2021-07-09,127,55687,38.9
13097,Douglas County,2021-07-10,91,55778,38.9
13097,Douglas County,2021-07-11,55,55833,39
13097,Douglas County,2021-07-12,139,55972,39.1
13097,Douglas County,2021-07-13,118,56090,39.1
13097,Douglas County,2021-07-14,149,56239,39.2
13097,Douglas County,2021-07-15,86,56325,39.3
13097,Douglas County,2021-07-16,155,56480,39.4
13097,Douglas County,2021-07-17,110,56590,39.5
13097,Douglas County,2021-07-18,69,56659,39.5
13097,Douglas County,2021-07-19,140,56799,39.6
13097,Douglas County,2021-07-20,159,56958,39.7
13097,Douglas County,2021-07-21,155,57113,39.9
13097,Douglas County,2021-07-22,159,57272,40
13097,Douglas County,2021-07-23,247,57519,40.1
13097,Douglas County,2021-07-24,166,57685,40.3
13097,Douglas County,2021-07-25,130,57815,40.3
13097,Douglas County,2021-07-26,232,58047,40.5
13097,Douglas County,2021-07-27,240,58287,40.7
13097,Douglas County,2021-07-28,242,58529,40.8
13097,Douglas County,2021-07-29,294,58823,41
13097,Douglas County,2021-07-30,282,59105,41.2
13097,Douglas County,2021-07-31,158,59263,41.4
13097,Douglas County,2021-08-01,121,59384,41.4
13097,Douglas County,2021-08-02,262,59646,41.6
13097,Douglas County,2021-08-03,250,59896,41.8
13097,Douglas County,2021-08-04,244,60140,42
13097,Douglas County,2021-08-05,247,60387,42.1
13097,Douglas County,2021-08-06,304,60691,42.3
13097,Douglas County,2021-08-07,211,60902,42.5
13097,Douglas County,2021-08-08,134,61036,42.6
13097,Douglas County,2021-08-09,211,61247,42.7
13097,Douglas County,2021-08-10,282,61529,42.9
13097,Douglas County,2021-08-11,217,61746,43.1
13097,Douglas County,2021-08-12,257,62003,43.3
13097,Douglas County,2021-08-13,279,62282,43.5
13097,Douglas County,2021-08-14,211,62493,43.6
13097,Douglas County,2021-08-15,73,62566,43.7
13097,Douglas County,2021-08-16,232,62798,43.8
13097,Douglas County,2021-08-17,238,63036,44
13097,Douglas County,2021-08-18,246,63282,44.2
13097,Douglas County,2021-08-19,254,63536,44.3
13097,Douglas County,2021-08-20,258,63794,44.5
13097,Douglas County,2021-08-21,178,63972,44.6
13097,Douglas County,2021-08-22,76,64048,44.7
13097,Douglas County,2021-08-23,238,64286,44.9
13097,Douglas County,2021-08-24,218,64504,45
13097,Douglas County,2021-08-25,204,64708,45.2
13097,Douglas County,2021-08-26,235,64943,45.3
13097,Douglas County,2021-08-27,261,65204,45.5
13097,Douglas County,2021-08-28,195,65399,45.6
13097,Douglas County,2021-08-29,76,65475,45.7
13097,Douglas County,2021-08-30,195,65670,45.8
13097,Douglas County,2021-08-31,167,65837,45.9
13097,Douglas County,2021-09-01,198,66035,46.1
13097,Douglas County,2021-09-02,205,66240,46.2
13097,Douglas County,2021-09-03,264,66504,46.4
13097,Douglas County,2021-09-04,167,66671,46.5
13097,Douglas County,2021-09-05,87,66758,46.6
13097,Douglas County,2021-09-06,22,66780,46.6
13097,Douglas County,2021-09-07,180,66960,46.7
13097,Douglas County,2021-09-08,206,67166,46.9
13097,Douglas County,2021-09-09,200,67366,47
13097,Douglas County,2021-09-10,217,67583,47.2
13097,Douglas County,2021-09-11,150,67733,47.3
13097,Douglas County,2021-09-12,88,67821,47.3
13097,Douglas County,2021-09-13,205,68026,47.5
13097,Douglas County,2021-09-14,198,68224,47.6
13097,Douglas County,2021-09-15,152,68376,47.7
13097,Douglas County,2021-09-16,150,68526,47.8
13097,Douglas County,2021-09-17,167,68693,47.9
13097,Douglas County,2021-09-18,117,68810,48
13097,Douglas County,2021-09-19,43,68853,48
13097,Douglas County,2021-09-20,110,68963,48.1
13097,Douglas County,2021-09-21,113,69076,48.2
13097,Douglas County,2021-09-22,117,69193,48.3
13097,Douglas County,2021-09-23,86,69279,48.3
13097,Douglas County,2021-09-24,82,69361,48.4
13097,Douglas County,2021-09-25,61,69422,48.4
13097,Douglas County,2021-09-26,30,69452,48.5
13097,Douglas County,2021-09-27,57,69509,48.5
13097,Douglas County,2021-09-28,49,69558,48.5
13097,Douglas County,2021-09-29,57,69615,48.6
13097,Douglas County,2021-09-30,48,69663,48.6
13097,Douglas County,2021-10-01,69,69732,48.7
13097,Douglas County,2021-10-02,32,69764,48.7
13097,Douglas County,2021-10-03,31,69795,48.7
13097,Douglas County,2021-10-04,27,69822,48.7
13097,Douglas County,2021-10-05,38,69860,48.7
13097,Douglas County,2021-10-06,35,69895,48.8
13097,Douglas County,2021-10-07,19,69914,48.8
13099,Early County,2020-12-18,2,2,0
13099,Early County,2020-12-19,1,3,0
13099,Early County,2020-12-20,1,4,0
13099,Early County,2020-12-21,2,6,0.1
13099,Early County,2020-12-22,3,9,0.1
13099,Early County,2020-12-23,42,51,0.5
13099,Early County,2020-12-24,5,56,0.5
13099,Early County,2020-12-26,1,57,0.6
13099,Early County,2020-12-27,3,60,0.6
13099,Early County,2020-12-28,23,83,0.8
13099,Early County,2020-12-29,31,114,1.1
13099,Early County,2020-12-30,20,134,1.3
13099,Early County,2020-12-31,20,154,1.5
13099,Early County,2021-01-01,8,162,1.6
13099,Early County,2021-01-03,1,163,1.6
13099,Early County,2021-01-04,28,191,1.9
13099,Early County,2021-01-05,17,208,2
13099,Early County,2021-01-06,20,228,2.2
13099,Early County,2021-01-07,17,245,2.4
13099,Early County,2021-01-08,59,304,2.9
13099,Early County,2021-01-11,89,393,3.8
13099,Early County,2021-01-12,152,545,5.3
13099,Early County,2021-01-13,95,640,6.2
13099,Early County,2021-01-14,181,821,8
13099,Early County,2021-01-15,107,928,9
13099,Early County,2021-01-16,67,995,9.6
13099,Early County,2021-01-18,88,1083,10.5
13099,Early County,2021-01-19,66,1149,11.1
13099,Early County,2021-01-20,60,1209,11.7
13099,Early County,2021-01-21,74,1283,12.4
13099,Early County,2021-01-22,53,1336,13
13099,Early County,2021-01-23,4,1340,13
13099,Early County,2021-01-25,53,1393,13.5
13099,Early County,2021-01-26,51,1444,14
13099,Early County,2021-01-27,35,1479,14.3
13099,Early County,2021-01-28,38,1517,14.7
13099,Early County,2021-01-29,40,1557,15.1
13099,Early County,2021-01-30,1,1558,15.1
13099,Early County,2021-01-31,1,1559,15.1
13099,Early County,2021-02-01,31,1590,15.4
13099,Early County,2021-02-02,42,1632,15.8
13099,Early County,2021-02-03,44,1676,16.3
13099,Early County,2021-02-04,47,1723,16.7
13099,Early County,2021-02-05,22,1745,16.9
13099,Early County,2021-02-06,1,1746,16.9
13099,Early County,2021-02-08,68,1814,17.6
13099,Early County,2021-02-09,25,1839,17.8
13099,Early County,2021-02-10,21,1860,18
13099,Early County,2021-02-11,9,1869,18.1
13099,Early County,2021-02-12,21,1890,18.3
13099,Early County,2021-02-14,1,1891,18.3
13099,Early County,2021-02-15,6,1897,18.4
13099,Early County,2021-02-16,38,1935,18.8
13099,Early County,2021-02-17,12,1947,18.9
13099,Early County,2021-02-18,19,1966,19.1
13099,Early County,2021-02-19,7,1973,19.1
13099,Early County,2021-02-21,1,1974,19.1
13099,Early County,2021-02-22,9,1983,19.2
13099,Early County,2021-02-23,11,1994,19.3
13099,Early County,2021-02-24,26,2020,19.6
13099,Early County,2021-02-25,61,2081,20.2
13099,Early County,2021-02-26,8,2089,20.3
13099,Early County,2021-02-27,1,2090,20.3
13099,Early County,2021-03-01,9,2099,20.4
13099,Early County,2021-03-02,30,2129,20.6
13099,Early County,2021-03-03,15,2144,20.8
13099,Early County,2021-03-04,12,2156,20.9
13099,Early County,2021-03-05,10,2166,21
13099,Early County,2021-03-08,124,2290,22.2
13099,Early County,2021-03-09,58,2348,22.8
13099,Early County,2021-03-10,43,2391,23.2
13099,Early County,2021-03-11,37,2428,23.5
13099,Early County,2021-03-12,33,2461,23.9
13099,Early County,2021-03-13,28,2489,24.1
13099,Early County,2021-03-14,1,2490,24.1
13099,Early County,2021-03-15,50,2540,24.6
13099,Early County,2021-03-16,25,2565,24.9
13099,Early County,2021-03-17,40,2605,25.3
13099,Early County,2021-03-18,11,2616,25.4
13099,Early County,2021-03-19,45,2661,25.8
13099,Early County,2021-03-20,2,2663,25.8
13099,Early County,2021-03-21,1,2664,25.8
13099,Early County,2021-03-22,20,2684,26
13099,Early County,2021-03-23,21,2705,26.2
13099,Early County,2021-03-24,33,2738,26.6
13099,Early County,2021-03-25,35,2773,26.9
13099,Early County,2021-03-26,70,2843,27.6
13099,Early County,2021-03-28,1,2844,27.6
13099,Early County,2021-03-29,36,2880,27.9
13099,Early County,2021-03-30,49,2929,28.4
13099,Early County,2021-03-31,42,2971,28.8
13099,Early County,2021-04-01,26,2997,29.1
13099,Early County,2021-04-02,14,3011,29.2
13099,Early County,2021-04-03,2,3013,29.2
13099,Early County,2021-04-04,1,3014,29.2
13099,Early County,2021-04-05,30,3044,29.5
13099,Early County,2021-04-06,25,3069,29.8
13099,Early County,2021-04-07,47,3116,30.2
13099,Early County,2021-04-08,16,3132,30.4
13099,Early County,2021-04-09,22,3154,30.6
13099,Early County,2021-04-10,4,3158,30.6
13099,Early County,2021-04-12,15,3173,30.8
13099,Early County,2021-04-13,4,3177,30.8
13099,Early County,2021-04-14,22,3199,31
13099,Early County,2021-04-15,11,3210,31.1
13099,Early County,2021-04-16,32,3242,31.4
13099,Early County,2021-04-18,1,3243,31.4
13099,Early County,2021-04-19,11,3254,31.6
13099,Early County,2021-04-20,16,3270,31.7
13099,Early County,2021-04-21,18,3288,31.9
13099,Early County,2021-04-22,14,3302,32
13099,Early County,2021-04-23,19,3321,32.2
13099,Early County,2021-04-24,1,3322,32.2
13099,Early County,2021-04-26,20,3342,32.4
13099,Early County,2021-04-27,4,3346,32.4
13099,Early County,2021-04-28,19,3365,32.6
13099,Early County,2021-04-29,5,3370,32.7
13099,Early County,2021-04-30,16,3386,32.8
13099,Early County,2021-05-01,1,3387,32.8
13099,Early County,2021-05-02,3,3390,32.9
13099,Early County,2021-05-03,13,3403,33
13099,Early County,2021-05-04,8,3411,33.1
13099,Early County,2021-05-05,19,3430,33.3
13099,Early County,2021-05-06,4,3434,33.3
13099,Early County,2021-05-07,11,3445,33.4
13099,Early County,2021-05-08,1,3446,33.4
13099,Early County,2021-05-09,1,3447,33.4
13099,Early County,2021-05-10,5,3452,33.5
13099,Early County,2021-05-11,6,3458,33.5
13099,Early County,2021-05-12,18,3476,33.7
13099,Early County,2021-05-13,14,3490,33.8
13099,Early County,2021-05-14,7,3497,33.9
13099,Early County,2021-05-15,6,3503,34
13099,Early County,2021-05-16,1,3504,34
13099,Early County,2021-05-17,12,3516,34.1
13099,Early County,2021-05-18,10,3526,34.2
13099,Early County,2021-05-19,13,3539,34.3
13099,Early County,2021-05-20,6,3545,34.4
13099,Early County,2021-05-21,11,3556,34.5
13099,Early County,2021-05-24,13,3569,34.6
13099,Early County,2021-05-25,7,3576,34.7
13099,Early County,2021-05-26,12,3588,34.8
13099,Early County,2021-05-27,4,3592,34.8
13099,Early County,2021-05-28,8,3600,34.9
13099,Early County,2021-05-29,1,3601,34.9
13099,Early County,2021-06-01,8,3609,35
13099,Early County,2021-06-02,10,3619,35.1
13099,Early County,2021-06-03,6,3625,35.2
13099,Early County,2021-06-04,12,3637,35.3
13099,Early County,2021-06-05,2,3639,35.3
13099,Early County,2021-06-06,1,3640,35.3
13099,Early County,2021-06-07,7,3647,35.4
13099,Early County,2021-06-08,3,3650,35.4
13099,Early County,2021-06-09,7,3657,35.5
13099,Early County,2021-06-10,5,3662,35.5
13099,Early County,2021-06-11,12,3674,35.6
13099,Early County,2021-06-12,1,3675,35.6
13099,Early County,2021-06-13,2,3677,35.7
13099,Early County,2021-06-14,8,3685,35.7
13099,Early County,2021-06-15,1,3686,35.7
13099,Early County,2021-06-16,9,3695,35.8
13099,Early County,2021-06-17,5,3700,35.9
13099,Early County,2021-06-18,1,3701,35.9
13099,Early County,2021-06-19,2,3703,35.9
13099,Early County,2021-06-20,1,3704,35.9
13099,Early County,2021-06-21,14,3718,36.1
13099,Early County,2021-06-22,4,3722,36.1
13099,Early County,2021-06-23,5,3727,36.1
13099,Early County,2021-06-24,1,3728,36.2
13099,Early County,2021-06-25,19,3747,36.3
13099,Early County,2021-06-27,1,3748,36.3
13099,Early County,2021-06-28,11,3759,36.5
13099,Early County,2021-06-29,3,3762,36.5
13099,Early County,2021-06-30,11,3773,36.6
13099,Early County,2021-07-01,3,3776,36.6
13099,Early County,2021-07-02,5,3781,36.7
13099,Early County,2021-07-03,1,3782,36.7
13099,Early County,2021-07-05,5,3787,36.7
13099,Early County,2021-07-06,4,3791,36.8
13099,Early County,2021-07-07,12,3803,36.9
13099,Early County,2021-07-08,3,3806,36.9
13099,Early County,2021-07-09,13,3819,37
13099,Early County,2021-07-12,6,3825,37.1
13099,Early County,2021-07-13,8,3833,37.2
13099,Early County,2021-07-14,14,3847,37.3
13099,Early County,2021-07-15,7,3854,37.4
13099,Early County,2021-07-16,31,3885,37.7
13099,Early County,2021-07-17,1,3886,37.7
13099,Early County,2021-07-18,1,3887,37.7
13099,Early County,2021-07-19,13,3900,37.8
13099,Early County,2021-07-20,11,3911,37.9
13099,Early County,2021-07-21,19,3930,38.1
13099,Early County,2021-07-22,12,3942,38.2
13099,Early County,2021-07-23,23,3965,38.5
13099,Early County,2021-07-24,7,3972,38.5
13099,Early County,2021-07-25,1,3973,38.5
13099,Early County,2021-07-26,20,3993,38.7
13099,Early County,2021-07-27,25,4018,39
13099,Early County,2021-07-28,25,4043,39.2
13099,Early County,2021-07-29,25,4068,39.4
13099,Early County,2021-07-30,36,4104,39.8
13099,Early County,2021-07-31,9,4113,39.9
13099,Early County,2021-08-01,5,4118,39.9
13099,Early County,2021-08-02,43,4161,40.4
13099,Early County,2021-08-03,20,4181,40.5
13099,Early County,2021-08-04,54,4235,41.1
13099,Early County,2021-08-05,17,4252,41.2
13099,Early County,2021-08-06,47,4299,41.7
13099,Early County,2021-08-07,11,4310,41.8
13099,Early County,2021-08-08,2,4312,41.8
13099,Early County,2021-08-09,37,4349,42.2
13099,Early County,2021-08-10,26,4375,42.4
13099,Early County,2021-08-11,43,4418,42.8
13099,Early County,2021-08-12,27,4445,43.1
13099,Early County,2021-08-13,59,4504,43.7
13099,Early County,2021-08-14,10,4514,43.8
13099,Early County,2021-08-15,1,4515,43.8
13099,Early County,2021-08-16,28,4543,44.1
13099,Early County,2021-08-17,18,4561,44.2
13099,Early County,2021-08-18,59,4620,44.8
13099,Early County,2021-08-19,22,4642,45
13099,Early County,2021-08-20,44,4686,45.4
13099,Early County,2021-08-21,5,4691,45.5
13099,Early County,2021-08-22,5,4696,45.5
13099,Early County,2021-08-23,44,4740,46
13099,Early County,2021-08-24,31,4771,46.3
13099,Early County,2021-08-25,43,4814,46.7
13099,Early County,2021-08-26,35,4849,47
13099,Early County,2021-08-27,24,4873,47.3
13099,Early County,2021-08-28,16,4889,47.4
13099,Early County,2021-08-29,9,4898,47.5
13099,Early County,2021-08-30,36,4934,47.8
13099,Early County,2021-08-31,21,4955,48.1
13099,Early County,2021-09-01,23,4978,48.3
13099,Early County,2021-09-02,19,4997,48.5
13099,Early County,2021-09-03,27,5024,48.7
13099,Early County,2021-09-04,6,5030,48.8
13099,Early County,2021-09-05,2,5032,48.8
13099,Early County,2021-09-07,12,5044,48.9
13099,Early County,2021-09-08,12,5056,49
13099,Early County,2021-09-09,17,5073,49.2
13099,Early County,2021-09-10,14,5087,49.3
13099,Early County,2021-09-11,6,5093,49.4
13099,Early County,2021-09-12,3,5096,49.4
13099,Early County,2021-09-13,15,5111,49.6
13099,Early County,2021-09-14,6,5117,49.6
13099,Early County,2021-09-15,14,5131,49.8
13099,Early County,2021-09-16,6,5137,49.8
13099,Early County,2021-09-17,15,5152,50
13099,Early County,2021-09-18,3,5155,50
13099,Early County,2021-09-19,2,5157,50
13099,Early County,2021-09-20,15,5172,50.2
13099,Early County,2021-09-21,3,5175,50.2
13099,Early County,2021-09-22,11,5186,50.3
13099,Early County,2021-09-23,6,5192,50.3
13099,Early County,2021-09-24,9,5201,50.4
13099,Early County,2021-09-27,3,5204,50.5
13099,Early County,2021-09-28,4,5208,50.5
13099,Early County,2021-09-29,6,5214,50.6
13099,Early County,2021-09-30,2,5216,50.6
13099,Early County,2021-10-01,11,5227,50.7
13099,Early County,2021-10-02,1,5228,50.7
13099,Early County,2021-10-04,1,5229,50.7
13099,Early County,2021-10-05,4,5233,50.7
13099,Early County,2021-10-06,1,5234,50.8
13099,Early County,2021-10-07,4,5238,50.8
13101,Echols County,2020-12-21,1,1,0
13101,Echols County,2020-12-24,1,2,0.1
13101,Echols County,2020-12-28,1,3,0.1
13101,Echols County,2020-12-29,6,9,0.2
13101,Echols County,2021-01-04,2,11,0.3
13101,Echols County,2021-01-06,10,21,0.5
13101,Echols County,2021-01-07,1,22,0.6
13101,Echols County,2021-01-08,3,25,0.6
13101,Echols County,2021-01-09,1,26,0.7
13101,Echols County,2021-01-11,16,42,1.1
13101,Echols County,2021-01-12,10,52,1.3
13101,Echols County,2021-01-13,11,63,1.6
13101,Echols County,2021-01-14,16,79,2
13101,Echols County,2021-01-15,7,86,2.2
13101,Echols County,2021-01-16,1,87,2.2
13101,Echols County,2021-01-18,22,109,2.7
13101,Echols County,2021-01-19,9,118,3
13101,Echols County,2021-01-20,16,134,3.4
13101,Echols County,2021-01-21,20,154,3.9
13101,Echols County,2021-01-22,9,163,4.1
13101,Echols County,2021-01-25,8,171,4.3
13101,Echols County,2021-01-26,6,177,4.4
13101,Echols County,2021-01-27,11,188,4.7
13101,Echols County,2021-01-28,17,205,5.1
13101,Echols County,2021-01-29,10,215,5.4
13101,Echols County,2021-02-01,5,220,5.5
13101,Echols County,2021-02-02,7,227,5.7
13101,Echols County,2021-02-03,7,234,5.9
13101,Echols County,2021-02-04,26,260,6.5
13101,Echols County,2021-02-05,1,261,6.6
13101,Echols County,2021-02-08,2,263,6.6
13101,Echols County,2021-02-09,2,265,6.7
13101,Echols County,2021-02-10,1,266,6.7
13101,Echols County,2021-02-11,4,270,6.8
13101,Echols County,2021-02-12,2,272,6.8
13101,Echols County,2021-02-15,4,276,6.9
13101,Echols County,2021-02-16,1,277,7
13101,Echols County,2021-02-17,2,279,7
13101,Echols County,2021-02-18,6,285,7.2
13101,Echols County,2021-02-19,2,287,7.2
13101,Echols County,2021-02-22,4,291,7.3
13101,Echols County,2021-02-23,3,294,7.4
13101,Echols County,2021-02-24,3,297,7.5
13101,Echols County,2021-02-25,1,298,7.5
13101,Echols County,2021-02-26,3,301,7.6
13101,Echols County,2021-03-01,3,304,7.6
13101,Echols County,2021-03-02,4,308,7.7
13101,Echols County,2021-03-03,12,320,8
13101,Echols County,2021-03-04,12,332,8.3
13101,Echols County,2021-03-05,7,339,8.5
13101,Echols County,2021-03-08,18,357,9
13101,Echols County,2021-03-09,4,361,9.1
13101,Echols County,2021-03-10,2,363,9.1
13101,Echols County,2021-03-11,8,371,9.3
13101,Echols County,2021-03-12,13,384,9.6
13101,Echols County,2021-03-13,2,386,9.7
13101,Echols County,2021-03-14,1,387,9.7
13101,Echols County,2021-03-15,11,398,10
13101,Echols County,2021-03-16,8,406,10.2
13101,Echols County,2021-03-17,18,424,10.7
13101,Echols County,2021-03-18,11,435,10.9
13101,Echols County,2021-03-19,9,444,11.2
13101,Echols County,2021-03-20,1,445,11.2
13101,Echols County,2021-03-22,2,447,11.2
13101,Echols County,2021-03-23,12,459,11.5
13101,Echols County,2021-03-24,6,465,11.7
13101,Echols County,2021-03-25,8,473,11.9
13101,Echols County,2021-03-26,11,484,12.2
13101,Echols County,2021-03-27,2,486,12.2
13101,Echols County,2021-03-28,1,487,12.2
13101,Echols County,2021-03-29,6,493,12.4
13101,Echols County,2021-03-30,15,508,12.8
13101,Echols County,2021-03-31,12,520,13.1
13101,Echols County,2021-04-01,10,530,13.3
13101,Echols County,2021-04-02,5,535,13.4
13101,Echols County,2021-04-03,4,539,13.5
13101,Echols County,2021-04-05,18,557,14
13101,Echols County,2021-04-06,1,558,14
13101,Echols County,2021-04-07,5,563,14.1
13101,Echols County,2021-04-08,4,567,14.2
13101,Echols County,2021-04-09,17,584,14.7
13101,Echols County,2021-04-12,7,591,14.8
13101,Echols County,2021-04-13,10,601,15.1
13101,Echols County,2021-04-14,2,603,15.1
13101,Echols County,2021-04-15,12,615,15.4
13101,Echols County,2021-04-16,2,617,15.5
13101,Echols County,2021-04-19,10,627,15.7
13101,Echols County,2021-04-20,5,632,15.9
13101,Echols County,2021-04-21,6,638,16
13101,Echols County,2021-04-22,5,643,16.2
13101,Echols County,2021-04-23,128,771,19.4
13101,Echols County,2021-04-26,10,781,19.6
13101,Echols County,2021-04-27,3,784,19.7
13101,Echols County,2021-04-28,4,788,19.8
13101,Echols County,2021-04-29,5,793,19.9
13101,Echols County,2021-04-30,2,795,20
13101,Echols County,2021-05-01,1,796,20
13101,Echols County,2021-05-03,1,797,20
13101,Echols County,2021-05-04,1,798,20
13101,Echols County,2021-05-05,2,800,20.1
13101,Echols County,2021-05-06,3,803,20.2
13101,Echols County,2021-05-07,38,841,21.1
13101,Echols County,2021-05-11,1,842,21.2
13101,Echols County,2021-05-12,2,844,21.2
13101,Echols County,2021-05-13,2,846,21.3
13101,Echols County,2021-05-15,1,847,21.3
13101,Echols County,2021-05-17,2,849,21.3
13101,Echols County,2021-05-18,1,850,21.4
13101,Echols County,2021-05-19,3,853,21.4
13101,Echols County,2021-05-21,12,865,21.7
13101,Echols County,2021-05-22,1,866,21.8
13101,Echols County,2021-05-24,2,868,21.8
13101,Echols County,2021-05-26,7,875,22
13101,Echols County,2021-05-27,1,876,22
13101,Echols County,2021-05-28,1,877,22
13101,Echols County,2021-06-01,4,881,22.1
13101,Echols County,2021-06-02,2,883,22.2
13101,Echols County,2021-06-03,2,885,22.2
13101,Echols County,2021-06-04,5,890,22.4
13101,Echols County,2021-06-07,3,893,22.4
13101,Echols County,2021-06-08,2,895,22.5
13101,Echols County,2021-06-09,1,896,22.5
13101,Echols County,2021-06-11,1,897,22.5
13101,Echols County,2021-06-12,1,898,22.6
13101,Echols County,2021-06-18,2,900,22.6
13101,Echols County,2021-06-19,1,901,22.6
13101,Echols County,2021-06-20,2,903,22.7
13101,Echols County,2021-06-21,2,905,22.7
13101,Echols County,2021-06-22,3,908,22.8
13101,Echols County,2021-06-23,2,910,22.9
13101,Echols County,2021-06-24,10,920,23.1
13101,Echols County,2021-06-25,4,924,23.2
13101,Echols County,2021-06-28,2,926,23.3
13101,Echols County,2021-06-30,4,930,23.4
13101,Echols County,2021-07-01,3,933,23.4
13101,Echols County,2021-07-02,6,939,23.6
13101,Echols County,2021-07-03,3,942,23.7
13101,Echols County,2021-07-06,3,945,23.7
13101,Echols County,2021-07-08,3,948,23.8
13101,Echols County,2021-07-09,2,950,23.9
13101,Echols County,2021-07-10,1,951,23.9
13101,Echols County,2021-07-13,1,952,23.9
13101,Echols County,2021-07-14,6,958,24.1
13101,Echols County,2021-07-15,4,962,24.2
13101,Echols County,2021-07-16,1,963,24.2
13101,Echols County,2021-07-20,2,965,24.2
13101,Echols County,2021-07-21,3,968,24.3
13101,Echols County,2021-07-22,4,972,24.4
13101,Echols County,2021-07-23,7,979,24.6
13101,Echols County,2021-07-24,3,982,24.7
13101,Echols County,2021-07-27,7,989,24.8
13101,Echols County,2021-07-28,17,1006,25.3
13101,Echols County,2021-07-29,7,1013,25.4
13101,Echols County,2021-07-30,23,1036,26
13101,Echols County,2021-07-31,3,1039,26.1
13101,Echols County,2021-08-01,1,1040,26.1
13101,Echols County,2021-08-02,3,1043,26.2
13101,Echols County,2021-08-03,6,1049,26.4
13101,Echols County,2021-08-04,8,1057,26.6
13101,Echols County,2021-08-05,11,1068,26.8
13101,Echols County,2021-08-06,10,1078,27.1
13101,Echols County,2021-08-07,11,1089,27.4
13101,Echols County,2021-08-09,10,1099,27.6
13101,Echols County,2021-08-10,9,1108,27.8
13101,Echols County,2021-08-11,15,1123,28.2
13101,Echols County,2021-08-12,11,1134,28.5
13101,Echols County,2021-08-13,4,1138,28.6
13101,Echols County,2021-08-14,1,1139,28.6
13101,Echols County,2021-08-15,2,1141,28.7
13101,Echols County,2021-08-16,5,1146,28.8
13101,Echols County,2021-08-17,3,1149,28.9
13101,Echols County,2021-08-18,11,1160,29.1
13101,Echols County,2021-08-19,15,1175,29.5
13101,Echols County,2021-08-20,8,1183,29.7
13101,Echols County,2021-08-22,2,1185,29.8
13101,Echols County,2021-08-23,3,1188,29.8
13101,Echols County,2021-08-24,4,1192,29.9
13101,Echols County,2021-08-25,11,1203,30.2
13101,Echols County,2021-08-26,12,1215,30.5
13101,Echols County,2021-08-27,6,1221,30.7
13101,Echols County,2021-08-28,5,1226,30.8
13101,Echols County,2021-08-29,1,1227,30.8
13101,Echols County,2021-08-30,2,1229,30.9
13101,Echols County,2021-08-31,7,1236,31
13101,Echols County,2021-09-01,6,1242,31.2
13101,Echols County,2021-09-02,6,1248,31.3
13101,Echols County,2021-09-03,6,1254,31.5
13101,Echols County,2021-09-04,1,1255,31.5
13101,Echols County,2021-09-05,2,1257,31.6
13101,Echols County,2021-09-07,1,1258,31.6
13101,Echols County,2021-09-08,7,1265,31.8
13101,Echols County,2021-09-09,1,1266,31.8
13101,Echols County,2021-09-10,9,1275,32
13101,Echols County,2021-09-11,1,1276,32.1
13101,Echols County,2021-09-12,1,1277,32.1
13101,Echols County,2021-09-13,1,1278,32.1
13101,Echols County,2021-09-14,2,1280,32.2
13101,Echols County,2021-09-15,5,1285,32.3
13101,Echols County,2021-09-17,1,1286,32.3
13101,Echols County,2021-09-21,2,1288,32.4
13101,Echols County,2021-09-22,9,1297,32.6
13101,Echols County,2021-09-23,2,1299,32.6
13101,Echols County,2021-09-24,3,1302,32.7
13101,Echols County,2021-09-25,1,1303,32.7
13101,Echols County,2021-09-28,1,1304,32.8
13101,Echols County,2021-09-29,2,1306,32.8
13101,Echols County,2021-10-01,2,1308,32.9
13101,Echols County,2021-10-05,1,1309,32.9
13101,Echols County,2021-10-06,2,1311,32.9
13103,Effingham County,2020-12-15,5,5,0
13103,Effingham County,2020-12-16,47,52,0.1
13103,Effingham County,2020-12-17,19,71,0.1
13103,Effingham County,2020-12-18,81,152,0.3
13103,Effingham County,2020-12-19,12,164,0.3
13103,Effingham County,2020-12-20,3,167,0.3
13103,Effingham County,2020-12-21,97,264,0.4
13103,Effingham County,2020-12-22,54,318,0.5
13103,Effingham County,2020-12-23,66,384,0.6
13103,Effingham County,2020-12-24,13,397,0.7
13103,Effingham County,2020-12-27,8,405,0.7
13103,Effingham County,2020-12-28,65,470,0.8
13103,Effingham County,2020-12-29,38,508,0.8
13103,Effingham County,2020-12-30,93,601,1
13103,Effingham County,2020-12-31,17,618,1
13103,Effingham County,2021-01-01,9,627,1
13103,Effingham County,2021-01-02,5,632,1
13103,Effingham County,2021-01-03,2,634,1
13103,Effingham County,2021-01-04,29,663,1.1
13103,Effingham County,2021-01-05,60,723,1.2
13103,Effingham County,2021-01-06,89,812,1.3
13103,Effingham County,2021-01-07,98,910,1.5
13103,Effingham County,2021-01-08,42,952,1.6
13103,Effingham County,2021-01-09,19,971,1.6
13103,Effingham County,2021-01-10,5,976,1.6
13103,Effingham County,2021-01-11,147,1123,1.9
13103,Effingham County,2021-01-12,57,1180,2
13103,Effingham County,2021-01-13,75,1255,2.1
13103,Effingham County,2021-01-14,262,1517,2.5
13103,Effingham County,2021-01-15,85,1602,2.6
13103,Effingham County,2021-01-16,52,1654,2.7
13103,Effingham County,2021-01-17,23,1677,2.8
13103,Effingham County,2021-01-18,227,1904,3.1
13103,Effingham County,2021-01-19,114,2018,3.3
13103,Effingham County,2021-01-20,98,2116,3.5
13103,Effingham County,2021-01-21,204,2320,3.8
13103,Effingham County,2021-01-22,76,2396,4
13103,Effingham County,2021-01-23,48,2444,4
13103,Effingham County,2021-01-24,30,2474,4.1
13103,Effingham County,2021-01-25,190,2664,4.4
13103,Effingham County,2021-01-26,80,2744,4.5
13103,Effingham County,2021-01-27,146,2890,4.8
13103,Effingham County,2021-01-28,153,3043,5
13103,Effingham County,2021-01-29,178,3221,5.3
13103,Effingham County,2021-01-30,232,3453,5.7
13103,Effingham County,2021-01-31,32,3485,5.8
13103,Effingham County,2021-02-01,229,3714,6.1
13103,Effingham County,2021-02-02,178,3892,6.4
13103,Effingham County,2021-02-03,70,3962,6.6
13103,Effingham County,2021-02-04,92,4054,6.7
13103,Effingham County,2021-02-05,129,4183,6.9
13103,Effingham County,2021-02-06,193,4376,7.2
13103,Effingham County,2021-02-07,117,4493,7.4
13103,Effingham County,2021-02-08,119,4612,7.6
13103,Effingham County,2021-02-09,138,4750,7.9
13103,Effingham County,2021-02-10,41,4791,7.9
13103,Effingham County,2021-02-11,100,4891,8.1
13103,Effingham County,2021-02-12,239,5130,8.5
13103,Effingham County,2021-02-13,32,5162,8.5
13103,Effingham County,2021-02-14,10,5172,8.6
13103,Effingham County,2021-02-15,63,5235,8.7
13103,Effingham County,2021-02-16,183,5418,9
13103,Effingham County,2021-02-17,31,5449,9
13103,Effingham County,2021-02-18,87,5536,9.2
13103,Effingham County,2021-02-19,103,5639,9.3
13103,Effingham County,2021-02-20,18,5657,9.4
13103,Effingham County,2021-02-21,6,5663,9.4
13103,Effingham County,2021-02-22,120,5783,9.6
13103,Effingham County,2021-02-23,178,5961,9.9
13103,Effingham County,2021-02-24,43,6004,9.9
13103,Effingham County,2021-02-25,83,6087,10.1
13103,Effingham County,2021-02-26,53,6140,10.2
13103,Effingham County,2021-02-27,20,6160,10.2
13103,Effingham County,2021-02-28,29,6189,10.2
13103,Effingham County,2021-03-01,162,6351,10.5
13103,Effingham County,2021-03-02,212,6563,10.9
13103,Effingham County,2021-03-03,124,6687,11.1
13103,Effingham County,2021-03-04,119,6806,11.3
13103,Effingham County,2021-03-05,109,6915,11.4
13103,Effingham County,2021-03-06,16,6931,11.5
13103,Effingham County,2021-03-07,205,7136,11.8
13103,Effingham County,2021-03-08,225,7361,12.2
13103,Effingham County,2021-03-09,177,7538,12.5
13103,Effingham County,2021-03-10,120,7658,12.7
13103,Effingham County,2021-03-11,149,7807,12.9
13103,Effingham County,2021-03-12,261,8068,13.3
13103,Effingham County,2021-03-13,295,8363,13.8
13103,Effingham County,2021-03-14,43,8406,13.9
13103,Effingham County,2021-03-15,313,8719,14.4
13103,Effingham County,2021-03-16,297,9016,14.9
13103,Effingham County,2021-03-17,231,9247,15.3
13103,Effingham County,2021-03-18,315,9562,15.8
13103,Effingham County,2021-03-19,284,9846,16.3
13103,Effingham County,2021-03-20,174,10020,16.6
13103,Effingham County,2021-03-21,199,10219,16.9
13103,Effingham County,2021-03-22,232,10451,17.3
13103,Effingham County,2021-03-23,414,10865,18
13103,Effingham County,2021-03-24,323,11188,18.5
13103,Effingham County,2021-03-25,347,11535,19.1
13103,Effingham County,2021-03-26,354,11889,19.7
13103,Effingham County,2021-03-27,195,12084,20
13103,Effingham County,2021-03-28,53,12137,20.1
13103,Effingham County,2021-03-29,227,12364,20.4
13103,Effingham County,2021-03-30,393,12757,21.1
13103,Effingham County,2021-03-31,256,13013,21.5
13103,Effingham County,2021-04-01,257,13270,21.9
13103,Effingham County,2021-04-02,276,13546,22.4
13103,Effingham County,2021-04-03,82,13628,22.5
13103,Effingham County,2021-04-04,36,13664,22.6
13103,Effingham County,2021-04-05,174,13838,22.9
13103,Effingham County,2021-04-06,265,14103,23.3
13103,Effingham County,2021-04-07,184,14287,23.6
13103,Effingham County,2021-04-08,210,14497,24
13103,Effingham County,2021-04-09,187,14684,24.3
13103,Effingham County,2021-04-10,161,14845,24.5
13103,Effingham County,2021-04-11,24,14869,24.6
13103,Effingham County,2021-04-12,152,15021,24.8
13103,Effingham County,2021-04-13,153,15174,25.1
13103,Effingham County,2021-04-14,106,15280,25.3
13103,Effingham County,2021-04-15,119,15399,25.5
13103,Effingham County,2021-04-16,131,15530,25.7
13103,Effingham County,2021-04-17,52,15582,25.8
13103,Effingham County,2021-04-18,11,15593,25.8
13103,Effingham County,2021-04-19,46,15639,25.9
13103,Effingham County,2021-04-20,107,15746,26
13103,Effingham County,2021-04-21,75,15821,26.2
13103,Effingham County,2021-04-22,78,15899,26.3
13103,Effingham County,2021-04-23,96,15995,26.4
13103,Effingham County,2021-04-24,53,16048,26.5
13103,Effingham County,2021-04-25,19,16067,26.6
13103,Effingham County,2021-04-26,34,16101,26.6
13103,Effingham County,2021-04-27,101,16202,26.8
13103,Effingham County,2021-04-28,82,16284,26.9
13103,Effingham County,2021-04-29,66,16350,27
13103,Effingham County,2021-04-30,108,16458,27.2
13103,Effingham County,2021-05-01,42,16500,27.3
13103,Effingham County,2021-05-02,22,16522,27.3
13103,Effingham County,2021-05-03,54,16576,27.4
13103,Effingham County,2021-05-04,89,16665,27.6
13103,Effingham County,2021-05-05,51,16716,27.6
13103,Effingham County,2021-05-06,62,16778,27.7
13103,Effingham County,2021-05-07,65,16843,27.9
13103,Effingham County,2021-05-08,37,16880,27.9
13103,Effingham County,2021-05-09,6,16886,27.9
13103,Effingham County,2021-05-10,33,16919,28
13103,Effingham County,2021-05-11,85,17004,28.1
13103,Effingham County,2021-05-12,66,17070,28.2
13103,Effingham County,2021-05-13,89,17159,28.4
13103,Effingham County,2021-05-14,69,17228,28.5
13103,Effingham County,2021-05-15,55,17283,28.6
13103,Effingham County,2021-05-16,34,17317,28.6
13103,Effingham County,2021-05-17,71,17388,28.8
13103,Effingham County,2021-05-18,96,17484,28.9
13103,Effingham County,2021-05-19,64,17548,29
13103,Effingham County,2021-05-20,89,17637,29.2
13103,Effingham County,2021-05-21,84,17721,29.3
13103,Effingham County,2021-05-22,59,17780,29.4
13103,Effingham County,2021-05-23,23,17803,29.4
13103,Effingham County,2021-05-24,50,17853,29.5
13103,Effingham County,2021-05-25,66,17919,29.6
13103,Effingham County,2021-05-26,63,17982,29.7
13103,Effingham County,2021-05-27,75,18057,29.9
13103,Effingham County,2021-05-28,70,18127,30
13103,Effingham County,2021-05-29,24,18151,30
13103,Effingham County,2021-05-30,13,18164,30
13103,Effingham County,2021-05-31,6,18170,30
13103,Effingham County,2021-06-01,46,18216,30.1
13103,Effingham County,2021-06-02,46,18262,30.2
13103,Effingham County,2021-06-03,43,18305,30.3
13103,Effingham County,2021-06-04,65,18370,30.4
13103,Effingham County,2021-06-05,33,18403,30.4
13103,Effingham County,2021-06-06,13,18416,30.5
13103,Effingham County,2021-06-07,40,18456,30.5
13103,Effingham County,2021-06-08,32,18488,30.6
13103,Effingham County,2021-06-09,39,18527,30.6
13103,Effingham County,2021-06-10,30,18557,30.7
13103,Effingham County,2021-06-11,51,18608,30.8
13103,Effingham County,2021-06-12,26,18634,30.8
13103,Effingham County,2021-06-13,11,18645,30.8
13103,Effingham County,2021-06-14,30,18675,30.9
13103,Effingham County,2021-06-15,45,18720,31
13103,Effingham County,2021-06-16,27,18747,31
13103,Effingham County,2021-06-17,43,18790,31.1
13103,Effingham County,2021-06-18,26,18816,31.1
13103,Effingham County,2021-06-19,21,18837,31.1
13103,Effingham County,2021-06-20,6,18843,31.2
13103,Effingham County,2021-06-21,27,18870,31.2
13103,Effingham County,2021-06-22,35,18905,31.3
13103,Effingham County,2021-06-23,37,18942,31.3
13103,Effingham County,2021-06-24,36,18978,31.4
13103,Effingham County,2021-06-25,34,19012,31.4
13103,Effingham County,2021-06-26,22,19034,31.5
13103,Effingham County,2021-06-27,3,19037,31.5
13103,Effingham County,2021-06-28,31,19068,31.5
13103,Effingham County,2021-06-29,29,19097,31.6
13103,Effingham County,2021-06-30,46,19143,31.7
13103,Effingham County,2021-07-01,33,19176,31.7
13103,Effingham County,2021-07-02,30,19206,31.8
13103,Effingham County,2021-07-03,14,19220,31.8
13103,Effingham County,2021-07-04,2,19222,31.8
13103,Effingham County,2021-07-05,31,19253,31.8
13103,Effingham County,2021-07-06,28,19281,31.9
13103,Effingham County,2021-07-07,22,19303,31.9
13103,Effingham County,2021-07-08,23,19326,32
13103,Effingham County,2021-07-09,36,19362,32
13103,Effingham County,2021-07-10,22,19384,32.1
13103,Effingham County,2021-07-11,13,19397,32.1
13103,Effingham County,2021-07-12,22,19419,32.1
13103,Effingham County,2021-07-13,19,19438,32.1
13103,Effingham County,2021-07-14,29,19467,32.2
13103,Effingham County,2021-07-15,28,19495,32.2
13103,Effingham County,2021-07-16,41,19536,32.3
13103,Effingham County,2021-07-17,34,19570,32.4
13103,Effingham County,2021-07-18,24,19594,32.4
13103,Effingham County,2021-07-19,47,19641,32.5
13103,Effingham County,2021-07-20,52,19693,32.6
13103,Effingham County,2021-07-21,56,19749,32.7
13103,Effingham County,2021-07-22,64,19813,32.8
13103,Effingham County,2021-07-23,89,19902,32.9
13103,Effingham County,2021-07-24,56,19958,33
13103,Effingham County,2021-07-25,45,20003,33.1
13103,Effingham County,2021-07-26,95,20098,33.2
13103,Effingham County,2021-07-27,92,20190,33.4
13103,Effingham County,2021-07-28,89,20279,33.5
13103,Effingham County,2021-07-29,97,20376,33.7
13103,Effingham County,2021-07-30,120,20496,33.9
13103,Effingham County,2021-07-31,64,20560,34
13103,Effingham County,2021-08-01,45,20605,34.1
13103,Effingham County,2021-08-02,86,20691,34.2
13103,Effingham County,2021-08-03,86,20777,34.4
13103,Effingham County,2021-08-04,106,20883,34.5
13103,Effingham County,2021-08-05,95,20978,34.7
13103,Effingham County,2021-08-06,143,21121,34.9
13103,Effingham County,2021-08-07,82,21203,35.1
13103,Effingham County,2021-08-08,45,21248,35.1
13103,Effingham County,2021-08-09,96,21344,35.3
13103,Effingham County,2021-08-10,130,21474,35.5
13103,Effingham County,2021-08-11,139,21613,35.7
13103,Effingham County,2021-08-12,128,21741,35.9
13103,Effingham County,2021-08-13,178,21919,36.2
13103,Effingham County,2021-08-14,102,22021,36.4
13103,Effingham County,2021-08-15,57,22078,36.5
13103,Effingham County,2021-08-16,108,22186,36.7
13103,Effingham County,2021-08-17,134,22320,36.9
13103,Effingham County,2021-08-18,114,22434,37.1
13103,Effingham County,2021-08-19,155,22589,37.4
13103,Effingham County,2021-08-20,190,22779,37.7
13103,Effingham County,2021-08-21,83,22862,37.8
13103,Effingham County,2021-08-22,40,22902,37.9
13103,Effingham County,2021-08-23,96,22998,38
13103,Effingham County,2021-08-24,120,23118,38.2
13103,Effingham County,2021-08-25,135,23253,38.4
13103,Effingham County,2021-08-26,170,23423,38.7
13103,Effingham County,2021-08-27,165,23588,39
13103,Effingham County,2021-08-28,103,23691,39.2
13103,Effingham County,2021-08-29,53,23744,39.3
13103,Effingham County,2021-08-30,92,23836,39.4
13103,Effingham County,2021-08-31,107,23943,39.6
13103,Effingham County,2021-09-01,102,24045,39.8
13103,Effingham County,2021-09-02,126,24171,40
13103,Effingham County,2021-09-03,174,24345,40.3
13103,Effingham County,2021-09-04,63,24408,40.4
13103,Effingham County,2021-09-05,37,24445,40.4
13103,Effingham County,2021-09-06,19,24464,40.5
13103,Effingham County,2021-09-07,70,24534,40.6
13103,Effingham County,2021-09-08,75,24609,40.7
13103,Effingham County,2021-09-09,111,24720,40.9
13103,Effingham County,2021-09-10,86,24806,41
13103,Effingham County,2021-09-11,60,24866,41.1
13103,Effingham County,2021-09-12,40,24906,41.2
13103,Effingham County,2021-09-13,66,24972,41.3
13103,Effingham County,2021-09-14,71,25043,41.4
13103,Effingham County,2021-09-15,47,25090,41.5
13103,Effingham County,2021-09-16,75,25165,41.6
13103,Effingham County,2021-09-17,73,25238,41.7
13103,Effingham County,2021-09-18,56,25294,41.8
13103,Effingham County,2021-09-19,32,25326,41.9
13103,Effingham County,2021-09-20,42,25368,41.9
13103,Effingham County,2021-09-21,59,25427,42
13103,Effingham County,2021-09-22,54,25481,42.1
13103,Effingham County,2021-09-23,67,25548,42.2
13103,Effingham County,2021-09-24,34,25582,42.3
13103,Effingham County,2021-09-25,16,25598,42.3
13103,Effingham County,2021-09-26,11,25609,42.3
13103,Effingham County,2021-09-27,25,25634,42.4
13103,Effingham County,2021-09-28,34,25668,42.4
13103,Effingham County,2021-09-29,35,25703,42.5
13103,Effingham County,2021-09-30,23,25726,42.5
13103,Effingham County,2021-10-01,32,25758,42.6
13103,Effingham County,2021-10-02,13,25771,42.6
13103,Effingham County,2021-10-03,10,25781,42.6
13103,Effingham County,2021-10-04,7,25788,42.6
13103,Effingham County,2021-10-05,5,25793,42.6
13103,Effingham County,2021-10-06,14,25807,42.7
13103,Effingham County,2021-10-07,16,25823,42.7
13105,Elbert County,2020-12-17,7,7,0
13105,Elbert County,2020-12-18,21,28,0.1
13105,Elbert County,2020-12-21,1,29,0.2
13105,Elbert County,2020-12-22,7,36,0.2
13105,Elbert County,2020-12-23,12,48,0.3
13105,Elbert County,2020-12-24,3,51,0.3
13105,Elbert County,2020-12-27,1,52,0.3
13105,Elbert County,2020-12-28,44,96,0.5
13105,Elbert County,2020-12-29,12,108,0.6
13105,Elbert County,2020-12-30,9,117,0.6
13105,Elbert County,2020-12-31,1,118,0.6
13105,Elbert County,2021-01-01,2,120,0.6
13105,Elbert County,2021-01-02,2,122,0.6
13105,Elbert County,2021-01-03,25,147,0.8
13105,Elbert County,2021-01-04,73,220,1.1
13105,Elbert County,2021-01-05,66,286,1.5
13105,Elbert County,2021-01-06,58,344,1.8
13105,Elbert County,2021-01-07,55,399,2.1
13105,Elbert County,2021-01-08,46,445,2.3
13105,Elbert County,2021-01-11,85,530,2.8
13105,Elbert County,2021-01-12,71,601,3.1
13105,Elbert County,2021-01-13,87,688,3.6
13105,Elbert County,2021-01-14,122,810,4.2
13105,Elbert County,2021-01-15,93,903,4.7
13105,Elbert County,2021-01-16,11,914,4.8
13105,Elbert County,2021-01-17,4,918,4.8
13105,Elbert County,2021-01-18,91,1009,5.3
13105,Elbert County,2021-01-19,88,1097,5.7
13105,Elbert County,2021-01-20,158,1255,6.5
13105,Elbert County,2021-01-21,150,1405,7.3
13105,Elbert County,2021-01-22,71,1476,7.7
13105,Elbert County,2021-01-23,22,1498,7.8
13105,Elbert County,2021-01-24,11,1509,7.9
13105,Elbert County,2021-01-25,45,1554,8.1
13105,Elbert County,2021-01-26,29,1583,8.3
13105,Elbert County,2021-01-27,129,1712,8.9
13105,Elbert County,2021-01-28,60,1772,9.2
13105,Elbert County,2021-01-29,69,1841,9.6
13105,Elbert County,2021-01-30,3,1844,9.6
13105,Elbert County,2021-01-31,1,1845,9.6
13105,Elbert County,2021-02-01,35,1880,9.8
13105,Elbert County,2021-02-02,104,1984,10.4
13105,Elbert County,2021-02-03,158,2142,11.2
13105,Elbert County,2021-02-04,157,2299,12
13105,Elbert County,2021-02-05,108,2407,12.6
13105,Elbert County,2021-02-06,13,2420,12.6
13105,Elbert County,2021-02-07,16,2436,12.7
13105,Elbert County,2021-02-08,21,2457,12.8
13105,Elbert County,2021-02-09,66,2523,13.2
13105,Elbert County,2021-02-10,87,2610,13.6
13105,Elbert County,2021-02-11,66,2676,14
13105,Elbert County,2021-02-12,94,2770,14.5
13105,Elbert County,2021-02-13,10,2780,14.5
13105,Elbert County,2021-02-14,7,2787,14.5
13105,Elbert County,2021-02-15,20,2807,14.6
13105,Elbert County,2021-02-16,63,2870,15
13105,Elbert County,2021-02-17,19,2889,15.1
13105,Elbert County,2021-02-18,37,2926,15.3
13105,Elbert County,2021-02-19,59,2985,15.6
13105,Elbert County,2021-02-20,4,2989,15.6
13105,Elbert County,2021-02-22,4,2993,15.6
13105,Elbert County,2021-02-23,39,3032,15.8
13105,Elbert County,2021-02-24,23,3055,15.9
13105,Elbert County,2021-02-25,12,3067,16
13105,Elbert County,2021-02-26,17,3084,16.1
13105,Elbert County,2021-02-27,15,3099,16.2
13105,Elbert County,2021-02-28,5,3104,16.2
13105,Elbert County,2021-03-01,56,3160,16.5
13105,Elbert County,2021-03-02,56,3216,16.8
13105,Elbert County,2021-03-03,57,3273,17.1
13105,Elbert County,2021-03-04,31,3304,17.2
13105,Elbert County,2021-03-05,32,3336,17.4
13105,Elbert County,2021-03-06,6,3342,17.4
13105,Elbert County,2021-03-07,14,3356,17.5
13105,Elbert County,2021-03-08,36,3392,17.7
13105,Elbert County,2021-03-09,55,3447,18
13105,Elbert County,2021-03-10,38,3485,18.2
13105,Elbert County,2021-03-11,56,3541,18.5
13105,Elbert County,2021-03-12,45,3586,18.7
13105,Elbert County,2021-03-13,26,3612,18.8
13105,Elbert County,2021-03-14,18,3630,18.9
13105,Elbert County,2021-03-15,23,3653,19.1
13105,Elbert County,2021-03-16,155,3808,19.9
13105,Elbert County,2021-03-17,140,3948,20.6
13105,Elbert County,2021-03-18,145,4093,21.4
13105,Elbert County,2021-03-19,126,4219,22
13105,Elbert County,2021-03-20,18,4237,22.1
13105,Elbert County,2021-03-21,17,4254,22.2
13105,Elbert County,2021-03-22,87,4341,22.6
13105,Elbert County,2021-03-23,92,4433,23.1
13105,Elbert County,2021-03-24,52,4485,23.4
13105,Elbert County,2021-03-25,76,4561,23.8
13105,Elbert County,2021-03-26,107,4668,24.4
13105,Elbert County,2021-03-27,7,4675,24.4
13105,Elbert County,2021-03-28,19,4694,24.5
13105,Elbert County,2021-03-29,65,4759,24.8
13105,Elbert County,2021-03-30,138,4897,25.6
13105,Elbert County,2021-03-31,40,4937,25.8
13105,Elbert County,2021-04-01,98,5035,26.3
13105,Elbert County,2021-04-02,54,5089,26.6
13105,Elbert County,2021-04-03,13,5102,26.6
13105,Elbert County,2021-04-04,13,5115,26.7
13105,Elbert County,2021-04-05,47,5162,26.9
13105,Elbert County,2021-04-06,57,5219,27.2
13105,Elbert County,2021-04-07,45,5264,27.5
13105,Elbert County,2021-04-08,109,5373,28
13105,Elbert County,2021-04-09,65,5438,28.4
13105,Elbert County,2021-04-10,20,5458,28.5
13105,Elbert County,2021-04-11,11,5469,28.5
13105,Elbert County,2021-04-12,20,5489,28.6
13105,Elbert County,2021-04-13,34,5523,28.8
13105,Elbert County,2021-04-14,37,5560,29
13105,Elbert County,2021-04-15,12,5572,29.1
13105,Elbert County,2021-04-16,28,5600,29.2
13105,Elbert County,2021-04-17,12,5612,29.3
13105,Elbert County,2021-04-18,2,5614,29.3
13105,Elbert County,2021-04-19,25,5639,29.4
13105,Elbert County,2021-04-20,29,5668,29.6
13105,Elbert County,2021-04-21,24,5692,29.7
13105,Elbert County,2021-04-22,43,5735,29.9
13105,Elbert County,2021-04-23,35,5770,30.1
13105,Elbert County,2021-04-24,12,5782,30.2
13105,Elbert County,2021-04-25,1,5783,30.2
13105,Elbert County,2021-04-26,50,5833,30.4
13105,Elbert County,2021-04-27,33,5866,30.6
13105,Elbert County,2021-04-28,33,5899,30.8
13105,Elbert County,2021-04-29,55,5954,31.1
13105,Elbert County,2021-04-30,27,5981,31.2
13105,Elbert County,2021-05-01,9,5990,31.3
13105,Elbert County,2021-05-02,3,5993,31.3
13105,Elbert County,2021-05-03,6,5999,31.3
13105,Elbert County,2021-05-04,19,6018,31.4
13105,Elbert County,2021-05-05,26,6044,31.5
13105,Elbert County,2021-05-06,36,6080,31.7
13105,Elbert County,2021-05-07,10,6090,31.8
13105,Elbert County,2021-05-08,10,6100,31.8
13105,Elbert County,2021-05-09,4,6104,31.8
13105,Elbert County,2021-05-10,17,6121,31.9
13105,Elbert County,2021-05-11,9,6130,32
13105,Elbert County,2021-05-12,18,6148,32.1
13105,Elbert County,2021-05-13,16,6164,32.2
13105,Elbert County,2021-05-14,24,6188,32.3
13105,Elbert County,2021-05-15,5,6193,32.3
13105,Elbert County,2021-05-16,5,6198,32.3
13105,Elbert County,2021-05-17,14,6212,32.4
13105,Elbert County,2021-05-18,21,6233,32.5
13105,Elbert County,2021-05-19,15,6248,32.6
13105,Elbert County,2021-05-20,13,6261,32.7
13105,Elbert County,2021-05-21,20,6281,32.8
13105,Elbert County,2021-05-22,4,6285,32.8
13105,Elbert County,2021-05-23,5,6290,32.8
13105,Elbert County,2021-05-24,9,6299,32.9
13105,Elbert County,2021-05-25,14,6313,32.9
13105,Elbert County,2021-05-26,9,6322,33
13105,Elbert County,2021-05-27,18,6340,33.1
13105,Elbert County,2021-05-28,9,6349,33.1
13105,Elbert County,2021-05-29,5,6354,33.2
13105,Elbert County,2021-05-31,1,6355,33.2
13105,Elbert County,2021-06-01,24,6379,33.3
13105,Elbert County,2021-06-02,7,6386,33.3
13105,Elbert County,2021-06-03,7,6393,33.4
13105,Elbert County,2021-06-04,11,6404,33.4
13105,Elbert County,2021-06-05,5,6409,33.4
13105,Elbert County,2021-06-06,4,6413,33.5
13105,Elbert County,2021-06-07,9,6422,33.5
13105,Elbert County,2021-06-08,42,6464,33.7
13105,Elbert County,2021-06-09,8,6472,33.8
13105,Elbert County,2021-06-10,9,6481,33.8
13105,Elbert County,2021-06-11,17,6498,33.9
13105,Elbert County,2021-06-12,6,6504,33.9
13105,Elbert County,2021-06-14,9,6513,34
13105,Elbert County,2021-06-15,19,6532,34.1
13105,Elbert County,2021-06-16,7,6539,34.1
13105,Elbert County,2021-06-17,9,6548,34.2
13105,Elbert County,2021-06-18,16,6564,34.2
13105,Elbert County,2021-06-19,7,6571,34.3
13105,Elbert County,2021-06-21,7,6578,34.3
13105,Elbert County,2021-06-22,20,6598,34.4
13105,Elbert County,2021-06-23,3,6601,34.4
13105,Elbert County,2021-06-24,12,6613,34.5
13105,Elbert County,2021-06-25,5,6618,34.5
13105,Elbert County,2021-06-26,4,6622,34.6
13105,Elbert County,2021-06-27,3,6625,34.6
13105,Elbert County,2021-06-28,5,6630,34.6
13105,Elbert County,2021-06-29,10,6640,34.6
13105,Elbert County,2021-06-30,9,6649,34.7
13105,Elbert County,2021-07-01,6,6655,34.7
13105,Elbert County,2021-07-02,3,6658,34.7
13105,Elbert County,2021-07-03,2,6660,34.7
13105,Elbert County,2021-07-04,1,6661,34.8
13105,Elbert County,2021-07-05,4,6665,34.8
13105,Elbert County,2021-07-06,4,6669,34.8
13105,Elbert County,2021-07-07,17,6686,34.9
13105,Elbert County,2021-07-08,9,6695,34.9
13105,Elbert County,2021-07-09,14,6709,35
13105,Elbert County,2021-07-10,11,6720,35.1
13105,Elbert County,2021-07-11,3,6723,35.1
13105,Elbert County,2021-07-12,14,6737,35.2
13105,Elbert County,2021-07-13,10,6747,35.2
13105,Elbert County,2021-07-14,5,6752,35.2
13105,Elbert County,2021-07-15,10,6762,35.3
13105,Elbert County,2021-07-16,9,6771,35.3
13105,Elbert County,2021-07-17,5,6776,35.4
13105,Elbert County,2021-07-18,2,6778,35.4
13105,Elbert County,2021-07-19,14,6792,35.4
13105,Elbert County,2021-07-20,36,6828,35.6
13105,Elbert County,2021-07-21,12,6840,35.7
13105,Elbert County,2021-07-22,12,6852,35.8
13105,Elbert County,2021-07-23,23,6875,35.9
13105,Elbert County,2021-07-24,7,6882,35.9
13105,Elbert County,2021-07-25,1,6883,35.9
13105,Elbert County,2021-07-26,19,6902,36
13105,Elbert County,2021-07-27,29,6931,36.2
13105,Elbert County,2021-07-28,24,6955,36.3
13105,Elbert County,2021-07-29,20,6975,36.4
13105,Elbert County,2021-07-30,29,7004,36.5
13105,Elbert County,2021-07-31,24,7028,36.7
13105,Elbert County,2021-08-01,7,7035,36.7
13105,Elbert County,2021-08-02,26,7061,36.8
13105,Elbert County,2021-08-03,31,7092,37
13105,Elbert County,2021-08-04,25,7117,37.1
13105,Elbert County,2021-08-05,26,7143,37.3
13105,Elbert County,2021-08-06,21,7164,37.4
13105,Elbert County,2021-08-07,15,7179,37.5
13105,Elbert County,2021-08-08,94,7273,37.9
13105,Elbert County,2021-08-09,35,7308,38.1
13105,Elbert County,2021-08-10,47,7355,38.4
13105,Elbert County,2021-08-11,21,7376,38.5
13105,Elbert County,2021-08-12,34,7410,38.7
13105,Elbert County,2021-08-13,22,7432,38.8
13105,Elbert County,2021-08-14,20,7452,38.9
13105,Elbert County,2021-08-15,11,7463,38.9
13105,Elbert County,2021-08-16,29,7492,39.1
13105,Elbert County,2021-08-17,36,7528,39.3
13105,Elbert County,2021-08-18,28,7556,39.4
13105,Elbert County,2021-08-19,20,7576,39.5
13105,Elbert County,2021-08-20,33,7609,39.7
13105,Elbert County,2021-08-21,20,7629,39.8
13105,Elbert County,2021-08-22,6,7635,39.8
13105,Elbert County,2021-08-23,32,7667,40
13105,Elbert County,2021-08-24,47,7714,40.2
13105,Elbert County,2021-08-25,38,7752,40.4
13105,Elbert County,2021-08-26,39,7791,40.7
13105,Elbert County,2021-08-27,32,7823,40.8
13105,Elbert County,2021-08-28,24,7847,40.9
13105,Elbert County,2021-08-29,6,7853,41
13105,Elbert County,2021-08-30,30,7883,41.1
13105,Elbert County,2021-08-31,67,7950,41.5
13105,Elbert County,2021-09-01,34,7984,41.7
13105,Elbert County,2021-09-02,30,8014,41.8
13105,Elbert County,2021-09-03,29,8043,42
13105,Elbert County,2021-09-04,15,8058,42
13105,Elbert County,2021-09-05,14,8072,42.1
13105,Elbert County,2021-09-06,3,8075,42.1
13105,Elbert County,2021-09-07,35,8110,42.3
13105,Elbert County,2021-09-08,18,8128,42.4
13105,Elbert County,2021-09-09,27,8155,42.5
13105,Elbert County,2021-09-10,30,8185,42.7
13105,Elbert County,2021-09-11,22,8207,42.8
13105,Elbert County,2021-09-12,12,8219,42.9
13105,Elbert County,2021-09-13,34,8253,43.1
13105,Elbert County,2021-09-14,40,8293,43.3
13105,Elbert County,2021-09-15,23,8316,43.4
13105,Elbert County,2021-09-16,13,8329,43.5
13105,Elbert County,2021-09-17,19,8348,43.6
13105,Elbert County,2021-09-18,9,8357,43.6
13105,Elbert County,2021-09-19,2,8359,43.6
13105,Elbert County,2021-09-20,19,8378,43.7
13105,Elbert County,2021-09-21,24,8402,43.8
13105,Elbert County,2021-09-22,13,8415,43.9
13105,Elbert County,2021-09-23,16,8431,44
13105,Elbert County,2021-09-24,12,8443,44.1
13105,Elbert County,2021-09-25,3,8446,44.1
13105,Elbert County,2021-09-26,3,8449,44.1
13105,Elbert County,2021-09-27,10,8459,44.1
13105,Elbert County,2021-09-28,22,8481,44.3
13105,Elbert County,2021-09-29,7,8488,44.3
13105,Elbert County,2021-09-30,5,8493,44.3
13105,Elbert County,2021-10-01,10,8503,44.4
13105,Elbert County,2021-10-02,3,8506,44.4
13105,Elbert County,2021-10-03,2,8508,44.4
13105,Elbert County,2021-10-04,3,8511,44.4
13105,Elbert County,2021-10-05,7,8518,44.4
13105,Elbert County,2021-10-06,12,8530,44.5
13105,Elbert County,2021-10-07,3,8533,44.5
13107,Emanuel County,2020-12-17,1,1,0
13107,Emanuel County,2020-12-18,3,4,0
13107,Emanuel County,2020-12-19,2,6,0
13107,Emanuel County,2020-12-20,3,9,0
13107,Emanuel County,2020-12-22,9,18,0.1
13107,Emanuel County,2020-12-23,8,26,0.1
13107,Emanuel County,2020-12-24,4,30,0.1
13107,Emanuel County,2020-12-26,2,32,0.1
13107,Emanuel County,2020-12-27,4,36,0.2
13107,Emanuel County,2020-12-28,46,82,0.4
13107,Emanuel County,2020-12-29,19,101,0.4
13107,Emanuel County,2020-12-30,14,115,0.5
13107,Emanuel County,2020-12-31,32,147,0.7
13107,Emanuel County,2021-01-01,1,148,0.7
13107,Emanuel County,2021-01-02,1,149,0.7
13107,Emanuel County,2021-01-03,1,150,0.7
13107,Emanuel County,2021-01-04,21,171,0.8
13107,Emanuel County,2021-01-05,71,242,1.1
13107,Emanuel County,2021-01-06,36,278,1.2
13107,Emanuel County,2021-01-07,109,387,1.7
13107,Emanuel County,2021-01-08,41,428,1.9
13107,Emanuel County,2021-01-09,36,464,2.1
13107,Emanuel County,2021-01-10,3,467,2.1
13107,Emanuel County,2021-01-11,15,482,2.1
13107,Emanuel County,2021-01-12,19,501,2.2
13107,Emanuel County,2021-01-13,318,819,3.6
13107,Emanuel County,2021-01-14,64,883,3.9
13107,Emanuel County,2021-01-15,30,913,4.1
13107,Emanuel County,2021-01-16,8,921,4.1
13107,Emanuel County,2021-01-17,7,928,4.1
13107,Emanuel County,2021-01-18,13,941,4.2
13107,Emanuel County,2021-01-19,279,1220,5.4
13107,Emanuel County,2021-01-20,181,1401,6.2
13107,Emanuel County,2021-01-21,124,1525,6.8
13107,Emanuel County,2021-01-22,70,1595,7.1
13107,Emanuel County,2021-01-23,4,1599,7.1
13107,Emanuel County,2021-01-25,18,1617,7.2
13107,Emanuel County,2021-01-26,26,1643,7.3
13107,Emanuel County,2021-01-27,137,1780,7.9
13107,Emanuel County,2021-01-28,83,1863,8.3
13107,Emanuel County,2021-01-29,20,1883,8.4
13107,Emanuel County,2021-01-30,13,1896,8.4
13107,Emanuel County,2021-01-31,1,1897,8.4
13107,Emanuel County,2021-02-01,12,1909,8.5
13107,Emanuel County,2021-02-02,170,2079,9.2
13107,Emanuel County,2021-02-03,71,2150,9.5
13107,Emanuel County,2021-02-04,36,2186,9.7
13107,Emanuel County,2021-02-05,41,2227,9.9
13107,Emanuel County,2021-02-06,8,2235,9.9
13107,Emanuel County,2021-02-08,5,2240,9.9
13107,Emanuel County,2021-02-09,82,2322,10.3
13107,Emanuel County,2021-02-10,86,2408,10.7
13107,Emanuel County,2021-02-11,11,2419,10.7
13107,Emanuel County,2021-02-12,29,2448,10.9
13107,Emanuel County,2021-02-13,12,2460,10.9
13107,Emanuel County,2021-02-14,6,2466,10.9
13107,Emanuel County,2021-02-15,9,2475,11
13107,Emanuel County,2021-02-16,27,2502,11.1
13107,Emanuel County,2021-02-17,41,2543,11.3
13107,Emanuel County,2021-02-18,23,2566,11.4
13107,Emanuel County,2021-02-19,108,2674,11.9
13107,Emanuel County,2021-02-20,1,2675,11.9
13107,Emanuel County,2021-02-21,4,2679,11.9
13107,Emanuel County,2021-02-22,8,2687,11.9
13107,Emanuel County,2021-02-23,17,2704,12
13107,Emanuel County,2021-02-24,60,2764,12.3
13107,Emanuel County,2021-02-25,21,2785,12.4
13107,Emanuel County,2021-02-26,29,2814,12.5
13107,Emanuel County,2021-02-28,1,2815,12.5
13107,Emanuel County,2021-03-01,13,2828,12.6
13107,Emanuel County,2021-03-02,20,2848,12.6
13107,Emanuel County,2021-03-03,59,2907,12.9
13107,Emanuel County,2021-03-04,31,2938,13
13107,Emanuel County,2021-03-05,22,2960,13.1
13107,Emanuel County,2021-03-06,3,2963,13.1
13107,Emanuel County,2021-03-08,15,2978,13.2
13107,Emanuel County,2021-03-09,20,2998,13.3
13107,Emanuel County,2021-03-10,100,3098,13.7
13107,Emanuel County,2021-03-11,60,3158,14
13107,Emanuel County,2021-03-12,142,3300,14.6
13107,Emanuel County,2021-03-13,9,3309,14.7
13107,Emanuel County,2021-03-14,4,3313,14.7
13107,Emanuel County,2021-03-15,55,3368,14.9
13107,Emanuel County,2021-03-16,120,3488,15.5
13107,Emanuel County,2021-03-17,194,3682,16.3
13107,Emanuel County,2021-03-18,52,3734,16.6
13107,Emanuel County,2021-03-19,84,3818,16.9
13107,Emanuel County,2021-03-20,7,3825,17
13107,Emanuel County,2021-03-21,2,3827,17
13107,Emanuel County,2021-03-22,27,3854,17.1
13107,Emanuel County,2021-03-23,78,3932,17.4
13107,Emanuel County,2021-03-24,107,4039,17.9
13107,Emanuel County,2021-03-25,85,4124,18.3
13107,Emanuel County,2021-03-26,76,4200,18.6
13107,Emanuel County,2021-03-27,25,4225,18.8
13107,Emanuel County,2021-03-28,13,4238,18.8
13107,Emanuel County,2021-03-29,29,4267,18.9
13107,Emanuel County,2021-03-30,98,4365,19.4
13107,Emanuel County,2021-03-31,88,4453,19.8
13107,Emanuel County,2021-04-01,53,4506,20
13107,Emanuel County,2021-04-02,54,4560,20.2
13107,Emanuel County,2021-04-03,10,4570,20.3
13107,Emanuel County,2021-04-04,8,4578,20.3
13107,Emanuel County,2021-04-05,30,4608,20.5
13107,Emanuel County,2021-04-06,72,4680,20.8
13107,Emanuel County,2021-04-07,103,4783,21.2
13107,Emanuel County,2021-04-08,45,4828,21.4
13107,Emanuel County,2021-04-09,78,4906,21.8
13107,Emanuel County,2021-04-10,18,4924,21.9
13107,Emanuel County,2021-04-11,9,4933,21.9
13107,Emanuel County,2021-04-12,25,4958,22
13107,Emanuel County,2021-04-13,46,5004,22.2
13107,Emanuel County,2021-04-14,48,5052,22.4
13107,Emanuel County,2021-04-15,14,5066,22.5
13107,Emanuel County,2021-04-16,48,5114,22.7
13107,Emanuel County,2021-04-17,4,5118,22.7
13107,Emanuel County,2021-04-18,2,5120,22.7
13107,Emanuel County,2021-04-19,9,5129,22.8
13107,Emanuel County,2021-04-20,81,5210,23.1
13107,Emanuel County,2021-04-21,63,5273,23.4
13107,Emanuel County,2021-04-22,15,5288,23.5
13107,Emanuel County,2021-04-23,25,5313,23.6
13107,Emanuel County,2021-04-24,6,5319,23.6
13107,Emanuel County,2021-04-26,15,5334,23.7
13107,Emanuel County,2021-04-27,15,5349,23.7
13107,Emanuel County,2021-04-28,45,5394,23.9
13107,Emanuel County,2021-04-29,17,5411,24
13107,Emanuel County,2021-04-30,51,5462,24.2
13107,Emanuel County,2021-05-01,20,5482,24.3
13107,Emanuel County,2021-05-02,5,5487,24.4
13107,Emanuel County,2021-05-03,9,5496,24.4
13107,Emanuel County,2021-05-04,17,5513,24.5
13107,Emanuel County,2021-05-05,45,5558,24.7
13107,Emanuel County,2021-05-06,25,5583,24.8
13107,Emanuel County,2021-05-07,32,5615,24.9
13107,Emanuel County,2021-05-08,8,5623,25
13107,Emanuel County,2021-05-09,4,5627,25
13107,Emanuel County,2021-05-10,11,5638,25
13107,Emanuel County,2021-05-11,30,5668,25.2
13107,Emanuel County,2021-05-12,32,5700,25.3
13107,Emanuel County,2021-05-13,13,5713,25.4
13107,Emanuel County,2021-05-14,20,5733,25.4
13107,Emanuel County,2021-05-15,9,5742,25.5
13107,Emanuel County,2021-05-16,6,5748,25.5
13107,Emanuel County,2021-05-17,16,5764,25.6
13107,Emanuel County,2021-05-18,34,5798,25.7
13107,Emanuel County,2021-05-19,33,5831,25.9
13107,Emanuel County,2021-05-20,23,5854,26
13107,Emanuel County,2021-05-21,15,5869,26
13107,Emanuel County,2021-05-22,13,5882,26.1
13107,Emanuel County,2021-05-23,3,5885,26.1
13107,Emanuel County,2021-05-24,15,5900,26.2
13107,Emanuel County,2021-05-25,15,5915,26.3
13107,Emanuel County,2021-05-26,40,5955,26.4
13107,Emanuel County,2021-05-27,17,5972,26.5
13107,Emanuel County,2021-05-28,12,5984,26.6
13107,Emanuel County,2021-05-29,7,5991,26.6
13107,Emanuel County,2021-05-30,5,5996,26.6
13107,Emanuel County,2021-05-31,2,5998,26.6
13107,Emanuel County,2021-06-01,23,6021,26.7
13107,Emanuel County,2021-06-02,32,6053,26.9
13107,Emanuel County,2021-06-03,9,6062,26.9
13107,Emanuel County,2021-06-04,18,6080,27
13107,Emanuel County,2021-06-05,13,6093,27
13107,Emanuel County,2021-06-06,6,6099,27.1
13107,Emanuel County,2021-06-07,6,6105,27.1
13107,Emanuel County,2021-06-08,13,6118,27.2
13107,Emanuel County,2021-06-09,39,6157,27.3
13107,Emanuel County,2021-06-10,11,6168,27.4
13107,Emanuel County,2021-06-11,24,6192,27.5
13107,Emanuel County,2021-06-12,10,6202,27.5
13107,Emanuel County,2021-06-13,3,6205,27.5
13107,Emanuel County,2021-06-14,12,6217,27.6
13107,Emanuel County,2021-06-15,9,6226,27.6
13107,Emanuel County,2021-06-16,23,6249,27.7
13107,Emanuel County,2021-06-17,15,6264,27.8
13107,Emanuel County,2021-06-18,11,6275,27.8
13107,Emanuel County,2021-06-19,2,6277,27.9
13107,Emanuel County,2021-06-20,1,6278,27.9
13107,Emanuel County,2021-06-21,10,6288,27.9
13107,Emanuel County,2021-06-22,11,6299,28
13107,Emanuel County,2021-06-23,28,6327,28.1
13107,Emanuel County,2021-06-24,13,6340,28.1
13107,Emanuel County,2021-06-25,10,6350,28.2
13107,Emanuel County,2021-06-26,6,6356,28.2
13107,Emanuel County,2021-06-28,3,6359,28.2
13107,Emanuel County,2021-06-29,9,6368,28.3
13107,Emanuel County,2021-06-30,21,6389,28.4
13107,Emanuel County,2021-07-01,8,6397,28.4
13107,Emanuel County,2021-07-02,6,6403,28.4
13107,Emanuel County,2021-07-03,4,6407,28.4
13107,Emanuel County,2021-07-04,1,6408,28.4
13107,Emanuel County,2021-07-05,4,6412,28.5
13107,Emanuel County,2021-07-06,10,6422,28.5
13107,Emanuel County,2021-07-07,23,6445,28.6
13107,Emanuel County,2021-07-08,6,6451,28.6
13107,Emanuel County,2021-07-09,7,6458,28.7
13107,Emanuel County,2021-07-10,2,6460,28.7
13107,Emanuel County,2021-07-11,4,6464,28.7
13107,Emanuel County,2021-07-12,9,6473,28.7
13107,Emanuel County,2021-07-13,17,6490,28.8
13107,Emanuel County,2021-07-14,21,6511,28.9
13107,Emanuel County,2021-07-15,20,6531,29
13107,Emanuel County,2021-07-16,20,6551,29.1
13107,Emanuel County,2021-07-17,6,6557,29.1
13107,Emanuel County,2021-07-18,5,6562,29.1
13107,Emanuel County,2021-07-19,18,6580,29.2
13107,Emanuel County,2021-07-20,33,6613,29.3
13107,Emanuel County,2021-07-21,63,6676,29.6
13107,Emanuel County,2021-07-22,37,6713,29.8
13107,Emanuel County,2021-07-23,54,6767,30
13107,Emanuel County,2021-07-24,21,6788,30.1
13107,Emanuel County,2021-07-25,6,6794,30.2
13107,Emanuel County,2021-07-26,30,6824,30.3
13107,Emanuel County,2021-07-27,32,6856,30.4
13107,Emanuel County,2021-07-28,68,6924,30.7
13107,Emanuel County,2021-07-29,131,7055,31.3
13107,Emanuel County,2021-07-30,49,7104,31.5
13107,Emanuel County,2021-07-31,27,7131,31.6
13107,Emanuel County,2021-08-01,12,7143,31.7
13107,Emanuel County,2021-08-02,42,7185,31.9
13107,Emanuel County,2021-08-03,38,7223,32.1
13107,Emanuel County,2021-08-04,54,7277,32.3
13107,Emanuel County,2021-08-05,34,7311,32.4
13107,Emanuel County,2021-08-06,36,7347,32.6
13107,Emanuel County,2021-08-07,55,7402,32.8
13107,Emanuel County,2021-08-08,16,7418,32.9
13107,Emanuel County,2021-08-09,51,7469,33.1
13107,Emanuel County,2021-08-10,42,7511,33.3
13107,Emanuel County,2021-08-11,83,7594,33.7
13107,Emanuel County,2021-08-12,96,7690,34.1
13107,Emanuel County,2021-08-13,70,7760,34.4
13107,Emanuel County,2021-08-14,38,7798,34.6
13107,Emanuel County,2021-08-15,15,7813,34.7
13107,Emanuel County,2021-08-16,72,7885,35
13107,Emanuel County,2021-08-17,65,7950,35.3
13107,Emanuel County,2021-08-18,117,8067,35.8
13107,Emanuel County,2021-08-19,51,8118,36
13107,Emanuel County,2021-08-20,62,8180,36.3
13107,Emanuel County,2021-08-21,22,8202,36.4
13107,Emanuel County,2021-08-22,14,8216,36.5
13107,Emanuel County,2021-08-23,72,8288,36.8
13107,Emanuel County,2021-08-24,38,8326,37
13107,Emanuel County,2021-08-25,109,8435,37.4
13107,Emanuel County,2021-08-26,97,8532,37.9
13107,Emanuel County,2021-08-27,99,8631,38.3
13107,Emanuel County,2021-08-28,43,8674,38.5
13107,Emanuel County,2021-08-29,16,8690,38.6
13107,Emanuel County,2021-08-30,73,8763,38.9
13107,Emanuel County,2021-08-31,53,8816,39.1
13107,Emanuel County,2021-09-01,67,8883,39.4
13107,Emanuel County,2021-09-02,64,8947,39.7
13107,Emanuel County,2021-09-03,49,8996,39.9
13107,Emanuel County,2021-09-04,26,9022,40
13107,Emanuel County,2021-09-05,12,9034,40.1
13107,Emanuel County,2021-09-06,5,9039,40.1
13107,Emanuel County,2021-09-07,33,9072,40.3
13107,Emanuel County,2021-09-08,46,9118,40.5
13107,Emanuel County,2021-09-09,31,9149,40.6
13107,Emanuel County,2021-09-10,47,9196,40.8
13107,Emanuel County,2021-09-11,27,9223,40.9
13107,Emanuel County,2021-09-12,8,9231,41
13107,Emanuel County,2021-09-13,26,9257,41.1
13107,Emanuel County,2021-09-14,31,9288,41.2
13107,Emanuel County,2021-09-15,46,9334,41.4
13107,Emanuel County,2021-09-16,29,9363,41.6
13107,Emanuel County,2021-09-17,33,9396,41.7
13107,Emanuel County,2021-09-18,15,9411,41.8
13107,Emanuel County,2021-09-19,2,9413,41.8
13107,Emanuel County,2021-09-20,17,9430,41.8
13107,Emanuel County,2021-09-21,33,9463,42
13107,Emanuel County,2021-09-22,21,9484,42.1
13107,Emanuel County,2021-09-23,14,9498,42.2
13107,Emanuel County,2021-09-24,22,9520,42.2
13107,Emanuel County,2021-09-25,11,9531,42.3
13107,Emanuel County,2021-09-26,2,9533,42.3
13107,Emanuel County,2021-09-27,7,9540,42.3
13107,Emanuel County,2021-09-28,10,9550,42.4
13107,Emanuel County,2021-09-29,7,9557,42.4
13107,Emanuel County,2021-09-30,6,9563,42.4
13107,Emanuel County,2021-10-01,8,9571,42.5
13107,Emanuel County,2021-10-02,2,9573,42.5
13107,Emanuel County,2021-10-03,2,9575,42.5
13107,Emanuel County,2021-10-04,4,9579,42.5
13107,Emanuel County,2021-10-05,6,9585,42.5
13107,Emanuel County,2021-10-06,13,9598,42.6
13107,Emanuel County,2021-10-07,3,9601,42.6
13109,Evans County,2020-12-18,3,3,0
13109,Evans County,2020-12-21,2,5,0
13109,Evans County,2020-12-22,2,7,0.1
13109,Evans County,2020-12-23,10,17,0.2
13109,Evans County,2020-12-24,10,27,0.3
13109,Evans County,2020-12-27,1,28,0.3
13109,Evans County,2020-12-28,11,39,0.4
13109,Evans County,2020-12-29,12,51,0.5
13109,Evans County,2020-12-30,31,82,0.8
13109,Evans County,2020-12-31,12,94,0.9
13109,Evans County,2021-01-01,4,98,0.9
13109,Evans County,2021-01-02,4,102,1
13109,Evans County,2021-01-04,17,119,1.1
13109,Evans County,2021-01-05,6,125,1.2
13109,Evans County,2021-01-06,24,149,1.4
13109,Evans County,2021-01-07,55,204,1.9
13109,Evans County,2021-01-08,23,227,2.1
13109,Evans County,2021-01-09,3,230,2.2
13109,Evans County,2021-01-10,3,233,2.2
13109,Evans County,2021-01-11,44,277,2.6
13109,Evans County,2021-01-12,106,383,3.6
13109,Evans County,2021-01-13,107,490,4.6
13109,Evans County,2021-01-14,83,573,5.4
13109,Evans County,2021-01-15,37,610,5.7
13109,Evans County,2021-01-16,4,614,5.7
13109,Evans County,2021-01-17,5,619,5.8
13109,Evans County,2021-01-18,85,704,6.6
13109,Evans County,2021-01-19,51,755,7.1
13109,Evans County,2021-01-20,46,801,7.5
13109,Evans County,2021-01-21,40,841,7.9
13109,Evans County,2021-01-22,13,854,8
13109,Evans County,2021-01-23,7,861,8.1
13109,Evans County,2021-01-24,1,862,8.1
13109,Evans County,2021-01-25,8,870,8.1
13109,Evans County,2021-01-26,18,888,8.3
13109,Evans County,2021-01-27,12,900,8.4
13109,Evans County,2021-01-28,33,933,8.7
13109,Evans County,2021-01-29,5,938,8.8
13109,Evans County,2021-01-30,7,945,8.8
13109,Evans County,2021-02-01,22,967,9
13109,Evans County,2021-02-02,22,989,9.3
13109,Evans County,2021-02-03,24,1013,9.5
13109,Evans County,2021-02-04,37,1050,9.8
13109,Evans County,2021-02-05,63,1113,10.4
13109,Evans County,2021-02-06,1,1114,10.4
13109,Evans County,2021-02-08,24,1138,10.6
13109,Evans County,2021-02-09,30,1168,10.9
13109,Evans County,2021-02-10,32,1200,11.2
13109,Evans County,2021-02-11,11,1211,11.3
13109,Evans County,2021-02-12,39,1250,11.7
13109,Evans County,2021-02-13,5,1255,11.7
13109,Evans County,2021-02-15,20,1275,11.9
13109,Evans County,2021-02-16,21,1296,12.1
13109,Evans County,2021-02-17,31,1327,12.4
13109,Evans County,2021-02-18,27,1354,12.7
13109,Evans County,2021-02-19,14,1368,12.8
13109,Evans County,2021-02-21,1,1369,12.8
13109,Evans County,2021-02-22,47,1416,13.2
13109,Evans County,2021-02-23,31,1447,13.5
13109,Evans County,2021-02-24,52,1499,14
13109,Evans County,2021-02-25,34,1533,14.3
13109,Evans County,2021-02-26,9,1542,14.4
13109,Evans County,2021-02-27,1,1543,14.4
13109,Evans County,2021-02-28,3,1546,14.5
13109,Evans County,2021-03-01,35,1581,14.8
13109,Evans County,2021-03-02,28,1609,15.1
13109,Evans County,2021-03-03,31,1640,15.3
13109,Evans County,2021-03-04,36,1676,15.7
13109,Evans County,2021-03-05,5,1681,15.7
13109,Evans County,2021-03-06,1,1682,15.7
13109,Evans County,2021-03-07,7,1689,15.8
13109,Evans County,2021-03-08,29,1718,16.1
13109,Evans County,2021-03-09,34,1752,16.4
13109,Evans County,2021-03-10,35,1787,16.7
13109,Evans County,2021-03-11,41,1828,17.1
13109,Evans County,2021-03-12,82,1910,17.9
13109,Evans County,2021-03-13,6,1916,17.9
13109,Evans County,2021-03-14,10,1926,18
13109,Evans County,2021-03-15,29,1955,18.3
13109,Evans County,2021-03-16,36,1991,18.6
13109,Evans County,2021-03-17,57,2048,19.2
13109,Evans County,2021-03-18,13,2061,19.3
13109,Evans County,2021-03-19,37,2098,19.6
13109,Evans County,2021-03-20,9,2107,19.7
13109,Evans County,2021-03-21,9,2116,19.8
13109,Evans County,2021-03-22,18,2134,20
13109,Evans County,2021-03-23,19,2153,20.1
13109,Evans County,2021-03-24,40,2193,20.5
13109,Evans County,2021-03-25,36,2229,20.9
13109,Evans County,2021-03-26,22,2251,21.1
13109,Evans County,2021-03-27,12,2263,21.2
13109,Evans County,2021-03-28,3,2266,21.2
13109,Evans County,2021-03-29,51,2317,21.7
13109,Evans County,2021-03-30,78,2395,22.4
13109,Evans County,2021-03-31,33,2428,22.7
13109,Evans County,2021-04-01,58,2486,23.3
13109,Evans County,2021-04-02,16,2502,23.4
13109,Evans County,2021-04-03,6,2508,23.5
13109,Evans County,2021-04-04,7,2515,23.5
13109,Evans County,2021-04-05,25,2540,23.8
13109,Evans County,2021-04-06,29,2569,24
13109,Evans County,2021-04-07,28,2597,24.3
13109,Evans County,2021-04-08,33,2630,24.6
13109,Evans County,2021-04-09,18,2648,24.8
13109,Evans County,2021-04-10,26,2674,25
13109,Evans County,2021-04-11,8,2682,25.1
13109,Evans County,2021-04-12,30,2712,25.4
13109,Evans County,2021-04-13,15,2727,25.5
13109,Evans County,2021-04-14,30,2757,25.8
13109,Evans County,2021-04-15,33,2790,26.1
13109,Evans County,2021-04-16,17,2807,26.3
13109,Evans County,2021-04-17,6,2813,26.3
13109,Evans County,2021-04-18,1,2814,26.3
13109,Evans County,2021-04-19,21,2835,26.5
13109,Evans County,2021-04-20,12,2847,26.6
13109,Evans County,2021-04-21,30,2877,26.9
13109,Evans County,2021-04-22,15,2892,27.1
13109,Evans County,2021-04-23,18,2910,27.2
13109,Evans County,2021-04-24,2,2912,27.2
13109,Evans County,2021-04-25,1,2913,27.3
13109,Evans County,2021-04-26,7,2920,27.3
13109,Evans County,2021-04-27,12,2932,27.4
13109,Evans County,2021-04-28,17,2949,27.6
13109,Evans County,2021-04-29,14,2963,27.7
13109,Evans County,2021-04-30,19,2982,27.9
13109,Evans County,2021-05-01,2,2984,27.9
13109,Evans County,2021-05-02,1,2985,27.9
13109,Evans County,2021-05-03,9,2994,28
13109,Evans County,2021-05-04,18,3012,28.2
13109,Evans County,2021-05-05,20,3032,28.4
13109,Evans County,2021-05-06,31,3063,28.7
13109,Evans County,2021-05-07,13,3076,28.8
13109,Evans County,2021-05-08,3,3079,28.8
13109,Evans County,2021-05-10,11,3090,28.9
13109,Evans County,2021-05-11,13,3103,29
13109,Evans County,2021-05-12,9,3112,29.1
13109,Evans County,2021-05-13,12,3124,29.2
13109,Evans County,2021-05-14,14,3138,29.4
13109,Evans County,2021-05-15,9,3147,29.4
13109,Evans County,2021-05-16,3,3150,29.5
13109,Evans County,2021-05-17,20,3170,29.7
13109,Evans County,2021-05-18,13,3183,29.8
13109,Evans County,2021-05-19,19,3202,30
13109,Evans County,2021-05-20,11,3213,30.1
13109,Evans County,2021-05-21,14,3227,30.2
13109,Evans County,2021-05-22,2,3229,30.2
13109,Evans County,2021-05-23,1,3230,30.2
13109,Evans County,2021-05-24,12,3242,30.3
13109,Evans County,2021-05-25,6,3248,30.4
13109,Evans County,2021-05-26,10,3258,30.5
13109,Evans County,2021-05-27,17,3275,30.6
13109,Evans County,2021-05-28,8,3283,30.7
13109,Evans County,2021-05-29,6,3289,30.8
13109,Evans County,2021-06-01,11,3300,30.9
13109,Evans County,2021-06-02,14,3314,31
13109,Evans County,2021-06-03,5,3319,31.1
13109,Evans County,2021-06-04,8,3327,31.1
13109,Evans County,2021-06-05,6,3333,31.2
13109,Evans County,2021-06-06,1,3334,31.2
13109,Evans County,2021-06-07,7,3341,31.3
13109,Evans County,2021-06-08,4,3345,31.3
13109,Evans County,2021-06-09,5,3350,31.3
13109,Evans County,2021-06-10,10,3360,31.4
13109,Evans County,2021-06-11,6,3366,31.5
13109,Evans County,2021-06-12,2,3368,31.5
13109,Evans County,2021-06-14,4,3372,31.6
13109,Evans County,2021-06-15,4,3376,31.6
13109,Evans County,2021-06-16,9,3385,31.7
13109,Evans County,2021-06-17,20,3405,31.9
13109,Evans County,2021-06-18,13,3418,32
13109,Evans County,2021-06-19,5,3423,32
13109,Evans County,2021-06-20,4,3427,32.1
13109,Evans County,2021-06-21,3,3430,32.1
13109,Evans County,2021-06-22,11,3441,32.2
13109,Evans County,2021-06-23,9,3450,32.3
13109,Evans County,2021-06-24,8,3458,32.4
13109,Evans County,2021-06-25,9,3467,32.4
13109,Evans County,2021-06-26,8,3475,32.5
13109,Evans County,2021-06-27,1,3476,32.5
13109,Evans County,2021-06-28,4,3480,32.6
13109,Evans County,2021-06-29,8,3488,32.6
13109,Evans County,2021-06-30,3,3491,32.7
13109,Evans County,2021-07-01,7,3498,32.7
13109,Evans County,2021-07-02,2,3500,32.8
13109,Evans County,2021-07-03,1,3501,32.8
13109,Evans County,2021-07-05,2,3503,32.8
13109,Evans County,2021-07-06,1,3504,32.8
13109,Evans County,2021-07-07,8,3512,32.9
13109,Evans County,2021-07-08,6,3518,32.9
13109,Evans County,2021-07-09,4,3522,33
13109,Evans County,2021-07-10,2,3524,33
13109,Evans County,2021-07-11,2,3526,33
13109,Evans County,2021-07-12,9,3535,33.1
13109,Evans County,2021-07-13,8,3543,33.2
13109,Evans County,2021-07-14,11,3554,33.3
13109,Evans County,2021-07-15,8,3562,33.3
13109,Evans County,2021-07-16,9,3571,33.4
13109,Evans County,2021-07-17,3,3574,33.4
13109,Evans County,2021-07-18,7,3581,33.5
13109,Evans County,2021-07-19,17,3598,33.7
13109,Evans County,2021-07-20,17,3615,33.8
13109,Evans County,2021-07-21,14,3629,34
13109,Evans County,2021-07-22,26,3655,34.2
13109,Evans County,2021-07-23,20,3675,34.4
13109,Evans County,2021-07-24,13,3688,34.5
13109,Evans County,2021-07-25,19,3707,34.7
13109,Evans County,2021-07-26,23,3730,34.9
13109,Evans County,2021-07-27,27,3757,35.2
13109,Evans County,2021-07-28,14,3771,35.3
13109,Evans County,2021-07-29,26,3797,35.5
13109,Evans County,2021-07-30,38,3835,35.9
13109,Evans County,2021-07-31,19,3854,36.1
13109,Evans County,2021-08-01,7,3861,36.1
13109,Evans County,2021-08-02,18,3879,36.3
13109,Evans County,2021-08-03,12,3891,36.4
13109,Evans County,2021-08-04,31,3922,36.7
13109,Evans County,2021-08-05,36,3958,37
13109,Evans County,2021-08-06,27,3985,37.3
13109,Evans County,2021-08-07,15,4000,37.4
13109,Evans County,2021-08-08,10,4010,37.5
13109,Evans County,2021-08-09,23,4033,37.7
13109,Evans County,2021-08-10,25,4058,38
13109,Evans County,2021-08-11,36,4094,38.3
13109,Evans County,2021-08-12,26,4120,38.6
13109,Evans County,2021-08-13,26,4146,38.8
13109,Evans County,2021-08-14,10,4156,38.9
13109,Evans County,2021-08-15,5,4161,38.9
13109,Evans County,2021-08-16,9,4170,39
13109,Evans County,2021-08-17,25,4195,39.3
13109,Evans County,2021-08-18,22,4217,39.5
13109,Evans County,2021-08-19,20,4237,39.6
13109,Evans County,2021-08-20,34,4271,40
13109,Evans County,2021-08-21,11,4282,40.1
13109,Evans County,2021-08-22,4,4286,40.1
13109,Evans County,2021-08-23,17,4303,40.3
13109,Evans County,2021-08-24,20,4323,40.5
13109,Evans County,2021-08-25,26,4349,40.7
13109,Evans County,2021-08-26,17,4366,40.9
13109,Evans County,2021-08-27,23,4389,41.1
13109,Evans County,2021-08-28,10,4399,41.2
13109,Evans County,2021-08-29,4,4403,41.2
13109,Evans County,2021-08-30,12,4415,41.3
13109,Evans County,2021-08-31,14,4429,41.4
13109,Evans County,2021-09-01,18,4447,41.6
13109,Evans County,2021-09-02,22,4469,41.8
13109,Evans County,2021-09-03,22,4491,42
13109,Evans County,2021-09-04,6,4497,42.1
13109,Evans County,2021-09-05,1,4498,42.1
13109,Evans County,2021-09-06,2,4500,42.1
13109,Evans County,2021-09-07,18,4518,42.3
13109,Evans County,2021-09-08,6,4524,42.3
13109,Evans County,2021-09-09,16,4540,42.5
13109,Evans County,2021-09-10,8,4548,42.6
13109,Evans County,2021-09-11,2,4550,42.6
13109,Evans County,2021-09-13,11,4561,42.7
13109,Evans County,2021-09-14,8,4569,42.8
13109,Evans County,2021-09-15,9,4578,42.8
13109,Evans County,2021-09-16,7,4585,42.9
13109,Evans County,2021-09-17,7,4592,43
13109,Evans County,2021-09-18,5,4597,43
13109,Evans County,2021-09-19,1,4598,43
13109,Evans County,2021-09-20,7,4605,43.1
13109,Evans County,2021-09-21,8,4613,43.2
13109,Evans County,2021-09-22,6,4619,43.2
13109,Evans County,2021-09-23,6,4625,43.3
13109,Evans County,2021-09-24,12,4637,43.4
13109,Evans County,2021-09-25,2,4639,43.4
13109,Evans County,2021-09-27,4,4643,43.4
13109,Evans County,2021-09-28,3,4646,43.5
13109,Evans County,2021-09-29,3,4649,43.5
13109,Evans County,2021-09-30,5,4654,43.5
13109,Evans County,2021-10-01,3,4657,43.6
13109,Evans County,2021-10-04,4,4661,43.6
13109,Evans County,2021-10-05,2,4663,43.6
13109,Evans County,2021-10-06,2,4665,43.7
13109,Evans County,2021-10-07,2,4667,43.7
13111,Fannin County,2020-12-17,2,2,0
13111,Fannin County,2020-12-18,4,6,0
13111,Fannin County,2020-12-19,2,8,0
13111,Fannin County,2020-12-20,2,10,0
13111,Fannin County,2020-12-21,4,14,0.1
13111,Fannin County,2020-12-22,8,22,0.1
13111,Fannin County,2020-12-23,49,71,0.3
13111,Fannin County,2020-12-24,30,101,0.4
13111,Fannin County,2020-12-27,1,102,0.4
13111,Fannin County,2020-12-28,36,138,0.5
13111,Fannin County,2020-12-29,48,186,0.7
13111,Fannin County,2020-12-30,39,225,0.9
13111,Fannin County,2020-12-31,9,234,0.9
13111,Fannin County,2021-01-01,7,241,0.9
13111,Fannin County,2021-01-02,1,242,1
13111,Fannin County,2021-01-03,5,247,1
13111,Fannin County,2021-01-04,30,277,1.1
13111,Fannin County,2021-01-05,53,330,1.3
13111,Fannin County,2021-01-06,106,436,1.7
13111,Fannin County,2021-01-07,107,543,2.1
13111,Fannin County,2021-01-08,26,569,2.2
13111,Fannin County,2021-01-09,3,572,2.3
13111,Fannin County,2021-01-10,5,577,2.3
13111,Fannin County,2021-01-11,171,748,2.9
13111,Fannin County,2021-01-12,163,911,3.6
13111,Fannin County,2021-01-13,212,1123,4.4
13111,Fannin County,2021-01-14,193,1316,5.2
13111,Fannin County,2021-01-15,107,1423,5.6
13111,Fannin County,2021-01-16,24,1447,5.7
13111,Fannin County,2021-01-17,42,1489,5.9
13111,Fannin County,2021-01-18,149,1638,6.5
13111,Fannin County,2021-01-19,222,1860,7.3
13111,Fannin County,2021-01-20,336,2196,8.6
13111,Fannin County,2021-01-21,121,2317,9.1
13111,Fannin County,2021-01-22,201,2518,9.9
13111,Fannin County,2021-01-23,21,2539,10
13111,Fannin County,2021-01-24,14,2553,10.1
13111,Fannin County,2021-01-25,114,2667,10.5
13111,Fannin County,2021-01-26,83,2750,10.8
13111,Fannin County,2021-01-27,71,2821,11.1
13111,Fannin County,2021-01-28,60,2881,11.3
13111,Fannin County,2021-01-29,59,2940,11.6
13111,Fannin County,2021-01-30,4,2944,11.6
13111,Fannin County,2021-01-31,1,2945,11.6
13111,Fannin County,2021-02-01,62,3007,11.8
13111,Fannin County,2021-02-02,75,3082,12.1
13111,Fannin County,2021-02-03,124,3206,12.6
13111,Fannin County,2021-02-04,63,3269,12.9
13111,Fannin County,2021-02-05,58,3327,13.1
13111,Fannin County,2021-02-06,2,3329,13.1
13111,Fannin County,2021-02-07,1,3330,13.1
13111,Fannin County,2021-02-08,26,3356,13.2
13111,Fannin County,2021-02-09,27,3383,13.3
13111,Fannin County,2021-02-10,111,3494,13.8
13111,Fannin County,2021-02-11,34,3528,13.9
13111,Fannin County,2021-02-12,30,3558,14
13111,Fannin County,2021-02-13,2,3560,14
13111,Fannin County,2021-02-14,4,3564,14
13111,Fannin County,2021-02-15,30,3594,14.2
13111,Fannin County,2021-02-16,41,3635,14.3
13111,Fannin County,2021-02-17,76,3711,14.6
13111,Fannin County,2021-02-18,23,3734,14.7
13111,Fannin County,2021-02-19,31,3765,14.8
13111,Fannin County,2021-02-20,6,3771,14.8
13111,Fannin County,2021-02-21,3,3774,14.9
13111,Fannin County,2021-02-22,14,3788,14.9
13111,Fannin County,2021-02-23,31,3819,15
13111,Fannin County,2021-02-24,55,3874,15.3
13111,Fannin County,2021-02-25,84,3958,15.6
13111,Fannin County,2021-02-26,108,4066,16
13111,Fannin County,2021-02-27,18,4084,16.1
13111,Fannin County,2021-02-28,39,4123,16.2
13111,Fannin County,2021-03-01,172,4295,16.9
13111,Fannin County,2021-03-02,164,4459,17.6
13111,Fannin County,2021-03-03,128,4587,18.1
13111,Fannin County,2021-03-04,154,4741,18.7
13111,Fannin County,2021-03-05,104,4845,19.1
13111,Fannin County,2021-03-06,19,4864,19.2
13111,Fannin County,2021-03-07,31,4895,19.3
13111,Fannin County,2021-03-08,115,5010,19.7
13111,Fannin County,2021-03-09,123,5133,20.2
13111,Fannin County,2021-03-10,86,5219,20.6
13111,Fannin County,2021-03-11,98,5317,20.9
13111,Fannin County,2021-03-12,258,5575,22
13111,Fannin County,2021-03-13,30,5605,22.1
13111,Fannin County,2021-03-14,23,5628,22.2
13111,Fannin County,2021-03-15,189,5817,22.9
13111,Fannin County,2021-03-16,142,5959,23.5
13111,Fannin County,2021-03-17,186,6145,24.2
13111,Fannin County,2021-03-18,88,6233,24.5
13111,Fannin County,2021-03-19,100,6333,24.9
13111,Fannin County,2021-03-20,27,6360,25
13111,Fannin County,2021-03-21,17,6377,25.1
13111,Fannin County,2021-03-22,105,6482,25.5
13111,Fannin County,2021-03-23,118,6600,26
13111,Fannin County,2021-03-24,104,6704,26.4
13111,Fannin County,2021-03-25,109,6813,26.8
13111,Fannin County,2021-03-26,117,6930,27.3
13111,Fannin County,2021-03-27,9,6939,27.3
13111,Fannin County,2021-03-28,13,6952,27.4
13111,Fannin County,2021-03-29,70,7022,27.7
13111,Fannin County,2021-03-30,74,7096,27.9
13111,Fannin County,2021-03-31,108,7204,28.4
13111,Fannin County,2021-04-01,87,7291,28.7
13111,Fannin County,2021-04-02,87,7378,29.1
13111,Fannin County,2021-04-03,34,7412,29.2
13111,Fannin County,2021-04-04,14,7426,29.2
13111,Fannin County,2021-04-05,80,7506,29.6
13111,Fannin County,2021-04-06,59,7565,29.8
13111,Fannin County,2021-04-07,50,7615,30
13111,Fannin County,2021-04-08,70,7685,30.3
13111,Fannin County,2021-04-09,69,7754,30.5
13111,Fannin County,2021-04-10,62,7816,30.8
13111,Fannin County,2021-04-11,15,7831,30.8
13111,Fannin County,2021-04-12,113,7944,31.3
13111,Fannin County,2021-04-13,65,8009,31.5
13111,Fannin County,2021-04-14,47,8056,31.7
13111,Fannin County,2021-04-15,49,8105,31.9
13111,Fannin County,2021-04-16,39,8144,32.1
13111,Fannin County,2021-04-17,17,8161,32.1
13111,Fannin County,2021-04-18,9,8170,32.2
13111,Fannin County,2021-04-19,36,8206,32.3
13111,Fannin County,2021-04-20,39,8245,32.5
13111,Fannin County,2021-04-21,21,8266,32.5
13111,Fannin County,2021-04-22,37,8303,32.7
13111,Fannin County,2021-04-23,39,8342,32.8
13111,Fannin County,2021-04-24,11,8353,32.9
13111,Fannin County,2021-04-25,9,8362,32.9
13111,Fannin County,2021-04-26,26,8388,33
13111,Fannin County,2021-04-27,31,8419,33.2
13111,Fannin County,2021-04-28,32,8451,33.3
13111,Fannin County,2021-04-29,25,8476,33.4
13111,Fannin County,2021-04-30,52,8528,33.6
13111,Fannin County,2021-05-01,15,8543,33.6
13111,Fannin County,2021-05-02,10,8553,33.7
13111,Fannin County,2021-05-03,21,8574,33.8
13111,Fannin County,2021-05-04,30,8604,33.9
13111,Fannin County,2021-05-05,20,8624,34
13111,Fannin County,2021-05-06,16,8640,34
13111,Fannin County,2021-05-07,35,8675,34.2
13111,Fannin County,2021-05-08,5,8680,34.2
13111,Fannin County,2021-05-09,4,8684,34.2
13111,Fannin County,2021-05-10,14,8698,34.3
13111,Fannin County,2021-05-11,21,8719,34.3
13111,Fannin County,2021-05-12,8,8727,34.4
13111,Fannin County,2021-05-13,9,8736,34.4
13111,Fannin County,2021-05-14,29,8765,34.5
13111,Fannin County,2021-05-15,12,8777,34.6
13111,Fannin County,2021-05-16,5,8782,34.6
13111,Fannin County,2021-05-17,16,8798,34.6
13111,Fannin County,2021-05-18,19,8817,34.7
13111,Fannin County,2021-05-19,21,8838,34.8
13111,Fannin County,2021-05-20,12,8850,34.8
13111,Fannin County,2021-05-21,33,8883,35
13111,Fannin County,2021-05-22,7,8890,35
13111,Fannin County,2021-05-24,17,8907,35.1
13111,Fannin County,2021-05-25,17,8924,35.1
13111,Fannin County,2021-05-26,11,8935,35.2
13111,Fannin County,2021-05-27,12,8947,35.2
13111,Fannin County,2021-05-28,26,8973,35.3
13111,Fannin County,2021-05-29,3,8976,35.3
13111,Fannin County,2021-05-30,4,8980,35.4
13111,Fannin County,2021-05-31,1,8981,35.4
13111,Fannin County,2021-06-01,22,9003,35.5
13111,Fannin County,2021-06-02,16,9019,35.5
13111,Fannin County,2021-06-03,10,9029,35.6
13111,Fannin County,2021-06-04,21,9050,35.6
13111,Fannin County,2021-06-05,11,9061,35.7
13111,Fannin County,2021-06-07,10,9071,35.7
13111,Fannin County,2021-06-08,17,9088,35.8
13111,Fannin County,2021-06-09,11,9099,35.8
13111,Fannin County,2021-06-10,9,9108,35.9
13111,Fannin County,2021-06-11,5,9113,35.9
13111,Fannin County,2021-06-12,5,9118,35.9
13111,Fannin County,2021-06-13,2,9120,35.9
13111,Fannin County,2021-06-14,6,9126,35.9
13111,Fannin County,2021-06-15,9,9135,36
13111,Fannin County,2021-06-16,11,9146,36
13111,Fannin County,2021-06-17,10,9156,36.1
13111,Fannin County,2021-06-18,12,9168,36.1
13111,Fannin County,2021-06-19,2,9170,36.1
13111,Fannin County,2021-06-21,12,9182,36.2
13111,Fannin County,2021-06-22,16,9198,36.2
13111,Fannin County,2021-06-23,12,9210,36.3
13111,Fannin County,2021-06-24,11,9221,36.3
13111,Fannin County,2021-06-25,11,9232,36.4
13111,Fannin County,2021-06-26,5,9237,36.4
13111,Fannin County,2021-06-27,2,9239,36.4
13111,Fannin County,2021-06-28,7,9246,36.4
13111,Fannin County,2021-06-29,5,9251,36.4
13111,Fannin County,2021-06-30,15,9266,36.5
13111,Fannin County,2021-07-01,5,9271,36.5
13111,Fannin County,2021-07-02,6,9277,36.5
13111,Fannin County,2021-07-03,2,9279,36.5
13111,Fannin County,2021-07-04,1,9280,36.5
13111,Fannin County,2021-07-05,5,9285,36.6
13111,Fannin County,2021-07-06,5,9290,36.6
13111,Fannin County,2021-07-07,8,9298,36.6
13111,Fannin County,2021-07-08,9,9307,36.6
13111,Fannin County,2021-07-09,9,9316,36.7
13111,Fannin County,2021-07-10,1,9317,36.7
13111,Fannin County,2021-07-11,7,9324,36.7
13111,Fannin County,2021-07-12,9,9333,36.8
13111,Fannin County,2021-07-13,8,9341,36.8
13111,Fannin County,2021-07-14,10,9351,36.8
13111,Fannin County,2021-07-15,10,9361,36.9
13111,Fannin County,2021-07-16,7,9368,36.9
13111,Fannin County,2021-07-17,5,9373,36.9
13111,Fannin County,2021-07-18,5,9378,36.9
13111,Fannin County,2021-07-19,8,9386,37
13111,Fannin County,2021-07-20,8,9394,37
13111,Fannin County,2021-07-21,14,9408,37
13111,Fannin County,2021-07-22,24,9432,37.1
13111,Fannin County,2021-07-23,14,9446,37.2
13111,Fannin County,2021-07-24,15,9461,37.3
13111,Fannin County,2021-07-25,4,9465,37.3
13111,Fannin County,2021-07-26,31,9496,37.4
13111,Fannin County,2021-07-27,24,9520,37.5
13111,Fannin County,2021-07-28,19,9539,37.6
13111,Fannin County,2021-07-29,26,9565,37.7
13111,Fannin County,2021-07-30,40,9605,37.8
13111,Fannin County,2021-07-31,15,9620,37.9
13111,Fannin County,2021-08-01,11,9631,37.9
13111,Fannin County,2021-08-02,25,9656,38
13111,Fannin County,2021-08-03,34,9690,38.2
13111,Fannin County,2021-08-04,29,9719,38.3
13111,Fannin County,2021-08-05,26,9745,38.4
13111,Fannin County,2021-08-06,42,9787,38.5
13111,Fannin County,2021-08-07,20,9807,38.6
13111,Fannin County,2021-08-08,17,9824,38.7
13111,Fannin County,2021-08-09,24,9848,38.8
13111,Fannin County,2021-08-10,28,9876,38.9
13111,Fannin County,2021-08-11,37,9913,39
13111,Fannin County,2021-08-12,44,9957,39.2
13111,Fannin County,2021-08-13,45,10002,39.4
13111,Fannin County,2021-08-14,13,10015,39.4
13111,Fannin County,2021-08-15,9,10024,39.5
13111,Fannin County,2021-08-16,25,10049,39.6
13111,Fannin County,2021-08-17,36,10085,39.7
13111,Fannin County,2021-08-18,26,10111,39.8
13111,Fannin County,2021-08-19,25,10136,39.9
13111,Fannin County,2021-08-20,27,10163,40
13111,Fannin County,2021-08-21,12,10175,40.1
13111,Fannin County,2021-08-22,9,10184,40.1
13111,Fannin County,2021-08-23,23,10207,40.2
13111,Fannin County,2021-08-24,29,10236,40.3
13111,Fannin County,2021-08-25,45,10281,40.5
13111,Fannin County,2021-08-26,37,10318,40.6
13111,Fannin County,2021-08-27,43,10361,40.8
13111,Fannin County,2021-08-28,31,10392,40.9
13111,Fannin County,2021-08-29,8,10400,41
13111,Fannin County,2021-08-30,33,10433,41.1
13111,Fannin County,2021-08-31,34,10467,41.2
13111,Fannin County,2021-09-01,39,10506,41.4
13111,Fannin County,2021-09-02,25,10531,41.5
13111,Fannin County,2021-09-03,39,10570,41.6
13111,Fannin County,2021-09-04,20,10590,41.7
13111,Fannin County,2021-09-05,8,10598,41.7
13111,Fannin County,2021-09-06,5,10603,41.8
13111,Fannin County,2021-09-07,25,10628,41.9
13111,Fannin County,2021-09-08,24,10652,41.9
13111,Fannin County,2021-09-09,22,10674,42
13111,Fannin County,2021-09-10,36,10710,42.2
13111,Fannin County,2021-09-11,15,10725,42.2
13111,Fannin County,2021-09-12,5,10730,42.3
13111,Fannin County,2021-09-13,14,10744,42.3
13111,Fannin County,2021-09-14,13,10757,42.4
13111,Fannin County,2021-09-15,17,10774,42.4
13111,Fannin County,2021-09-16,25,10799,42.5
13111,Fannin County,2021-09-17,19,10818,42.6
13111,Fannin County,2021-09-18,6,10824,42.6
13111,Fannin County,2021-09-19,6,10830,42.6
13111,Fannin County,2021-09-20,14,10844,42.7
13111,Fannin County,2021-09-21,21,10865,42.8
13111,Fannin County,2021-09-22,18,10883,42.9
13111,Fannin County,2021-09-23,12,10895,42.9
13111,Fannin County,2021-09-24,14,10909,43
13111,Fannin County,2021-09-25,2,10911,43
13111,Fannin County,2021-09-26,6,10917,43
13111,Fannin County,2021-09-27,14,10931,43
13111,Fannin County,2021-09-28,10,10941,43.1
13111,Fannin County,2021-09-29,4,10945,43.1
13111,Fannin County,2021-09-30,13,10958,43.2
13111,Fannin County,2021-10-01,8,10966,43.2
13111,Fannin County,2021-10-02,6,10972,43.2
13111,Fannin County,2021-10-03,2,10974,43.2
13111,Fannin County,2021-10-04,5,10979,43.2
13111,Fannin County,2021-10-05,1,10980,43.2
13111,Fannin County,2021-10-06,7,10987,43.3
13111,Fannin County,2021-10-07,7,10994,43.3
13113,Fayette County,2020-12-15,1,1,0
13113,Fayette County,2020-12-16,2,3,0
13113,Fayette County,2020-12-17,10,13,0
13113,Fayette County,2020-12-18,46,59,0.1
13113,Fayette County,2020-12-19,33,92,0.1
13113,Fayette County,2020-12-20,27,119,0.1
13113,Fayette County,2020-12-21,49,168,0.1
13113,Fayette County,2020-12-22,122,290,0.3
13113,Fayette County,2020-12-23,186,476,0.4
13113,Fayette County,2020-12-24,46,522,0.5
13113,Fayette County,2020-12-25,2,524,0.5
13113,Fayette County,2020-12-26,8,532,0.5
13113,Fayette County,2020-12-27,35,567,0.5
13113,Fayette County,2020-12-28,248,815,0.7
13113,Fayette County,2020-12-29,374,1189,1.1
13113,Fayette County,2020-12-30,204,1393,1.2
13113,Fayette County,2020-12-31,137,1530,1.4
13113,Fayette County,2021-01-01,53,1583,1.4
13113,Fayette County,2021-01-02,9,1592,1.4
13113,Fayette County,2021-01-03,17,1609,1.4
13113,Fayette County,2021-01-04,242,1851,1.6
13113,Fayette County,2021-01-05,100,1951,1.7
13113,Fayette County,2021-01-06,129,2080,1.9
13113,Fayette County,2021-01-07,109,2189,1.9
13113,Fayette County,2021-01-08,131,2320,2.1
13113,Fayette County,2021-01-09,63,2383,2.1
13113,Fayette County,2021-01-10,100,2483,2.2
13113,Fayette County,2021-01-11,332,2815,2.5
13113,Fayette County,2021-01-12,616,3431,3.1
13113,Fayette County,2021-01-13,799,4230,3.8
13113,Fayette County,2021-01-14,755,4985,4.4
13113,Fayette County,2021-01-15,643,5628,5
13113,Fayette County,2021-01-16,393,6021,5.4
13113,Fayette County,2021-01-17,177,6198,5.5
13113,Fayette County,2021-01-18,451,6649,5.9
13113,Fayette County,2021-01-19,609,7258,6.5
13113,Fayette County,2021-01-20,563,7821,7
13113,Fayette County,2021-01-21,487,8308,7.4
13113,Fayette County,2021-01-22,640,8948,8
13113,Fayette County,2021-01-23,211,9159,8.2
13113,Fayette County,2021-01-24,30,9189,8.2
13113,Fayette County,2021-01-25,380,9569,8.5
13113,Fayette County,2021-01-26,259,9828,8.8
13113,Fayette County,2021-01-27,408,10236,9.1
13113,Fayette County,2021-01-28,501,10737,9.6
13113,Fayette County,2021-01-29,604,11341,10.1
13113,Fayette County,2021-01-30,214,11555,10.3
13113,Fayette County,2021-01-31,58,11613,10.3
13113,Fayette County,2021-02-01,224,11837,10.5
13113,Fayette County,2021-02-02,196,12033,10.7
13113,Fayette County,2021-02-03,193,12226,10.9
13113,Fayette County,2021-02-04,377,12603,11.2
13113,Fayette County,2021-02-05,235,12838,11.4
13113,Fayette County,2021-02-06,76,12914,11.5
13113,Fayette County,2021-02-07,23,12937,11.5
13113,Fayette County,2021-02-08,146,13083,11.6
13113,Fayette County,2021-02-09,208,13291,11.8
13113,Fayette County,2021-02-10,268,13559,12.1
13113,Fayette County,2021-02-11,234,13793,12.3
13113,Fayette County,2021-02-12,202,13995,12.5
13113,Fayette County,2021-02-13,120,14115,12.6
13113,Fayette County,2021-02-14,67,14182,12.6
13113,Fayette County,2021-02-15,185,14367,12.8
13113,Fayette County,2021-02-16,317,14684,13.1
13113,Fayette County,2021-02-17,603,15287,13.6
13113,Fayette County,2021-02-18,235,15522,13.8
13113,Fayette County,2021-02-19,453,15975,14.2
13113,Fayette County,2021-02-20,68,16043,14.3
13113,Fayette County,2021-02-21,36,16079,14.3
13113,Fayette County,2021-02-22,230,16309,14.5
13113,Fayette County,2021-02-23,695,17004,15.1
13113,Fayette County,2021-02-24,800,17804,15.9
13113,Fayette County,2021-02-25,429,18233,16.2
13113,Fayette County,2021-02-26,445,18678,16.6
13113,Fayette County,2021-02-27,147,18825,16.8
13113,Fayette County,2021-02-28,142,18967,16.9
13113,Fayette County,2021-03-01,331,19298,17.2
13113,Fayette County,2021-03-02,446,19744,17.6
13113,Fayette County,2021-03-03,984,20728,18.5
13113,Fayette County,2021-03-04,545,21273,18.9
13113,Fayette County,2021-03-05,690,21963,19.6
13113,Fayette County,2021-03-06,120,22083,19.7
13113,Fayette County,2021-03-07,149,22232,19.8
13113,Fayette County,2021-03-08,568,22800,20.3
13113,Fayette County,2021-03-09,622,23422,20.9
13113,Fayette County,2021-03-10,822,24244,21.6
13113,Fayette County,2021-03-11,1661,25905,23.1
13113,Fayette County,2021-03-12,673,26578,23.7
13113,Fayette County,2021-03-13,223,26801,23.9
13113,Fayette County,2021-03-14,241,27042,24.1
13113,Fayette County,2021-03-15,826,27868,24.8
13113,Fayette County,2021-03-16,848,28716,25.6
13113,Fayette County,2021-03-17,1116,29832,26.6
13113,Fayette County,2021-03-18,809,30641,27.3
13113,Fayette County,2021-03-19,977,31618,28.2
13113,Fayette County,2021-03-20,268,31886,28.4
13113,Fayette County,2021-03-21,282,32168,28.6
13113,Fayette County,2021-03-22,837,33005,29.4
13113,Fayette County,2021-03-23,813,33818,30.1
13113,Fayette County,2021-03-24,1015,34833,31
13113,Fayette County,2021-03-25,1053,35886,32
13113,Fayette County,2021-03-26,777,36663,32.6
13113,Fayette County,2021-03-27,451,37114,33
13113,Fayette County,2021-03-28,294,37408,33.3
13113,Fayette County,2021-03-29,725,38133,34
13113,Fayette County,2021-03-30,1020,39153,34.9
13113,Fayette County,2021-03-31,1222,40375,36
13113,Fayette County,2021-04-01,1267,41642,37.1
13113,Fayette County,2021-04-02,868,42510,37.9
13113,Fayette County,2021-04-03,397,42907,38.2
13113,Fayette County,2021-04-04,185,43092,38.4
13113,Fayette County,2021-04-05,594,43686,38.9
13113,Fayette County,2021-04-06,1041,44727,39.8
13113,Fayette County,2021-04-07,968,45695,40.7
13113,Fayette County,2021-04-08,720,46415,41.3
13113,Fayette County,2021-04-09,729,47144,42
13113,Fayette County,2021-04-10,815,47959,42.7
13113,Fayette County,2021-04-11,275,48234,42.9
13113,Fayette County,2021-04-12,433,48667,43.3
13113,Fayette County,2021-04-13,560,49227,43.8
13113,Fayette County,2021-04-14,488,49715,44.3
13113,Fayette County,2021-04-15,417,50132,44.6
13113,Fayette County,2021-04-16,439,50571,45
13113,Fayette County,2021-04-17,113,50684,45.1
13113,Fayette County,2021-04-18,109,50793,45.2
13113,Fayette County,2021-04-19,270,51063,45.5
13113,Fayette County,2021-04-20,415,51478,45.8
13113,Fayette County,2021-04-21,487,51965,46.3
13113,Fayette County,2021-04-22,383,52348,46.6
13113,Fayette County,2021-04-23,334,52682,46.9
13113,Fayette County,2021-04-24,157,52839,47.1
13113,Fayette County,2021-04-25,124,52963,47.2
13113,Fayette County,2021-04-26,233,53196,47.4
13113,Fayette County,2021-04-27,308,53504,47.6
13113,Fayette County,2021-04-28,335,53839,47.9
13113,Fayette County,2021-04-29,291,54130,48.2
13113,Fayette County,2021-04-30,352,54482,48.5
13113,Fayette County,2021-05-01,172,54654,48.7
13113,Fayette County,2021-05-02,101,54755,48.8
13113,Fayette County,2021-05-03,180,54935,48.9
13113,Fayette County,2021-05-04,227,55162,49.1
13113,Fayette County,2021-05-05,247,55409,49.3
13113,Fayette County,2021-05-06,198,55607,49.5
13113,Fayette County,2021-05-07,222,55829,49.7
13113,Fayette County,2021-05-08,135,55964,49.8
13113,Fayette County,2021-05-09,54,56018,49.9
13113,Fayette County,2021-05-10,151,56169,50
13113,Fayette County,2021-05-11,211,56380,50.2
13113,Fayette County,2021-05-12,199,56579,50.4
13113,Fayette County,2021-05-13,243,56822,50.6
13113,Fayette County,2021-05-14,296,57118,50.9
13113,Fayette County,2021-05-15,303,57421,51.1
13113,Fayette County,2021-05-16,166,57587,51.3
13113,Fayette County,2021-05-17,280,57867,51.5
13113,Fayette County,2021-05-18,269,58136,51.8
13113,Fayette County,2021-05-19,252,58388,52
13113,Fayette County,2021-05-20,211,58599,52.2
13113,Fayette County,2021-05-21,226,58825,52.4
13113,Fayette County,2021-05-22,198,59023,52.6
13113,Fayette County,2021-05-23,100,59123,52.6
13113,Fayette County,2021-05-24,155,59278,52.8
13113,Fayette County,2021-05-25,142,59420,52.9
13113,Fayette County,2021-05-26,133,59553,53
13113,Fayette County,2021-05-27,166,59719,53.2
13113,Fayette County,2021-05-28,149,59868,53.3
13113,Fayette County,2021-05-29,99,59967,53.4
13113,Fayette County,2021-05-30,68,60035,53.5
13113,Fayette County,2021-05-31,18,60053,53.5
13113,Fayette County,2021-06-01,142,60195,53.6
13113,Fayette County,2021-06-02,140,60335,53.7
13113,Fayette County,2021-06-03,97,60432,53.8
13113,Fayette County,2021-06-04,146,60578,53.9
13113,Fayette County,2021-06-05,85,60663,54
13113,Fayette County,2021-06-06,62,60725,54.1
13113,Fayette County,2021-06-07,117,60842,54.2
13113,Fayette County,2021-06-08,106,60948,54.3
13113,Fayette County,2021-06-09,82,61030,54.3
13113,Fayette County,2021-06-10,114,61144,54.4
13113,Fayette County,2021-06-11,116,61260,54.5
13113,Fayette County,2021-06-12,56,61316,54.6
13113,Fayette County,2021-06-13,30,61346,54.6
13113,Fayette County,2021-06-14,114,61460,54.7
13113,Fayette County,2021-06-15,99,61559,54.8
13113,Fayette County,2021-06-16,87,61646,54.9
13113,Fayette County,2021-06-17,94,61740,55
13113,Fayette County,2021-06-18,94,61834,55.1
13113,Fayette County,2021-06-19,53,61887,55.1
13113,Fayette County,2021-06-20,29,61916,55.1
13113,Fayette County,2021-06-21,86,62002,55.2
13113,Fayette County,2021-06-22,92,62094,55.3
13113,Fayette County,2021-06-23,76,62170,55.4
13113,Fayette County,2021-06-24,74,62244,55.4
13113,Fayette County,2021-06-25,80,62324,55.5
13113,Fayette County,2021-06-26,56,62380,55.5
13113,Fayette County,2021-06-27,36,62416,55.6
13113,Fayette County,2021-06-28,63,62479,55.6
13113,Fayette County,2021-06-29,73,62552,55.7
13113,Fayette County,2021-06-30,78,62630,55.8
13113,Fayette County,2021-07-01,61,62691,55.8
13113,Fayette County,2021-07-02,101,62792,55.9
13113,Fayette County,2021-07-03,61,62853,56
13113,Fayette County,2021-07-04,10,62863,56
13113,Fayette County,2021-07-05,66,62929,56
13113,Fayette County,2021-07-06,94,63023,56.1
13113,Fayette County,2021-07-07,77,63100,56.2
13113,Fayette County,2021-07-08,68,63168,56.2
13113,Fayette County,2021-07-09,86,63254,56.3
13113,Fayette County,2021-07-10,54,63308,56.4
13113,Fayette County,2021-07-11,45,63353,56.4
13113,Fayette County,2021-07-12,54,63407,56.5
13113,Fayette County,2021-07-13,69,63476,56.5
13113,Fayette County,2021-07-14,79,63555,56.6
13113,Fayette County,2021-07-15,79,63634,56.7
13113,Fayette County,2021-07-16,99,63733,56.8
13113,Fayette County,2021-07-17,63,63796,56.8
13113,Fayette County,2021-07-18,51,63847,56.9
13113,Fayette County,2021-07-19,84,63931,56.9
13113,Fayette County,2021-07-20,135,64066,57
13113,Fayette County,2021-07-21,100,64166,57.1
13113,Fayette County,2021-07-22,122,64288,57.2
13113,Fayette County,2021-07-23,142,64430,57.4
13113,Fayette County,2021-07-24,118,64548,57.5
13113,Fayette County,2021-07-25,96,64644,57.6
13113,Fayette County,2021-07-26,151,64795,57.7
13113,Fayette County,2021-07-27,141,64936,57.8
13113,Fayette County,2021-07-28,165,65101,58
13113,Fayette County,2021-07-29,158,65259,58.1
13113,Fayette County,2021-07-30,206,65465,58.3
13113,Fayette County,2021-07-31,99,65564,58.4
13113,Fayette County,2021-08-01,76,65640,58.4
13113,Fayette County,2021-08-02,155,65795,58.6
13113,Fayette County,2021-08-03,166,65961,58.7
13113,Fayette County,2021-08-04,188,66149,58.9
13113,Fayette County,2021-08-05,174,66323,59.1
13113,Fayette County,2021-08-06,245,66568,59.3
13113,Fayette County,2021-08-07,135,66703,59.4
13113,Fayette County,2021-08-08,93,66796,59.5
13113,Fayette County,2021-08-09,143,66939,59.6
13113,Fayette County,2021-08-10,207,67146,59.8
13113,Fayette County,2021-08-11,178,67324,59.9
13113,Fayette County,2021-08-12,191,67515,60.1
13113,Fayette County,2021-08-13,176,67691,60.3
13113,Fayette County,2021-08-14,92,67783,60.4
13113,Fayette County,2021-08-15,57,67840,60.4
13113,Fayette County,2021-08-16,158,67998,60.5
13113,Fayette County,2021-08-17,171,68169,60.7
13113,Fayette County,2021-08-18,161,68330,60.8
13113,Fayette County,2021-08-19,155,68485,61
13113,Fayette County,2021-08-20,167,68652,61.1
13113,Fayette County,2021-08-21,111,68763,61.2
13113,Fayette County,2021-08-22,73,68836,61.3
13113,Fayette County,2021-08-23,155,68991,61.4
13113,Fayette County,2021-08-24,154,69145,61.6
13113,Fayette County,2021-08-25,155,69300,61.7
13113,Fayette County,2021-08-26,190,69490,61.9
13113,Fayette County,2021-08-27,179,69669,62
13113,Fayette County,2021-08-28,111,69780,62.1
13113,Fayette County,2021-08-29,74,69854,62.2
13113,Fayette County,2021-08-30,167,70021,62.4
13113,Fayette County,2021-08-31,136,70157,62.5
13113,Fayette County,2021-09-01,173,70330,62.6
13113,Fayette County,2021-09-02,148,70478,62.8
13113,Fayette County,2021-09-03,158,70636,62.9
13113,Fayette County,2021-09-04,97,70733,63
13113,Fayette County,2021-09-05,70,70803,63
13113,Fayette County,2021-09-06,9,70812,63.1
13113,Fayette County,2021-09-07,108,70920,63.2
13113,Fayette County,2021-09-08,156,71076,63.3
13113,Fayette County,2021-09-09,131,71207,63.4
13113,Fayette County,2021-09-10,158,71365,63.5
13113,Fayette County,2021-09-11,96,71461,63.6
13113,Fayette County,2021-09-12,49,71510,63.7
13113,Fayette County,2021-09-13,133,71643,63.8
13113,Fayette County,2021-09-14,110,71753,63.9
13113,Fayette County,2021-09-15,106,71859,64
13113,Fayette County,2021-09-16,95,71954,64.1
13113,Fayette County,2021-09-17,127,72081,64.2
13113,Fayette County,2021-09-18,85,72166,64.3
13113,Fayette County,2021-09-19,36,72202,64.3
13113,Fayette County,2021-09-20,73,72275,64.4
13113,Fayette County,2021-09-21,65,72340,64.4
13113,Fayette County,2021-09-22,72,72412,64.5
13113,Fayette County,2021-09-23,54,72466,64.5
13113,Fayette County,2021-09-24,62,72528,64.6
13113,Fayette County,2021-09-25,36,72564,64.6
13113,Fayette County,2021-09-26,29,72593,64.6
13113,Fayette County,2021-09-27,33,72626,64.7
13113,Fayette County,2021-09-28,35,72661,64.7
13113,Fayette County,2021-09-29,43,72704,64.7
13113,Fayette County,2021-09-30,28,72732,64.8
13113,Fayette County,2021-10-01,43,72775,64.8
13113,Fayette County,2021-10-02,23,72798,64.8
13113,Fayette County,2021-10-03,8,72806,64.8
13113,Fayette County,2021-10-04,12,72818,64.8
13113,Fayette County,2021-10-05,13,72831,64.9
13113,Fayette County,2021-10-06,43,72874,64.9
13113,Fayette County,2021-10-07,8,72882,64.9
13115,Floyd County,2020-12-15,1,1,0
13115,Floyd County,2020-12-16,1,2,0
13115,Floyd County,2020-12-17,2,4,0
13115,Floyd County,2020-12-18,80,84,0.1
13115,Floyd County,2020-12-20,6,90,0.1
13115,Floyd County,2020-12-21,142,232,0.2
13115,Floyd County,2020-12-22,182,414,0.4
13115,Floyd County,2020-12-23,251,665,0.7
13115,Floyd County,2020-12-24,6,671,0.7
13115,Floyd County,2020-12-26,27,698,0.7
13115,Floyd County,2020-12-27,13,711,0.7
13115,Floyd County,2020-12-28,188,899,0.9
13115,Floyd County,2020-12-29,219,1118,1.1
13115,Floyd County,2020-12-30,163,1281,1.3
13115,Floyd County,2020-12-31,196,1477,1.5
13115,Floyd County,2021-01-01,25,1502,1.5
13115,Floyd County,2021-01-02,44,1546,1.6
13115,Floyd County,2021-01-03,41,1587,1.6
13115,Floyd County,2021-01-04,149,1736,1.8
13115,Floyd County,2021-01-05,264,2000,2.1
13115,Floyd County,2021-01-06,265,2265,2.3
13115,Floyd County,2021-01-07,358,2623,2.7
13115,Floyd County,2021-01-08,255,2878,3
13115,Floyd County,2021-01-09,11,2889,3
13115,Floyd County,2021-01-10,57,2946,3
13115,Floyd County,2021-01-11,399,3345,3.4
13115,Floyd County,2021-01-12,646,3991,4.1
13115,Floyd County,2021-01-13,608,4599,4.7
13115,Floyd County,2021-01-14,714,5313,5.5
13115,Floyd County,2021-01-15,432,5745,5.9
13115,Floyd County,2021-01-16,68,5813,6
13115,Floyd County,2021-01-17,26,5839,6
13115,Floyd County,2021-01-18,739,6578,6.8
13115,Floyd County,2021-01-19,999,7577,7.8
13115,Floyd County,2021-01-20,706,8283,8.5
13115,Floyd County,2021-01-21,508,8791,9
13115,Floyd County,2021-01-22,305,9096,9.3
13115,Floyd County,2021-01-23,21,9117,9.4
13115,Floyd County,2021-01-24,14,9131,9.4
13115,Floyd County,2021-01-25,158,9289,9.5
13115,Floyd County,2021-01-26,149,9438,9.7
13115,Floyd County,2021-01-27,630,10068,10.3
13115,Floyd County,2021-01-28,598,10666,11
13115,Floyd County,2021-01-29,372,11038,11.3
13115,Floyd County,2021-01-30,15,11053,11.4
13115,Floyd County,2021-01-31,8,11061,11.4
13115,Floyd County,2021-02-01,573,11634,11.9
13115,Floyd County,2021-02-02,410,12044,12.4
13115,Floyd County,2021-02-03,217,12261,12.6
13115,Floyd County,2021-02-04,387,12648,13
13115,Floyd County,2021-02-05,368,13016,13.4
13115,Floyd County,2021-02-06,160,13176,13.5
13115,Floyd County,2021-02-07,5,13181,13.5
13115,Floyd County,2021-02-08,204,13385,13.7
13115,Floyd County,2021-02-09,85,13470,13.8
13115,Floyd County,2021-02-10,76,13546,13.9
13115,Floyd County,2021-02-11,276,13822,14.2
13115,Floyd County,2021-02-12,225,14047,14.4
13115,Floyd County,2021-02-13,16,14063,14.4
13115,Floyd County,2021-02-14,11,14074,14.5
13115,Floyd County,2021-02-15,71,14145,14.5
13115,Floyd County,2021-02-16,27,14172,14.6
13115,Floyd County,2021-02-17,55,14227,14.6
13115,Floyd County,2021-02-18,37,14264,14.6
13115,Floyd County,2021-02-19,196,14460,14.9
13115,Floyd County,2021-02-20,2,14462,14.9
13115,Floyd County,2021-02-21,11,14473,14.9
13115,Floyd County,2021-02-22,22,14495,14.9
13115,Floyd County,2021-02-23,37,14532,14.9
13115,Floyd County,2021-02-24,62,14594,15
13115,Floyd County,2021-02-25,38,14632,15
13115,Floyd County,2021-02-26,169,14801,15.2
13115,Floyd County,2021-02-27,13,14814,15.2
13115,Floyd County,2021-02-28,21,14835,15.2
13115,Floyd County,2021-03-01,135,14970,15.4
13115,Floyd County,2021-03-02,117,15087,15.5
13115,Floyd County,2021-03-03,177,15264,15.7
13115,Floyd County,2021-03-04,229,15493,15.9
13115,Floyd County,2021-03-05,243,15736,16.2
13115,Floyd County,2021-03-06,108,15844,16.3
13115,Floyd County,2021-03-07,21,15865,16.3
13115,Floyd County,2021-03-08,398,16263,16.7
13115,Floyd County,2021-03-09,103,16366,16.8
13115,Floyd County,2021-03-10,462,16828,17.3
13115,Floyd County,2021-03-11,241,17069,17.5
13115,Floyd County,2021-03-12,691,17760,18.2
13115,Floyd County,2021-03-13,103,17863,18.3
13115,Floyd County,2021-03-14,26,17889,18.4
13115,Floyd County,2021-03-15,492,18381,18.9
13115,Floyd County,2021-03-16,354,18735,19.2
13115,Floyd County,2021-03-17,366,19101,19.6
13115,Floyd County,2021-03-18,527,19628,20.2
13115,Floyd County,2021-03-19,898,20526,21.1
13115,Floyd County,2021-03-20,30,20556,21.1
13115,Floyd County,2021-03-21,43,20599,21.2
13115,Floyd County,2021-03-22,245,20844,21.4
13115,Floyd County,2021-03-23,281,21125,21.7
13115,Floyd County,2021-03-24,348,21473,22.1
13115,Floyd County,2021-03-25,158,21631,22.2
13115,Floyd County,2021-03-26,776,22407,23
13115,Floyd County,2021-03-27,106,22513,23.1
13115,Floyd County,2021-03-28,50,22563,23.2
13115,Floyd County,2021-03-29,426,22989,23.6
13115,Floyd County,2021-03-30,378,23367,24
13115,Floyd County,2021-03-31,745,24112,24.8
13115,Floyd County,2021-04-01,481,24593,25.3
13115,Floyd County,2021-04-02,427,25020,25.7
13115,Floyd County,2021-04-03,67,25087,25.8
13115,Floyd County,2021-04-04,43,25130,25.8
13115,Floyd County,2021-04-05,404,25534,26.2
13115,Floyd County,2021-04-06,276,25810,26.5
13115,Floyd County,2021-04-07,362,26172,26.9
13115,Floyd County,2021-04-08,281,26453,27.2
13115,Floyd County,2021-04-09,542,26995,27.7
13115,Floyd County,2021-04-10,94,27089,27.8
13115,Floyd County,2021-04-11,46,27135,27.9
13115,Floyd County,2021-04-12,207,27342,28.1
13115,Floyd County,2021-04-13,180,27522,28.3
13115,Floyd County,2021-04-14,120,27642,28.4
13115,Floyd County,2021-04-15,260,27902,28.7
13115,Floyd County,2021-04-16,221,28123,28.9
13115,Floyd County,2021-04-17,47,28170,28.9
13115,Floyd County,2021-04-18,19,28189,29
13115,Floyd County,2021-04-19,91,28280,29
13115,Floyd County,2021-04-20,159,28439,29.2
13115,Floyd County,2021-04-21,226,28665,29.4
13115,Floyd County,2021-04-22,219,28884,29.7
13115,Floyd County,2021-04-23,243,29127,29.9
13115,Floyd County,2021-04-24,30,29157,29.9
13115,Floyd County,2021-04-25,14,29171,30
13115,Floyd County,2021-04-26,45,29216,30
13115,Floyd County,2021-04-27,208,29424,30.2
13115,Floyd County,2021-04-28,100,29524,30.3
13115,Floyd County,2021-04-29,149,29673,30.5
13115,Floyd County,2021-04-30,196,29869,30.7
13115,Floyd County,2021-05-01,39,29908,30.7
13115,Floyd County,2021-05-02,29,29937,30.7
13115,Floyd County,2021-05-03,82,30019,30.8
13115,Floyd County,2021-05-04,134,30153,31
13115,Floyd County,2021-05-05,105,30258,31.1
13115,Floyd County,2021-05-06,117,30375,31.2
13115,Floyd County,2021-05-07,210,30585,31.4
13115,Floyd County,2021-05-08,45,30630,31.5
13115,Floyd County,2021-05-09,16,30646,31.5
13115,Floyd County,2021-05-10,30,30676,31.5
13115,Floyd County,2021-05-11,88,30764,31.6
13115,Floyd County,2021-05-12,58,30822,31.7
13115,Floyd County,2021-05-13,114,30936,31.8
13115,Floyd County,2021-05-14,192,31128,32
13115,Floyd County,2021-05-15,137,31265,32.1
13115,Floyd County,2021-05-16,55,31320,32.2
13115,Floyd County,2021-05-17,82,31402,32.3
13115,Floyd County,2021-05-18,122,31524,32.4
13115,Floyd County,2021-05-19,88,31612,32.5
13115,Floyd County,2021-05-20,110,31722,32.6
13115,Floyd County,2021-05-21,175,31897,32.8
13115,Floyd County,2021-05-22,50,31947,32.8
13115,Floyd County,2021-05-23,31,31978,32.8
13115,Floyd County,2021-05-24,59,32037,32.9
13115,Floyd County,2021-05-25,81,32118,33
13115,Floyd County,2021-05-26,82,32200,33.1
13115,Floyd County,2021-05-27,100,32300,33.2
13115,Floyd County,2021-05-28,117,32417,33.3
13115,Floyd County,2021-05-29,45,32462,33.3
13115,Floyd County,2021-05-30,34,32496,33.4
13115,Floyd County,2021-05-31,24,32520,33.4
13115,Floyd County,2021-06-01,61,32581,33.5
13115,Floyd County,2021-06-02,51,32632,33.5
13115,Floyd County,2021-06-03,68,32700,33.6
13115,Floyd County,2021-06-04,95,32795,33.7
13115,Floyd County,2021-06-05,23,32818,33.7
13115,Floyd County,2021-06-06,19,32837,33.7
13115,Floyd County,2021-06-07,48,32885,33.8
13115,Floyd County,2021-06-08,72,32957,33.8
13115,Floyd County,2021-06-09,60,33017,33.9
13115,Floyd County,2021-06-10,93,33110,34
13115,Floyd County,2021-06-11,55,33165,34.1
13115,Floyd County,2021-06-12,32,33197,34.1
13115,Floyd County,2021-06-13,16,33213,34.1
13115,Floyd County,2021-06-14,27,33240,34.1
13115,Floyd County,2021-06-15,67,33307,34.2
13115,Floyd County,2021-06-16,38,33345,34.2
13115,Floyd County,2021-06-17,69,33414,34.3
13115,Floyd County,2021-06-18,48,33462,34.4
13115,Floyd County,2021-06-19,21,33483,34.4
13115,Floyd County,2021-06-20,9,33492,34.4
13115,Floyd County,2021-06-21,32,33524,34.4
13115,Floyd County,2021-06-22,63,33587,34.5
13115,Floyd County,2021-06-23,51,33638,34.5
13115,Floyd County,2021-06-24,47,33685,34.6
13115,Floyd County,2021-06-25,76,33761,34.7
13115,Floyd County,2021-06-26,28,33789,34.7
13115,Floyd County,2021-06-27,10,33799,34.7
13115,Floyd County,2021-06-28,34,33833,34.7
13115,Floyd County,2021-06-29,40,33873,34.8
13115,Floyd County,2021-06-30,30,33903,34.8
13115,Floyd County,2021-07-01,42,33945,34.9
13115,Floyd County,2021-07-02,43,33988,34.9
13115,Floyd County,2021-07-03,19,34007,34.9
13115,Floyd County,2021-07-04,3,34010,34.9
13115,Floyd County,2021-07-05,27,34037,35
13115,Floyd County,2021-07-06,45,34082,35
13115,Floyd County,2021-07-07,33,34115,35
13115,Floyd County,2021-07-08,74,34189,35.1
13115,Floyd County,2021-07-09,42,34231,35.2
13115,Floyd County,2021-07-10,23,34254,35.2
13115,Floyd County,2021-07-11,13,34267,35.2
13115,Floyd County,2021-07-12,30,34297,35.2
13115,Floyd County,2021-07-13,81,34378,35.3
13115,Floyd County,2021-07-14,40,34418,35.3
13115,Floyd County,2021-07-15,71,34489,35.4
13115,Floyd County,2021-07-16,65,34554,35.5
13115,Floyd County,2021-07-17,23,34577,35.5
13115,Floyd County,2021-07-18,22,34599,35.5
13115,Floyd County,2021-07-19,52,34651,35.6
13115,Floyd County,2021-07-20,71,34722,35.7
13115,Floyd County,2021-07-21,61,34783,35.7
13115,Floyd County,2021-07-22,95,34878,35.8
13115,Floyd County,2021-07-23,110,34988,35.9
13115,Floyd County,2021-07-24,75,35063,36
13115,Floyd County,2021-07-25,35,35098,36
13115,Floyd County,2021-07-26,67,35165,36.1
13115,Floyd County,2021-07-27,138,35303,36.3
13115,Floyd County,2021-07-28,89,35392,36.3
13115,Floyd County,2021-07-29,120,35512,36.5
13115,Floyd County,2021-07-30,185,35697,36.7
13115,Floyd County,2021-07-31,62,35759,36.7
13115,Floyd County,2021-08-01,44,35803,36.8
13115,Floyd County,2021-08-02,134,35937,36.9
13115,Floyd County,2021-08-03,169,36106,37.1
13115,Floyd County,2021-08-04,124,36230,37.2
13115,Floyd County,2021-08-05,177,36407,37.4
13115,Floyd County,2021-08-06,144,36551,37.5
13115,Floyd County,2021-08-07,94,36645,37.6
13115,Floyd County,2021-08-08,68,36713,37.7
13115,Floyd County,2021-08-09,124,36837,37.8
13115,Floyd County,2021-08-10,165,37002,38
13115,Floyd County,2021-08-11,125,37127,38.1
13115,Floyd County,2021-08-12,181,37308,38.3
13115,Floyd County,2021-08-13,206,37514,38.5
13115,Floyd County,2021-08-14,84,37598,38.6
13115,Floyd County,2021-08-15,60,37658,38.7
13115,Floyd County,2021-08-16,148,37806,38.8
13115,Floyd County,2021-08-17,254,38060,39.1
13115,Floyd County,2021-08-18,212,38272,39.3
13115,Floyd County,2021-08-19,277,38549,39.6
13115,Floyd County,2021-08-20,288,38837,39.9
13115,Floyd County,2021-08-21,110,38947,40
13115,Floyd County,2021-08-22,98,39045,40.1
13115,Floyd County,2021-08-23,158,39203,40.3
13115,Floyd County,2021-08-24,231,39434,40.5
13115,Floyd County,2021-08-25,162,39596,40.7
13115,Floyd County,2021-08-26,193,39789,40.9
13115,Floyd County,2021-08-27,290,40079,41.2
13115,Floyd County,2021-08-28,96,40175,41.3
13115,Floyd County,2021-08-29,68,40243,41.3
13115,Floyd County,2021-08-30,126,40369,41.5
13115,Floyd County,2021-08-31,221,40590,41.7
13115,Floyd County,2021-09-01,190,40780,41.9
13115,Floyd County,2021-09-02,246,41026,42.1
13115,Floyd County,2021-09-03,399,41425,42.5
13115,Floyd County,2021-09-04,119,41544,42.7
13115,Floyd County,2021-09-05,87,41631,42.8
13115,Floyd County,2021-09-06,57,41688,42.8
13115,Floyd County,2021-09-07,179,41867,43
13115,Floyd County,2021-09-08,142,42009,43.1
13115,Floyd County,2021-09-09,185,42194,43.3
13115,Floyd County,2021-09-10,221,42415,43.6
13115,Floyd County,2021-09-11,89,42504,43.7
13115,Floyd County,2021-09-12,65,42569,43.7
13115,Floyd County,2021-09-13,133,42702,43.9
13115,Floyd County,2021-09-14,135,42837,44
13115,Floyd County,2021-09-15,145,42982,44.1
13115,Floyd County,2021-09-16,142,43124,44.3
13115,Floyd County,2021-09-17,145,43269,44.4
13115,Floyd County,2021-09-18,69,43338,44.5
13115,Floyd County,2021-09-19,48,43386,44.6
13115,Floyd County,2021-09-20,91,43477,44.7
13115,Floyd County,2021-09-21,82,43559,44.7
13115,Floyd County,2021-09-22,50,43609,44.8
13115,Floyd County,2021-09-23,81,43690,44.9
13115,Floyd County,2021-09-24,84,43774,45
13115,Floyd County,2021-09-25,27,43801,45
13115,Floyd County,2021-09-26,16,43817,45
13115,Floyd County,2021-09-27,45,43862,45
13115,Floyd County,2021-09-28,43,43905,45.1
13115,Floyd County,2021-09-29,55,43960,45.1
13115,Floyd County,2021-09-30,47,44007,45.2
13115,Floyd County,2021-10-01,61,44068,45.3
13115,Floyd County,2021-10-02,18,44086,45.3
13115,Floyd County,2021-10-03,9,44095,45.3
13115,Floyd County,2021-10-04,17,44112,45.3
13115,Floyd County,2021-10-05,26,44138,45.3
13115,Floyd County,2021-10-06,27,44165,45.4
13115,Floyd County,2021-10-07,21,44186,45.4
13117,Forsyth County,2020-12-16,3,3,0
13117,Forsyth County,2020-12-17,46,49,0
13117,Forsyth County,2020-12-18,95,144,0.1
13117,Forsyth County,2020-12-19,66,210,0.1
13117,Forsyth County,2020-12-20,85,295,0.1
13117,Forsyth County,2020-12-21,127,422,0.2
13117,Forsyth County,2020-12-22,184,606,0.3
13117,Forsyth County,2020-12-23,197,803,0.4
13117,Forsyth County,2020-12-24,56,859,0.4
13117,Forsyth County,2020-12-25,1,860,0.4
13117,Forsyth County,2020-12-26,30,890,0.4
13117,Forsyth County,2020-12-27,63,953,0.4
13117,Forsyth County,2020-12-28,278,1231,0.5
13117,Forsyth County,2020-12-29,287,1518,0.7
13117,Forsyth County,2020-12-30,432,1950,0.9
13117,Forsyth County,2020-12-31,86,2036,0.9
13117,Forsyth County,2021-01-01,333,2369,1
13117,Forsyth County,2021-01-02,38,2407,1.1
13117,Forsyth County,2021-01-03,57,2464,1.1
13117,Forsyth County,2021-01-04,378,2842,1.2
13117,Forsyth County,2021-01-05,264,3106,1.4
13117,Forsyth County,2021-01-06,388,3494,1.5
13117,Forsyth County,2021-01-07,371,3865,1.7
13117,Forsyth County,2021-01-08,269,4134,1.8
13117,Forsyth County,2021-01-09,142,4276,1.9
13117,Forsyth County,2021-01-10,46,4322,1.9
13117,Forsyth County,2021-01-11,323,4645,2
13117,Forsyth County,2021-01-12,370,5015,2.2
13117,Forsyth County,2021-01-13,468,5483,2.4
13117,Forsyth County,2021-01-14,579,6062,2.7
13117,Forsyth County,2021-01-15,644,6706,2.9
13117,Forsyth County,2021-01-16,516,7222,3.2
13117,Forsyth County,2021-01-17,269,7491,3.3
13117,Forsyth County,2021-01-18,626,8117,3.6
13117,Forsyth County,2021-01-19,1213,9330,4.1
13117,Forsyth County,2021-01-20,1233,10563,4.6
13117,Forsyth County,2021-01-21,790,11353,5
13117,Forsyth County,2021-01-22,574,11927,5.2
13117,Forsyth County,2021-01-23,364,12291,5.4
13117,Forsyth County,2021-01-24,156,12447,5.5
13117,Forsyth County,2021-01-25,483,12930,5.7
13117,Forsyth County,2021-01-26,1058,13988,6.1
13117,Forsyth County,2021-01-27,1231,15219,6.7
13117,Forsyth County,2021-01-28,859,16078,7
13117,Forsyth County,2021-01-29,681,16759,7.3
13117,Forsyth County,2021-01-30,363,17122,7.5
13117,Forsyth County,2021-01-31,32,17154,7.5
13117,Forsyth County,2021-02-01,519,17673,7.7
13117,Forsyth County,2021-02-02,603,18276,8
13117,Forsyth County,2021-02-03,444,18720,8.2
13117,Forsyth County,2021-02-04,1128,19848,8.7
13117,Forsyth County,2021-02-05,329,20177,8.8
13117,Forsyth County,2021-02-06,263,20440,8.9
13117,Forsyth County,2021-02-07,25,20465,9
13117,Forsyth County,2021-02-08,904,21369,9.4
13117,Forsyth County,2021-02-09,840,22209,9.7
13117,Forsyth County,2021-02-10,788,22997,10.1
13117,Forsyth County,2021-02-11,321,23318,10.2
13117,Forsyth County,2021-02-12,205,23523,10.3
13117,Forsyth County,2021-02-13,186,23709,10.4
13117,Forsyth County,2021-02-14,99,23808,10.4
13117,Forsyth County,2021-02-15,294,24102,10.6
13117,Forsyth County,2021-02-16,346,24448,10.7
13117,Forsyth County,2021-02-17,352,24800,10.9
13117,Forsyth County,2021-02-18,238,25038,11
13117,Forsyth County,2021-02-19,242,25280,11.1
13117,Forsyth County,2021-02-20,126,25406,11.1
13117,Forsyth County,2021-02-21,83,25489,11.2
13117,Forsyth County,2021-02-22,234,25723,11.3
13117,Forsyth County,2021-02-23,341,26064,11.4
13117,Forsyth County,2021-02-24,447,26511,11.6
13117,Forsyth County,2021-02-25,451,26962,11.8
13117,Forsyth County,2021-02-26,972,27934,12.2
13117,Forsyth County,2021-02-27,209,28143,12.3
13117,Forsyth County,2021-02-28,203,28346,12.4
13117,Forsyth County,2021-03-01,770,29116,12.7
13117,Forsyth County,2021-03-02,491,29607,13
13117,Forsyth County,2021-03-03,577,30184,13.2
13117,Forsyth County,2021-03-04,670,30854,13.5
13117,Forsyth County,2021-03-05,829,31683,13.9
13117,Forsyth County,2021-03-06,258,31941,14
13117,Forsyth County,2021-03-07,224,32165,14.1
13117,Forsyth County,2021-03-08,925,33090,14.5
13117,Forsyth County,2021-03-09,1082,34172,15
13117,Forsyth County,2021-03-10,1475,35647,15.6
13117,Forsyth County,2021-03-11,1103,36750,16.1
13117,Forsyth County,2021-03-12,1048,37798,16.6
13117,Forsyth County,2021-03-13,1851,39649,17.4
13117,Forsyth County,2021-03-14,276,39925,17.5
13117,Forsyth County,2021-03-15,1443,41368,18.1
13117,Forsyth County,2021-03-16,1980,43348,19
13117,Forsyth County,2021-03-17,2119,45467,19.9
13117,Forsyth County,2021-03-18,2177,47644,20.9
13117,Forsyth County,2021-03-19,1393,49037,21.5
13117,Forsyth County,2021-03-20,692,49729,21.8
13117,Forsyth County,2021-03-21,393,50122,21.9
13117,Forsyth County,2021-03-22,1672,51794,22.7
13117,Forsyth County,2021-03-23,2128,53922,23.6
13117,Forsyth County,2021-03-24,2490,56412,24.7
13117,Forsyth County,2021-03-25,2760,59172,25.9
13117,Forsyth County,2021-03-26,1889,61061,26.7
13117,Forsyth County,2021-03-27,1044,62105,27.2
13117,Forsyth County,2021-03-28,545,62650,27.4
13117,Forsyth County,2021-03-29,2108,64758,28.4
13117,Forsyth County,2021-03-30,2521,67279,29.5
13117,Forsyth County,2021-03-31,2628,69907,30.6
13117,Forsyth County,2021-04-01,3007,72914,31.9
13117,Forsyth County,2021-04-02,1819,74733,32.7
13117,Forsyth County,2021-04-03,766,75499,33.1
13117,Forsyth County,2021-04-04,373,75872,33.2
13117,Forsyth County,2021-04-05,1232,77104,33.8
13117,Forsyth County,2021-04-06,1541,78645,34.4
13117,Forsyth County,2021-04-07,1806,80451,35.2
13117,Forsyth County,2021-04-08,1666,82117,36
13117,Forsyth County,2021-04-09,1524,83641,36.6
13117,Forsyth County,2021-04-10,982,84623,37.1
13117,Forsyth County,2021-04-11,397,85020,37.2
13117,Forsyth County,2021-04-12,1215,86235,37.8
13117,Forsyth County,2021-04-13,883,87118,38.1
13117,Forsyth County,2021-04-14,1029,88147,38.6
13117,Forsyth County,2021-04-15,1059,89206,39.1
13117,Forsyth County,2021-04-16,814,90020,39.4
13117,Forsyth County,2021-04-17,282,90302,39.5
13117,Forsyth County,2021-04-18,177,90479,39.6
13117,Forsyth County,2021-04-19,861,91340,40
13117,Forsyth County,2021-04-20,1007,92347,40.4
13117,Forsyth County,2021-04-21,661,93008,40.7
13117,Forsyth County,2021-04-22,673,93681,41
13117,Forsyth County,2021-04-23,524,94205,41.2
13117,Forsyth County,2021-04-24,435,94640,41.4
13117,Forsyth County,2021-04-25,210,94850,41.5
13117,Forsyth County,2021-04-26,620,95470,41.8
13117,Forsyth County,2021-04-27,737,96207,42.1
13117,Forsyth County,2021-04-28,611,96818,42.4
13117,Forsyth County,2021-04-29,640,97458,42.7
13117,Forsyth County,2021-04-30,566,98024,42.9
13117,Forsyth County,2021-05-01,281,98305,43
13117,Forsyth County,2021-05-02,191,98496,43.1
13117,Forsyth County,2021-05-03,345,98841,43.3
13117,Forsyth County,2021-05-04,702,99543,43.6
13117,Forsyth County,2021-05-05,441,99984,43.8
13117,Forsyth County,2021-05-06,455,100439,44
13117,Forsyth County,2021-05-07,443,100882,44.2
13117,Forsyth County,2021-05-08,245,101127,44.3
13117,Forsyth County,2021-05-09,121,101248,44.3
13117,Forsyth County,2021-05-10,216,101464,44.4
13117,Forsyth County,2021-05-11,405,101869,44.6
13117,Forsyth County,2021-05-12,381,102250,44.8
13117,Forsyth County,2021-05-13,787,103037,45.1
13117,Forsyth County,2021-05-14,621,103658,45.4
13117,Forsyth County,2021-05-15,601,104259,45.7
13117,Forsyth County,2021-05-16,404,104663,45.8
13117,Forsyth County,2021-05-17,523,105186,46.1
13117,Forsyth County,2021-05-18,590,105776,46.3
13117,Forsyth County,2021-05-19,536,106312,46.5
13117,Forsyth County,2021-05-20,528,106840,46.8
13117,Forsyth County,2021-05-21,471,107311,47
13117,Forsyth County,2021-05-22,476,107787,47.2
13117,Forsyth County,2021-05-23,196,107983,47.3
13117,Forsyth County,2021-05-24,381,108364,47.4
13117,Forsyth County,2021-05-25,324,108688,47.6
13117,Forsyth County,2021-05-26,295,108983,47.7
13117,Forsyth County,2021-05-27,319,109302,47.9
13117,Forsyth County,2021-05-28,308,109610,48
13117,Forsyth County,2021-05-29,208,109818,48.1
13117,Forsyth County,2021-05-30,116,109934,48.1
13117,Forsyth County,2021-05-31,37,109971,48.2
13117,Forsyth County,2021-06-01,351,110322,48.3
13117,Forsyth County,2021-06-02,256,110578,48.4
13117,Forsyth County,2021-06-03,304,110882,48.6
13117,Forsyth County,2021-06-04,271,111153,48.7
13117,Forsyth County,2021-06-05,237,111390,48.8
13117,Forsyth County,2021-06-06,119,111509,48.8
13117,Forsyth County,2021-06-07,175,111684,48.9
13117,Forsyth County,2021-06-08,228,111912,49
13117,Forsyth County,2021-06-09,166,112078,49.1
13117,Forsyth County,2021-06-10,220,112298,49.2
13117,Forsyth County,2021-06-11,196,112494,49.3
13117,Forsyth County,2021-06-12,174,112668,49.3
13117,Forsyth County,2021-06-13,52,112720,49.4
13117,Forsyth County,2021-06-14,179,112899,49.4
13117,Forsyth County,2021-06-15,163,113062,49.5
13117,Forsyth County,2021-06-16,151,113213,49.6
13117,Forsyth County,2021-06-17,153,113366,49.6
13117,Forsyth County,2021-06-18,194,113560,49.7
13117,Forsyth County,2021-06-19,116,113676,49.8
13117,Forsyth County,2021-06-20,56,113732,49.8
13117,Forsyth County,2021-06-21,152,113884,49.9
13117,Forsyth County,2021-06-22,126,114010,49.9
13117,Forsyth County,2021-06-23,123,114133,50
13117,Forsyth County,2021-06-24,161,114294,50
13117,Forsyth County,2021-06-25,173,114467,50.1
13117,Forsyth County,2021-06-26,104,114571,50.2
13117,Forsyth County,2021-06-27,75,114646,50.2
13117,Forsyth County,2021-06-28,122,114768,50.3
13117,Forsyth County,2021-06-29,161,114929,50.3
13117,Forsyth County,2021-06-30,138,115067,50.4
13117,Forsyth County,2021-07-01,148,115215,50.4
13117,Forsyth County,2021-07-02,163,115378,50.5
13117,Forsyth County,2021-07-03,90,115468,50.6
13117,Forsyth County,2021-07-04,11,115479,50.6
13117,Forsyth County,2021-07-05,99,115578,50.6
13117,Forsyth County,2021-07-06,117,115695,50.7
13117,Forsyth County,2021-07-07,140,115835,50.7
13117,Forsyth County,2021-07-08,120,115955,50.8
13117,Forsyth County,2021-07-09,155,116110,50.8
13117,Forsyth County,2021-07-10,128,116238,50.9
13117,Forsyth County,2021-07-11,49,116287,50.9
13117,Forsyth County,2021-07-12,126,116413,51
13117,Forsyth County,2021-07-13,140,116553,51
13117,Forsyth County,2021-07-14,120,116673,51.1
13117,Forsyth County,2021-07-15,149,116822,51.2
13117,Forsyth County,2021-07-16,176,116998,51.2
13117,Forsyth County,2021-07-17,118,117116,51.3
13117,Forsyth County,2021-07-18,84,117200,51.3
13117,Forsyth County,2021-07-19,189,117389,51.4
13117,Forsyth County,2021-07-20,192,117581,51.5
13117,Forsyth County,2021-07-21,194,117775,51.6
13117,Forsyth County,2021-07-22,232,118007,51.7
13117,Forsyth County,2021-07-23,278,118285,51.8
13117,Forsyth County,2021-07-24,211,118496,51.9
13117,Forsyth County,2021-07-25,126,118622,51.9
13117,Forsyth County,2021-07-26,240,118862,52
13117,Forsyth County,2021-07-27,275,119137,52.2
13117,Forsyth County,2021-07-28,272,119409,52.3
13117,Forsyth County,2021-07-29,261,119670,52.4
13117,Forsyth County,2021-07-30,308,119978,52.5
13117,Forsyth County,2021-07-31,238,120216,52.6
13117,Forsyth County,2021-08-01,152,120368,52.7
13117,Forsyth County,2021-08-02,334,120702,52.9
13117,Forsyth County,2021-08-03,353,121055,53
13117,Forsyth County,2021-08-04,330,121385,53.1
13117,Forsyth County,2021-08-05,313,121698,53.3
13117,Forsyth County,2021-08-06,367,122065,53.4
13117,Forsyth County,2021-08-07,258,122323,53.6
13117,Forsyth County,2021-08-08,203,122526,53.6
13117,Forsyth County,2021-08-09,310,122836,53.8
13117,Forsyth County,2021-08-10,337,123173,53.9
13117,Forsyth County,2021-08-11,275,123448,54.1
13117,Forsyth County,2021-08-12,295,123743,54.2
13117,Forsyth County,2021-08-13,358,124101,54.3
13117,Forsyth County,2021-08-14,233,124334,54.4
13117,Forsyth County,2021-08-15,146,124480,54.5
13117,Forsyth County,2021-08-16,307,124787,54.6
13117,Forsyth County,2021-08-17,319,125106,54.8
13117,Forsyth County,2021-08-18,268,125374,54.9
13117,Forsyth County,2021-08-19,269,125643,55
13117,Forsyth County,2021-08-20,348,125991,55.2
13117,Forsyth County,2021-08-21,232,126223,55.3
13117,Forsyth County,2021-08-22,132,126355,55.3
13117,Forsyth County,2021-08-23,262,126617,55.4
13117,Forsyth County,2021-08-24,275,126892,55.6
13117,Forsyth County,2021-08-25,262,127154,55.7
13117,Forsyth County,2021-08-26,296,127450,55.8
13117,Forsyth County,2021-08-27,296,127746,55.9
13117,Forsyth County,2021-08-28,196,127942,56
13117,Forsyth County,2021-08-29,120,128062,56.1
13117,Forsyth County,2021-08-30,210,128272,56.2
13117,Forsyth County,2021-08-31,211,128483,56.3
13117,Forsyth County,2021-09-01,233,128716,56.4
13117,Forsyth County,2021-09-02,200,128916,56.4
13117,Forsyth County,2021-09-03,276,129192,56.6
13117,Forsyth County,2021-09-04,135,129327,56.6
13117,Forsyth County,2021-09-05,115,129442,56.7
13117,Forsyth County,2021-09-06,38,129480,56.7
13117,Forsyth County,2021-09-07,147,129627,56.8
13117,Forsyth County,2021-09-08,180,129807,56.8
13117,Forsyth County,2021-09-09,211,130018,56.9
13117,Forsyth County,2021-09-10,239,130257,57
13117,Forsyth County,2021-09-11,117,130374,57.1
13117,Forsyth County,2021-09-12,91,130465,57.1
13117,Forsyth County,2021-09-13,192,130657,57.2
13117,Forsyth County,2021-09-14,176,130833,57.3
13117,Forsyth County,2021-09-15,154,130987,57.4
13117,Forsyth County,2021-09-16,154,131141,57.4
13117,Forsyth County,2021-09-17,181,131322,57.5
13117,Forsyth County,2021-09-18,84,131406,57.5
13117,Forsyth County,2021-09-19,55,131461,57.6
13117,Forsyth County,2021-09-20,137,131598,57.6
13117,Forsyth County,2021-09-21,125,131723,57.7
13117,Forsyth County,2021-09-22,104,131827,57.7
13117,Forsyth County,2021-09-23,77,131904,57.8
13117,Forsyth County,2021-09-24,81,131985,57.8
13117,Forsyth County,2021-09-25,51,132036,57.8
13117,Forsyth County,2021-09-26,27,132063,57.8
13117,Forsyth County,2021-09-27,39,132102,57.8
13117,Forsyth County,2021-09-28,52,132154,57.9
13117,Forsyth County,2021-09-29,73,132227,57.9
13117,Forsyth County,2021-09-30,55,132282,57.9
13117,Forsyth County,2021-10-01,101,132383,58
13117,Forsyth County,2021-10-02,36,132419,58
13117,Forsyth County,2021-10-03,20,132439,58
13117,Forsyth County,2021-10-04,38,132477,58
13117,Forsyth County,2021-10-05,23,132500,58
13117,Forsyth County,2021-10-06,47,132547,58
13117,Forsyth County,2021-10-07,25,132572,58
13119,Franklin County,2020-12-18,4,4,0
13119,Franklin County,2020-12-19,1,5,0
13119,Franklin County,2020-12-21,5,10,0
13119,Franklin County,2020-12-22,21,31,0.1
13119,Franklin County,2020-12-23,19,50,0.2
13119,Franklin County,2020-12-27,2,52,0.2
13119,Franklin County,2020-12-28,23,75,0.3
13119,Franklin County,2020-12-29,80,155,0.7
13119,Franklin County,2020-12-30,55,210,0.9
13119,Franklin County,2020-12-31,3,213,0.9
13119,Franklin County,2021-01-01,4,217,1
13119,Franklin County,2021-01-02,2,219,1
13119,Franklin County,2021-01-03,4,223,1
13119,Franklin County,2021-01-04,26,249,1.1
13119,Franklin County,2021-01-05,35,284,1.2
13119,Franklin County,2021-01-06,27,311,1.4
13119,Franklin County,2021-01-07,19,330,1.4
13119,Franklin County,2021-01-08,30,360,1.6
13119,Franklin County,2021-01-09,2,362,1.6
13119,Franklin County,2021-01-10,10,372,1.6
13119,Franklin County,2021-01-11,61,433,1.9
13119,Franklin County,2021-01-12,108,541,2.4
13119,Franklin County,2021-01-13,127,668,2.9
13119,Franklin County,2021-01-14,100,768,3.4
13119,Franklin County,2021-01-15,95,863,3.8
13119,Franklin County,2021-01-16,8,871,3.8
13119,Franklin County,2021-01-17,2,873,3.8
13119,Franklin County,2021-01-18,120,993,4.4
13119,Franklin County,2021-01-19,120,1113,4.9
13119,Franklin County,2021-01-20,159,1272,5.6
13119,Franklin County,2021-01-21,110,1382,6.1
13119,Franklin County,2021-01-22,69,1451,6.4
13119,Franklin County,2021-01-23,14,1465,6.4
13119,Franklin County,2021-01-24,21,1486,6.5
13119,Franklin County,2021-01-25,82,1568,6.9
13119,Franklin County,2021-01-26,136,1704,7.5
13119,Franklin County,2021-01-27,75,1779,7.8
13119,Franklin County,2021-01-28,90,1869,8.2
13119,Franklin County,2021-01-29,44,1913,8.4
13119,Franklin County,2021-01-30,5,1918,8.4
13119,Franklin County,2021-01-31,9,1927,8.5
13119,Franklin County,2021-02-01,74,2001,8.8
13119,Franklin County,2021-02-02,77,2078,9.1
13119,Franklin County,2021-02-03,88,2166,9.5
13119,Franklin County,2021-02-04,57,2223,9.8
13119,Franklin County,2021-02-05,37,2260,9.9
13119,Franklin County,2021-02-06,4,2264,9.9
13119,Franklin County,2021-02-07,4,2268,10
13119,Franklin County,2021-02-08,47,2315,10.2
13119,Franklin County,2021-02-09,54,2369,10.4
13119,Franklin County,2021-02-10,37,2406,10.6
13119,Franklin County,2021-02-11,40,2446,10.7
13119,Franklin County,2021-02-12,18,2464,10.8
13119,Franklin County,2021-02-13,1,2465,10.8
13119,Franklin County,2021-02-14,4,2469,10.8
13119,Franklin County,2021-02-15,25,2494,11
13119,Franklin County,2021-02-16,18,2512,11
13119,Franklin County,2021-02-17,13,2525,11.1
13119,Franklin County,2021-02-18,20,2545,11.2
13119,Franklin County,2021-02-19,15,2560,11.2
13119,Franklin County,2021-02-20,5,2565,11.3
13119,Franklin County,2021-02-22,20,2585,11.4
13119,Franklin County,2021-02-23,25,2610,11.5
13119,Franklin County,2021-02-24,25,2635,11.6
13119,Franklin County,2021-02-25,39,2674,11.7
13119,Franklin County,2021-02-26,24,2698,11.9
13119,Franklin County,2021-02-27,6,2704,11.9
13119,Franklin County,2021-02-28,14,2718,11.9
13119,Franklin County,2021-03-01,33,2751,12.1
13119,Franklin County,2021-03-02,35,2786,12.2
13119,Franklin County,2021-03-03,70,2856,12.5
13119,Franklin County,2021-03-04,45,2901,12.7
13119,Franklin County,2021-03-05,69,2970,13
13119,Franklin County,2021-03-06,6,2976,13.1
13119,Franklin County,2021-03-07,11,2987,13.1
13119,Franklin County,2021-03-08,55,3042,13.4
13119,Franklin County,2021-03-09,80,3122,13.7
13119,Franklin County,2021-03-10,92,3214,14.1
13119,Franklin County,2021-03-11,99,3313,14.6
13119,Franklin County,2021-03-12,104,3417,15
13119,Franklin County,2021-03-13,33,3450,15.2
13119,Franklin County,2021-03-14,11,3461,15.2
13119,Franklin County,2021-03-15,91,3552,15.6
13119,Franklin County,2021-03-16,121,3673,16.1
13119,Franklin County,2021-03-17,128,3801,16.7
13119,Franklin County,2021-03-18,101,3902,17.1
13119,Franklin County,2021-03-19,109,4011,17.6
13119,Franklin County,2021-03-20,15,4026,17.7
13119,Franklin County,2021-03-21,13,4039,17.7
13119,Franklin County,2021-03-22,89,4128,18.1
13119,Franklin County,2021-03-23,85,4213,18.5
13119,Franklin County,2021-03-24,97,4310,18.9
13119,Franklin County,2021-03-25,104,4414,19.4
13119,Franklin County,2021-03-26,91,4505,19.8
13119,Franklin County,2021-03-27,15,4520,19.9
13119,Franklin County,2021-03-28,16,4536,19.9
13119,Franklin County,2021-03-29,59,4595,20.2
13119,Franklin County,2021-03-30,111,4706,20.7
13119,Franklin County,2021-03-31,92,4798,21.1
13119,Franklin County,2021-04-01,113,4911,21.6
13119,Franklin County,2021-04-02,49,4960,21.8
13119,Franklin County,2021-04-03,30,4990,21.9
13119,Franklin County,2021-04-04,22,5012,22
13119,Franklin County,2021-04-05,75,5087,22.3
13119,Franklin County,2021-04-06,141,5228,23
13119,Franklin County,2021-04-07,67,5295,23.3
13119,Franklin County,2021-04-08,87,5382,23.6
13119,Franklin County,2021-04-09,55,5437,23.9
13119,Franklin County,2021-04-10,19,5456,24
13119,Franklin County,2021-04-11,15,5471,24
13119,Franklin County,2021-04-12,46,5517,24.2
13119,Franklin County,2021-04-13,36,5553,24.4
13119,Franklin County,2021-04-14,46,5599,24.6
13119,Franklin County,2021-04-15,48,5647,24.8
13119,Franklin County,2021-04-16,60,5707,25.1
13119,Franklin County,2021-04-17,47,5754,25.3
13119,Franklin County,2021-04-18,4,5758,25.3
13119,Franklin County,2021-04-19,19,5777,25.4
13119,Franklin County,2021-04-20,32,5809,25.5
13119,Franklin County,2021-04-21,33,5842,25.7
13119,Franklin County,2021-04-22,32,5874,25.8
13119,Franklin County,2021-04-23,38,5912,26
13119,Franklin County,2021-04-24,9,5921,26
13119,Franklin County,2021-04-25,8,5929,26
13119,Franklin County,2021-04-26,20,5949,26.1
13119,Franklin County,2021-04-27,39,5988,26.3
13119,Franklin County,2021-04-28,39,6027,26.5
13119,Franklin County,2021-04-29,17,6044,26.5
13119,Franklin County,2021-04-30,41,6085,26.7
13119,Franklin County,2021-05-01,8,6093,26.8
13119,Franklin County,2021-05-02,5,6098,26.8
13119,Franklin County,2021-05-03,22,6120,26.9
13119,Franklin County,2021-05-04,33,6153,27
13119,Franklin County,2021-05-05,36,6189,27.2
13119,Franklin County,2021-05-06,27,6216,27.3
13119,Franklin County,2021-05-07,32,6248,27.4
13119,Franklin County,2021-05-08,7,6255,27.5
13119,Franklin County,2021-05-09,4,6259,27.5
13119,Franklin County,2021-05-10,14,6273,27.6
13119,Franklin County,2021-05-11,25,6298,27.7
13119,Franklin County,2021-05-12,12,6310,27.7
13119,Franklin County,2021-05-13,14,6324,27.8
13119,Franklin County,2021-05-14,16,6340,27.8
13119,Franklin County,2021-05-15,10,6350,27.9
13119,Franklin County,2021-05-16,1,6351,27.9
13119,Franklin County,2021-05-17,27,6378,28
13119,Franklin County,2021-05-18,41,6419,28.2
13119,Franklin County,2021-05-19,30,6449,28.3
13119,Franklin County,2021-05-20,19,6468,28.4
13119,Franklin County,2021-05-21,20,6488,28.5
13119,Franklin County,2021-05-22,10,6498,28.5
13119,Franklin County,2021-05-23,4,6502,28.6
13119,Franklin County,2021-05-24,18,6520,28.6
13119,Franklin County,2021-05-25,27,6547,28.8
13119,Franklin County,2021-05-26,17,6564,28.8
13119,Franklin County,2021-05-27,14,6578,28.9
13119,Franklin County,2021-05-28,23,6601,29
13119,Franklin County,2021-05-29,10,6611,29
13119,Franklin County,2021-05-30,3,6614,29.1
13119,Franklin County,2021-05-31,3,6617,29.1
13119,Franklin County,2021-06-01,12,6629,29.1
13119,Franklin County,2021-06-02,10,6639,29.2
13119,Franklin County,2021-06-03,16,6655,29.2
13119,Franklin County,2021-06-04,13,6668,29.3
13119,Franklin County,2021-06-05,6,6674,29.3
13119,Franklin County,2021-06-06,5,6679,29.3
13119,Franklin County,2021-06-07,8,6687,29.4
13119,Franklin County,2021-06-08,10,6697,29.4
13119,Franklin County,2021-06-09,6,6703,29.4
13119,Franklin County,2021-06-10,20,6723,29.5
13119,Franklin County,2021-06-11,13,6736,29.6
13119,Franklin County,2021-06-12,8,6744,29.6
13119,Franklin County,2021-06-13,1,6745,29.6
13119,Franklin County,2021-06-14,13,6758,29.7
13119,Franklin County,2021-06-15,17,6775,29.8
13119,Franklin County,2021-06-16,11,6786,29.8
13119,Franklin County,2021-06-17,5,6791,29.8
13119,Franklin County,2021-06-18,11,6802,29.9
13119,Franklin County,2021-06-19,2,6804,29.9
13119,Franklin County,2021-06-20,3,6807,29.9
13119,Franklin County,2021-06-21,13,6820,30
13119,Franklin County,2021-06-22,11,6831,30
13119,Franklin County,2021-06-23,12,6843,30.1
13119,Franklin County,2021-06-24,5,6848,30.1
13119,Franklin County,2021-06-25,11,6859,30.1
13119,Franklin County,2021-06-27,2,6861,30.1
13119,Franklin County,2021-06-28,7,6868,30.2
13119,Franklin County,2021-06-29,8,6876,30.2
13119,Franklin County,2021-06-30,10,6886,30.2
13119,Franklin County,2021-07-01,15,6901,30.3
13119,Franklin County,2021-07-02,10,6911,30.4
13119,Franklin County,2021-07-03,5,6916,30.4
13119,Franklin County,2021-07-05,5,6921,30.4
13119,Franklin County,2021-07-06,6,6927,30.4
13119,Franklin County,2021-07-07,9,6936,30.5
13119,Franklin County,2021-07-08,20,6956,30.6
13119,Franklin County,2021-07-09,7,6963,30.6
13119,Franklin County,2021-07-10,4,6967,30.6
13119,Franklin County,2021-07-11,3,6970,30.6
13119,Franklin County,2021-07-12,8,6978,30.7
13119,Franklin County,2021-07-13,17,6995,30.7
13119,Franklin County,2021-07-14,9,7004,30.8
13119,Franklin County,2021-07-15,7,7011,30.8
13119,Franklin County,2021-07-16,14,7025,30.9
13119,Franklin County,2021-07-17,8,7033,30.9
13119,Franklin County,2021-07-18,7,7040,30.9
13119,Franklin County,2021-07-19,15,7055,31
13119,Franklin County,2021-07-20,16,7071,31.1
13119,Franklin County,2021-07-21,9,7080,31.1
13119,Franklin County,2021-07-22,32,7112,31.2
13119,Franklin County,2021-07-23,12,7124,31.3
13119,Franklin County,2021-07-24,16,7140,31.4
13119,Franklin County,2021-07-25,8,7148,31.4
13119,Franklin County,2021-07-26,23,7171,31.5
13119,Franklin County,2021-07-27,25,7196,31.6
13119,Franklin County,2021-07-28,26,7222,31.7
13119,Franklin County,2021-07-29,35,7257,31.9
13119,Franklin County,2021-07-30,28,7285,32
13119,Franklin County,2021-07-31,14,7299,32.1
13119,Franklin County,2021-08-01,9,7308,32.1
13119,Franklin County,2021-08-02,22,7330,32.2
13119,Franklin County,2021-08-03,21,7351,32.3
13119,Franklin County,2021-08-04,44,7395,32.5
13119,Franklin County,2021-08-05,40,7435,32.7
13119,Franklin County,2021-08-06,33,7468,32.8
13119,Franklin County,2021-08-07,17,7485,32.9
13119,Franklin County,2021-08-08,14,7499,32.9
13119,Franklin County,2021-08-09,29,7528,33.1
13119,Franklin County,2021-08-10,45,7573,33.3
13119,Franklin County,2021-08-11,38,7611,33.4
13119,Franklin County,2021-08-12,60,7671,33.7
13119,Franklin County,2021-08-13,46,7717,33.9
13119,Franklin County,2021-08-14,20,7737,34
13119,Franklin County,2021-08-15,19,7756,34.1
13119,Franklin County,2021-08-16,32,7788,34.2
13119,Franklin County,2021-08-17,32,7820,34.3
13119,Franklin County,2021-08-18,28,7848,34.5
13119,Franklin County,2021-08-19,37,7885,34.6
13119,Franklin County,2021-08-20,53,7938,34.9
13119,Franklin County,2021-08-21,35,7973,35
13119,Franklin County,2021-08-22,13,7986,35.1
13119,Franklin County,2021-08-23,50,8036,35.3
13119,Franklin County,2021-08-24,70,8106,35.6
13119,Franklin County,2021-08-25,44,8150,35.8
13119,Franklin County,2021-08-26,59,8209,36.1
13119,Franklin County,2021-08-27,45,8254,36.3
13119,Franklin County,2021-08-28,27,8281,36.4
13119,Franklin County,2021-08-29,7,8288,36.4
13119,Franklin County,2021-08-30,30,8318,36.5
13119,Franklin County,2021-08-31,37,8355,36.7
13119,Franklin County,2021-09-01,37,8392,36.9
13119,Franklin County,2021-09-02,37,8429,37
13119,Franklin County,2021-09-03,38,8467,37.2
13119,Franklin County,2021-09-04,17,8484,37.3
13119,Franklin County,2021-09-05,16,8500,37.3
13119,Franklin County,2021-09-06,2,8502,37.3
13119,Franklin County,2021-09-07,31,8533,37.5
13119,Franklin County,2021-09-08,24,8557,37.6
13119,Franklin County,2021-09-09,29,8586,37.7
13119,Franklin County,2021-09-10,34,8620,37.9
13119,Franklin County,2021-09-11,9,8629,37.9
13119,Franklin County,2021-09-12,8,8637,37.9
13119,Franklin County,2021-09-13,37,8674,38.1
13119,Franklin County,2021-09-14,32,8706,38.2
13119,Franklin County,2021-09-15,22,8728,38.3
13119,Franklin County,2021-09-16,25,8753,38.4
13119,Franklin County,2021-09-17,31,8784,38.6
13119,Franklin County,2021-09-18,12,8796,38.6
13119,Franklin County,2021-09-19,13,8809,38.7
13119,Franklin County,2021-09-20,17,8826,38.8
13119,Franklin County,2021-09-21,11,8837,38.8
13119,Franklin County,2021-09-22,19,8856,38.9
13119,Franklin County,2021-09-23,38,8894,39.1
13119,Franklin County,2021-09-24,13,8907,39.1
13119,Franklin County,2021-09-25,7,8914,39.2
13119,Franklin County,2021-09-26,1,8915,39.2
13119,Franklin County,2021-09-27,13,8928,39.2
13119,Franklin County,2021-09-28,3,8931,39.2
13119,Franklin County,2021-09-29,15,8946,39.3
13119,Franklin County,2021-09-30,9,8955,39.3
13119,Franklin County,2021-10-01,10,8965,39.4
13119,Franklin County,2021-10-02,4,8969,39.4
13119,Franklin County,2021-10-03,1,8970,39.4
13119,Franklin County,2021-10-04,8,8978,39.4
13119,Franklin County,2021-10-05,5,8983,39.5
13119,Franklin County,2021-10-06,8,8991,39.5
13119,Franklin County,2021-10-07,5,8996,39.5
13121,Fulton County,2020-12-13,2,2,0
13121,Fulton County,2020-12-14,3,5,0
13121,Fulton County,2020-12-15,6,11,0
13121,Fulton County,2020-12-16,25,36,0
13121,Fulton County,2020-12-17,306,342,0
13121,Fulton County,2020-12-18,630,972,0.1
13121,Fulton County,2020-12-19,975,1947,0.2
13121,Fulton County,2020-12-20,868,2815,0.3
13121,Fulton County,2020-12-21,852,3667,0.4
13121,Fulton County,2020-12-22,1145,4812,0.5
13121,Fulton County,2020-12-23,1463,6275,0.6
13121,Fulton County,2020-12-24,406,6681,0.6
13121,Fulton County,2020-12-25,25,6706,0.6
13121,Fulton County,2020-12-26,247,6953,0.7
13121,Fulton County,2020-12-27,220,7173,0.7
13121,Fulton County,2020-12-28,1545,8718,0.8
13121,Fulton County,2020-12-29,1594,10312,1
13121,Fulton County,2020-12-30,1461,11773,1.1
13121,Fulton County,2020-12-31,761,12534,1.2
13121,Fulton County,2021-01-01,502,13036,1.3
13121,Fulton County,2021-01-02,234,13270,1.3
13121,Fulton County,2021-01-03,342,13612,1.3
13121,Fulton County,2021-01-04,1472,15084,1.5
13121,Fulton County,2021-01-05,1481,16565,1.6
13121,Fulton County,2021-01-06,1480,18045,1.7
13121,Fulton County,2021-01-07,1444,19489,1.9
13121,Fulton County,2021-01-08,1988,21477,2.1
13121,Fulton County,2021-01-09,1157,22634,2.2
13121,Fulton County,2021-01-10,497,23131,2.2
13121,Fulton County,2021-01-11,2538,25669,2.5
13121,Fulton County,2021-01-12,2916,28585,2.8
13121,Fulton County,2021-01-13,3730,32315,3.1
13121,Fulton County,2021-01-14,3750,36065,3.5
13121,Fulton County,2021-01-15,3766,39831,3.8
13121,Fulton County,2021-01-16,2999,42830,4.1
13121,Fulton County,2021-01-17,1344,44174,4.3
13121,Fulton County,2021-01-18,2661,46835,4.5
13121,Fulton County,2021-01-19,3820,50655,4.9
13121,Fulton County,2021-01-20,4120,54775,5.3
13121,Fulton County,2021-01-21,3785,58560,5.7
13121,Fulton County,2021-01-22,3038,61598,5.9
13121,Fulton County,2021-01-23,1349,62947,6.1
13121,Fulton County,2021-01-24,609,63556,6.1
13121,Fulton County,2021-01-25,2157,65713,6.3
13121,Fulton County,2021-01-26,2078,67791,6.5
13121,Fulton County,2021-01-27,2670,70461,6.8
13121,Fulton County,2021-01-28,3494,73955,7.1
13121,Fulton County,2021-01-29,3682,77637,7.5
13121,Fulton County,2021-01-30,1181,78818,7.6
13121,Fulton County,2021-01-31,543,79361,7.7
13121,Fulton County,2021-02-01,1854,81215,7.8
13121,Fulton County,2021-02-02,1987,83202,8
13121,Fulton County,2021-02-03,1774,84976,8.2
13121,Fulton County,2021-02-04,2601,87577,8.5
13121,Fulton County,2021-02-05,2203,89780,8.7
13121,Fulton County,2021-02-06,740,90520,8.7
13121,Fulton County,2021-02-07,413,90933,8.8
13121,Fulton County,2021-02-08,2137,93070,9
13121,Fulton County,2021-02-09,2176,95246,9.2
13121,Fulton County,2021-02-10,2033,97279,9.4
13121,Fulton County,2021-02-11,2380,99659,9.6
13121,Fulton County,2021-02-12,1747,101406,9.8
13121,Fulton County,2021-02-13,879,102285,9.9
13121,Fulton County,2021-02-14,506,102791,9.9
13121,Fulton County,2021-02-15,1384,104175,10.1
13121,Fulton County,2021-02-16,2194,106369,10.3
13121,Fulton County,2021-02-17,2557,108926,10.5
13121,Fulton County,2021-02-18,2211,111137,10.7
13121,Fulton County,2021-02-19,2364,113501,11
13121,Fulton County,2021-02-20,609,114110,11
13121,Fulton County,2021-02-21,289,114399,11
13121,Fulton County,2021-02-22,1140,115539,11.2
13121,Fulton County,2021-02-23,2449,117988,11.4
13121,Fulton County,2021-02-24,2969,120957,11.7
13121,Fulton County,2021-02-25,2963,123920,12
13121,Fulton County,2021-02-26,2575,126495,12.2
13121,Fulton County,2021-02-27,1331,127826,12.3
13121,Fulton County,2021-02-28,710,128536,12.4
13121,Fulton County,2021-03-01,2537,131073,12.6
13121,Fulton County,2021-03-02,2896,133969,12.9
13121,Fulton County,2021-03-03,3412,137381,13.3
13121,Fulton County,2021-03-04,3675,141056,13.6
13121,Fulton County,2021-03-05,3777,144833,14
13121,Fulton County,2021-03-06,1933,146766,14.2
13121,Fulton County,2021-03-07,958,147724,14.3
13121,Fulton County,2021-03-08,4816,152540,14.7
13121,Fulton County,2021-03-09,5294,157834,15.2
13121,Fulton County,2021-03-10,6152,163986,15.8
13121,Fulton County,2021-03-11,6288,170274,16.4
13121,Fulton County,2021-03-12,5944,176218,17
13121,Fulton County,2021-03-13,2961,179179,17.3
13121,Fulton County,2021-03-14,1742,180921,17.5
13121,Fulton County,2021-03-15,6056,186977,18
13121,Fulton County,2021-03-16,8542,195519,18.9
13121,Fulton County,2021-03-17,8324,203843,19.7
13121,Fulton County,2021-03-18,8331,212174,20.5
13121,Fulton County,2021-03-19,8159,220333,21.3
13121,Fulton County,2021-03-20,3548,223881,21.6
13121,Fulton County,2021-03-21,1985,225866,21.8
13121,Fulton County,2021-03-22,8350,234216,22.6
13121,Fulton County,2021-03-23,9000,243216,23.5
13121,Fulton County,2021-03-24,10111,253327,24.4
13121,Fulton County,2021-03-25,12020,265347,25.6
13121,Fulton County,2021-03-26,10384,275731,26.6
13121,Fulton County,2021-03-27,5206,280937,27.1
13121,Fulton County,2021-03-28,2469,283406,27.4
13121,Fulton County,2021-03-29,8671,292077,28.2
13121,Fulton County,2021-03-30,12755,304832,29.4
13121,Fulton County,2021-03-31,12535,317367,30.6
13121,Fulton County,2021-04-01,10729,328096,31.7
13121,Fulton County,2021-04-02,7579,335675,32.4
13121,Fulton County,2021-04-03,3665,339340,32.7
13121,Fulton County,2021-04-04,1413,340753,32.9
13121,Fulton County,2021-04-05,6356,347109,33.5
13121,Fulton County,2021-04-06,9508,356617,34.4
13121,Fulton County,2021-04-07,9731,366348,35.4
13121,Fulton County,2021-04-08,8570,374918,36.2
13121,Fulton County,2021-04-09,8690,383608,37
13121,Fulton County,2021-04-10,6433,390041,37.6
13121,Fulton County,2021-04-11,1545,391586,37.8
13121,Fulton County,2021-04-12,4784,396370,38.3
13121,Fulton County,2021-04-13,5542,401912,38.8
13121,Fulton County,2021-04-14,4641,406553,39.2
13121,Fulton County,2021-04-15,3954,410507,39.6
13121,Fulton County,2021-04-16,3471,413978,40
13121,Fulton County,2021-04-17,1710,415688,40.1
13121,Fulton County,2021-04-18,1691,417379,40.3
13121,Fulton County,2021-04-19,3239,420618,40.6
13121,Fulton County,2021-04-20,4032,424650,41
13121,Fulton County,2021-04-21,3537,428187,41.3
13121,Fulton County,2021-04-22,3223,431410,41.6
13121,Fulton County,2021-04-23,3060,434470,41.9
13121,Fulton County,2021-04-24,1782,436252,42.1
13121,Fulton County,2021-04-25,807,437059,42.2
13121,Fulton County,2021-04-26,2540,439599,42.4
13121,Fulton County,2021-04-27,2829,442428,42.7
13121,Fulton County,2021-04-28,3087,445515,43
13121,Fulton County,2021-04-29,2703,448218,43.3
13121,Fulton County,2021-04-30,2894,451112,43.5
13121,Fulton County,2021-05-01,2060,453172,43.7
13121,Fulton County,2021-05-02,740,453912,43.8
13121,Fulton County,2021-05-03,1665,455577,44
13121,Fulton County,2021-05-04,2304,457881,44.2
13121,Fulton County,2021-05-05,2189,460070,44.4
13121,Fulton County,2021-05-06,1968,462038,44.6
13121,Fulton County,2021-05-07,2219,464257,44.8
13121,Fulton County,2021-05-08,1479,465736,44.9
13121,Fulton County,2021-05-09,503,466239,45
13121,Fulton County,2021-05-10,1228,467467,45.1
13121,Fulton County,2021-05-11,2298,469765,45.3
13121,Fulton County,2021-05-12,2709,472474,45.6
13121,Fulton County,2021-05-13,2594,475068,45.8
13121,Fulton County,2021-05-14,3030,478098,46.1
13121,Fulton County,2021-05-15,3069,481167,46.4
13121,Fulton County,2021-05-16,1436,482603,46.6
13121,Fulton County,2021-05-17,2555,485158,46.8
13121,Fulton County,2021-05-18,2893,488051,47.1
13121,Fulton County,2021-05-19,2640,490691,47.4
13121,Fulton County,2021-05-20,2205,492896,47.6
13121,Fulton County,2021-05-21,2171,495067,47.8
13121,Fulton County,2021-05-22,2120,497187,48
13121,Fulton County,2021-05-23,793,497980,48.1
13121,Fulton County,2021-05-24,1573,499553,48.2
13121,Fulton County,2021-05-25,1722,501275,48.4
13121,Fulton County,2021-05-26,1584,502859,48.5
13121,Fulton County,2021-05-27,1686,504545,48.7
13121,Fulton County,2021-05-28,1463,506008,48.8
13121,Fulton County,2021-05-29,888,506896,48.9
13121,Fulton County,2021-05-30,545,507441,49
13121,Fulton County,2021-05-31,131,507572,49
13121,Fulton County,2021-06-01,1524,509096,49.1
13121,Fulton County,2021-06-02,1405,510501,49.3
13121,Fulton County,2021-06-03,1318,511819,49.4
13121,Fulton County,2021-06-04,1291,513110,49.5
13121,Fulton County,2021-06-05,1102,514212,49.6
13121,Fulton County,2021-06-06,562,514774,49.7
13121,Fulton County,2021-06-07,1169,515943,49.8
13121,Fulton County,2021-06-08,1167,517110,49.9
13121,Fulton County,2021-06-09,946,518056,50
13121,Fulton County,2021-06-10,1126,519182,50.1
13121,Fulton County,2021-06-11,976,520158,50.2
13121,Fulton County,2021-06-12,663,520821,50.3
13121,Fulton County,2021-06-13,218,521039,50.3
13121,Fulton County,2021-06-14,825,521864,50.4
13121,Fulton County,2021-06-15,908,522772,50.5
13121,Fulton County,2021-06-16,776,523548,50.5
13121,Fulton County,2021-06-17,793,524341,50.6
13121,Fulton County,2021-06-18,886,525227,50.7
13121,Fulton County,2021-06-19,638,525865,50.7
13121,Fulton County,2021-06-20,296,526161,50.8
13121,Fulton County,2021-06-21,699,526860,50.8
13121,Fulton County,2021-06-22,866,527726,50.9
13121,Fulton County,2021-06-23,837,528563,51
13121,Fulton County,2021-06-24,746,529309,51.1
13121,Fulton County,2021-06-25,855,530164,51.2
13121,Fulton County,2021-06-26,691,530855,51.2
13121,Fulton County,2021-06-27,354,531209,51.3
13121,Fulton County,2021-06-28,676,531885,51.3
13121,Fulton County,2021-06-29,769,532654,51.4
13121,Fulton County,2021-06-30,797,533451,51.5
13121,Fulton County,2021-07-01,763,534214,51.6
13121,Fulton County,2021-07-02,771,534985,51.6
13121,Fulton County,2021-07-03,427,535412,51.7
13121,Fulton County,2021-07-04,30,535442,51.7
13121,Fulton County,2021-07-05,571,536013,51.7
13121,Fulton County,2021-07-06,670,536683,51.8
13121,Fulton County,2021-07-07,643,537326,51.9
13121,Fulton County,2021-07-08,742,538068,51.9
13121,Fulton County,2021-07-09,794,538862,52
13121,Fulton County,2021-07-10,576,539438,52.1
13121,Fulton County,2021-07-11,336,539774,52.1
13121,Fulton County,2021-07-12,672,540446,52.2
13121,Fulton County,2021-07-13,771,541217,52.2
13121,Fulton County,2021-07-14,721,541938,52.3
13121,Fulton County,2021-07-15,813,542751,52.4
13121,Fulton County,2021-07-16,864,543615,52.5
13121,Fulton County,2021-07-17,675,544290,52.5
13121,Fulton County,2021-07-18,430,544720,52.6
13121,Fulton County,2021-07-19,913,545633,52.7
13121,Fulton County,2021-07-20,1017,546650,52.8
13121,Fulton County,2021-07-21,1055,547705,52.9
13121,Fulton County,2021-07-22,1209,548914,53
13121,Fulton County,2021-07-23,1270,550184,53.1
13121,Fulton County,2021-07-24,1053,551237,53.2
13121,Fulton County,2021-07-25,672,551909,53.3
13121,Fulton County,2021-07-26,1276,553185,53.4
13121,Fulton County,2021-07-27,1368,554553,53.5
13121,Fulton County,2021-07-28,1332,555885,53.6
13121,Fulton County,2021-07-29,1478,557363,53.8
13121,Fulton County,2021-07-30,1509,558872,53.9
13121,Fulton County,2021-07-31,1219,560091,54.1
13121,Fulton County,2021-08-01,754,560845,54.1
13121,Fulton County,2021-08-02,1528,562373,54.3
13121,Fulton County,2021-08-03,1593,563966,54.4
13121,Fulton County,2021-08-04,1649,565615,54.6
13121,Fulton County,2021-08-05,1543,567158,54.7
13121,Fulton County,2021-08-06,1705,568863,54.9
13121,Fulton County,2021-08-07,1225,570088,55
13121,Fulton County,2021-08-08,742,570830,55.1
13121,Fulton County,2021-08-09,1415,572245,55.2
13121,Fulton County,2021-08-10,1657,573902,55.4
13121,Fulton County,2021-08-11,1448,575350,55.5
13121,Fulton County,2021-08-12,1556,576906,55.7
13121,Fulton County,2021-08-13,1512,578418,55.8
13121,Fulton County,2021-08-14,1253,579671,55.9
13121,Fulton County,2021-08-15,606,580277,56
13121,Fulton County,2021-08-16,1208,581485,56.1
13121,Fulton County,2021-08-17,1309,582794,56.2
13121,Fulton County,2021-08-18,1255,584049,56.4
13121,Fulton County,2021-08-19,1286,585335,56.5
13121,Fulton County,2021-08-20,1291,586626,56.6
13121,Fulton County,2021-08-21,931,587557,56.7
13121,Fulton County,2021-08-22,546,588103,56.8
13121,Fulton County,2021-08-23,1076,589179,56.9
13121,Fulton County,2021-08-24,1207,590386,57
13121,Fulton County,2021-08-25,1116,591502,57.1
13121,Fulton County,2021-08-26,1271,592773,57.2
13121,Fulton County,2021-08-27,1200,593973,57.3
13121,Fulton County,2021-08-28,1192,595165,57.4
13121,Fulton County,2021-08-29,567,595732,57.5
13121,Fulton County,2021-08-30,1004,596736,57.6
13121,Fulton County,2021-08-31,1060,597796,57.7
13121,Fulton County,2021-09-01,1091,598887,57.8
13121,Fulton County,2021-09-02,1104,599991,57.9
13121,Fulton County,2021-09-03,1214,601205,58
13121,Fulton County,2021-09-04,689,601894,58.1
13121,Fulton County,2021-09-05,555,602449,58.1
13121,Fulton County,2021-09-06,140,602589,58.2
13121,Fulton County,2021-09-07,941,603530,58.2
13121,Fulton County,2021-09-08,998,604528,58.3
13121,Fulton County,2021-09-09,1113,605641,58.4
13121,Fulton County,2021-09-10,1121,606762,58.6
13121,Fulton County,2021-09-11,731,607493,58.6
13121,Fulton County,2021-09-12,494,607987,58.7
13121,Fulton County,2021-09-13,938,608925,58.8
13121,Fulton County,2021-09-14,887,609812,58.9
13121,Fulton County,2021-09-15,777,610589,58.9
13121,Fulton County,2021-09-16,751,611340,59
13121,Fulton County,2021-09-17,836,612176,59.1
13121,Fulton County,2021-09-18,628,612804,59.1
13121,Fulton County,2021-09-19,346,613150,59.2
13121,Fulton County,2021-09-20,678,613828,59.2
13121,Fulton County,2021-09-21,634,614462,59.3
13121,Fulton County,2021-09-22,606,615068,59.4
13121,Fulton County,2021-09-23,504,615572,59.4
13121,Fulton County,2021-09-24,471,616043,59.5
13121,Fulton County,2021-09-25,415,616458,59.5
13121,Fulton County,2021-09-26,217,616675,59.5
13121,Fulton County,2021-09-27,350,617025,59.5
13121,Fulton County,2021-09-28,394,617419,59.6
13121,Fulton County,2021-09-29,341,617760,59.6
13121,Fulton County,2021-09-30,347,618107,59.7
13121,Fulton County,2021-10-01,424,618531,59.7
13121,Fulton County,2021-10-02,274,618805,59.7
13121,Fulton County,2021-10-03,125,618930,59.7
13121,Fulton County,2021-10-04,167,619097,59.7
13121,Fulton County,2021-10-05,171,619268,59.8
13121,Fulton County,2021-10-06,256,619524,59.8
13121,Fulton County,2021-10-07,140,619664,59.8
13123,Gilmer County,2020-12-17,2,2,0
13123,Gilmer County,2020-12-18,13,15,0
13123,Gilmer County,2020-12-19,1,16,0.1
13123,Gilmer County,2020-12-20,5,21,0.1
13123,Gilmer County,2020-12-21,6,27,0.1
13123,Gilmer County,2020-12-22,30,57,0.2
13123,Gilmer County,2020-12-23,37,94,0.3
13123,Gilmer County,2020-12-24,8,102,0.3
13123,Gilmer County,2020-12-26,1,103,0.3
13123,Gilmer County,2020-12-27,1,104,0.3
13123,Gilmer County,2020-12-28,64,168,0.6
13123,Gilmer County,2020-12-29,45,213,0.7
13123,Gilmer County,2020-12-30,45,258,0.8
13123,Gilmer County,2020-12-31,20,278,0.9
13123,Gilmer County,2021-01-01,7,285,0.9
13123,Gilmer County,2021-01-02,1,286,0.9
13123,Gilmer County,2021-01-03,3,289,1
13123,Gilmer County,2021-01-04,37,326,1.1
13123,Gilmer County,2021-01-05,76,402,1.3
13123,Gilmer County,2021-01-06,68,470,1.5
13123,Gilmer County,2021-01-07,113,583,1.9
13123,Gilmer County,2021-01-08,50,633,2.1
13123,Gilmer County,2021-01-09,4,637,2.1
13123,Gilmer County,2021-01-10,2,639,2.1
13123,Gilmer County,2021-01-11,216,855,2.8
13123,Gilmer County,2021-01-12,362,1217,4
13123,Gilmer County,2021-01-13,274,1491,4.9
13123,Gilmer County,2021-01-14,319,1810,6
13123,Gilmer County,2021-01-15,248,2058,6.8
13123,Gilmer County,2021-01-16,63,2121,7
13123,Gilmer County,2021-01-17,23,2144,7
13123,Gilmer County,2021-01-18,283,2427,8
13123,Gilmer County,2021-01-19,346,2773,9.1
13123,Gilmer County,2021-01-20,318,3091,10.2
13123,Gilmer County,2021-01-21,203,3294,10.8
13123,Gilmer County,2021-01-22,73,3367,11.1
13123,Gilmer County,2021-01-23,10,3377,11.1
13123,Gilmer County,2021-01-24,11,3388,11.1
13123,Gilmer County,2021-01-25,87,3475,11.4
13123,Gilmer County,2021-01-26,67,3542,11.6
13123,Gilmer County,2021-01-27,72,3614,11.9
13123,Gilmer County,2021-01-28,65,3679,12.1
13123,Gilmer County,2021-01-29,35,3714,12.2
13123,Gilmer County,2021-01-30,12,3726,12.3
13123,Gilmer County,2021-02-01,38,3764,12.4
13123,Gilmer County,2021-02-02,57,3821,12.6
13123,Gilmer County,2021-02-03,59,3880,12.8
13123,Gilmer County,2021-02-04,57,3937,12.9
13123,Gilmer County,2021-02-05,50,3987,13.1
13123,Gilmer County,2021-02-06,4,3991,13.1
13123,Gilmer County,2021-02-08,17,4008,13.2
13123,Gilmer County,2021-02-09,54,4062,13.4
13123,Gilmer County,2021-02-10,35,4097,13.5
13123,Gilmer County,2021-02-11,34,4131,13.6
13123,Gilmer County,2021-02-12,45,4176,13.7
13123,Gilmer County,2021-02-13,7,4183,13.8
13123,Gilmer County,2021-02-14,3,4186,13.8
13123,Gilmer County,2021-02-15,32,4218,13.9
13123,Gilmer County,2021-02-16,52,4270,14
13123,Gilmer County,2021-02-17,122,4392,14.4
13123,Gilmer County,2021-02-18,177,4569,15
13123,Gilmer County,2021-02-19,39,4608,15.2
13123,Gilmer County,2021-02-20,7,4615,15.2
13123,Gilmer County,2021-02-21,11,4626,15.2
13123,Gilmer County,2021-02-22,20,4646,15.3
13123,Gilmer County,2021-02-23,52,4698,15.4
13123,Gilmer County,2021-02-24,78,4776,15.7
13123,Gilmer County,2021-02-25,105,4881,16
13123,Gilmer County,2021-02-26,60,4941,16.2
13123,Gilmer County,2021-02-27,16,4957,16.3
13123,Gilmer County,2021-02-28,37,4994,16.4
13123,Gilmer County,2021-03-01,127,5121,16.8
13123,Gilmer County,2021-03-02,142,5263,17.3
13123,Gilmer County,2021-03-03,116,5379,17.7
13123,Gilmer County,2021-03-04,99,5478,18
13123,Gilmer County,2021-03-05,37,5515,18.1
13123,Gilmer County,2021-03-06,7,5522,18.2
13123,Gilmer County,2021-03-07,27,5549,18.2
13123,Gilmer County,2021-03-08,124,5673,18.7
13123,Gilmer County,2021-03-09,197,5870,19.3
13123,Gilmer County,2021-03-10,104,5974,19.6
13123,Gilmer County,2021-03-11,93,6067,19.9
13123,Gilmer County,2021-03-12,159,6226,20.5
13123,Gilmer County,2021-03-13,25,6251,20.6
13123,Gilmer County,2021-03-14,38,6289,20.7
13123,Gilmer County,2021-03-15,287,6576,21.6
13123,Gilmer County,2021-03-16,280,6856,22.5
13123,Gilmer County,2021-03-17,166,7022,23.1
13123,Gilmer County,2021-03-18,122,7144,23.5
13123,Gilmer County,2021-03-19,175,7319,24.1
13123,Gilmer County,2021-03-20,18,7337,24.1
13123,Gilmer County,2021-03-21,21,7358,24.2
13123,Gilmer County,2021-03-22,147,7505,24.7
13123,Gilmer County,2021-03-23,182,7687,25.3
13123,Gilmer County,2021-03-24,149,7836,25.8
13123,Gilmer County,2021-03-25,160,7996,26.3
13123,Gilmer County,2021-03-26,124,8120,26.7
13123,Gilmer County,2021-03-27,7,8127,26.7
13123,Gilmer County,2021-03-28,13,8140,26.8
13123,Gilmer County,2021-03-29,145,8285,27.2
13123,Gilmer County,2021-03-30,162,8447,27.8
13123,Gilmer County,2021-03-31,122,8569,28.2
13123,Gilmer County,2021-04-01,140,8709,28.6
13123,Gilmer County,2021-04-02,105,8814,29
13123,Gilmer County,2021-04-03,29,8843,29.1
13123,Gilmer County,2021-04-04,16,8859,29.1
13123,Gilmer County,2021-04-05,80,8939,29.4
13123,Gilmer County,2021-04-06,90,9029,29.7
13123,Gilmer County,2021-04-07,57,9086,29.9
13123,Gilmer County,2021-04-08,93,9179,30.2
13123,Gilmer County,2021-04-09,106,9285,30.5
13123,Gilmer County,2021-04-10,32,9317,30.6
13123,Gilmer County,2021-04-11,22,9339,30.7
13123,Gilmer County,2021-04-12,73,9412,30.9
13123,Gilmer County,2021-04-13,88,9500,31.2
13123,Gilmer County,2021-04-14,39,9539,31.4
13123,Gilmer County,2021-04-15,80,9619,31.6
13123,Gilmer County,2021-04-16,54,9673,31.8
13123,Gilmer County,2021-04-17,11,9684,31.8
13123,Gilmer County,2021-04-18,6,9690,31.9
13123,Gilmer County,2021-04-19,46,9736,32
13123,Gilmer County,2021-04-20,67,9803,32.2
13123,Gilmer County,2021-04-21,37,9840,32.4
13123,Gilmer County,2021-04-22,58,9898,32.5
13123,Gilmer County,2021-04-23,29,9927,32.6
13123,Gilmer County,2021-04-24,13,9940,32.7
13123,Gilmer County,2021-04-25,13,9953,32.7
13123,Gilmer County,2021-04-26,23,9976,32.8
13123,Gilmer County,2021-04-27,34,10010,32.9
13123,Gilmer County,2021-04-28,51,10061,33.1
13123,Gilmer County,2021-04-29,64,10125,33.3
13123,Gilmer County,2021-04-30,28,10153,33.4
13123,Gilmer County,2021-05-01,11,10164,33.4
13123,Gilmer County,2021-05-02,6,10170,33.4
13123,Gilmer County,2021-05-03,25,10195,33.5
13123,Gilmer County,2021-05-04,37,10232,33.6
13123,Gilmer County,2021-05-05,41,10273,33.8
13123,Gilmer County,2021-05-06,45,10318,33.9
13123,Gilmer County,2021-05-07,105,10423,34.3
13123,Gilmer County,2021-05-08,10,10433,34.3
13123,Gilmer County,2021-05-09,1,10434,34.3
13123,Gilmer County,2021-05-10,26,10460,34.4
13123,Gilmer County,2021-05-11,50,10510,34.6
13123,Gilmer County,2021-05-12,34,10544,34.7
13123,Gilmer County,2021-05-13,36,10580,34.8
13123,Gilmer County,2021-05-14,35,10615,34.9
13123,Gilmer County,2021-05-15,29,10644,35
13123,Gilmer County,2021-05-16,22,10666,35.1
13123,Gilmer County,2021-05-17,28,10694,35.2
13123,Gilmer County,2021-05-18,31,10725,35.3
13123,Gilmer County,2021-05-19,33,10758,35.4
13123,Gilmer County,2021-05-20,31,10789,35.5
13123,Gilmer County,2021-05-21,29,10818,35.6
13123,Gilmer County,2021-05-22,20,10838,35.6
13123,Gilmer County,2021-05-23,14,10852,35.7
13123,Gilmer County,2021-05-24,23,10875,35.8
13123,Gilmer County,2021-05-25,36,10911,35.9
13123,Gilmer County,2021-05-26,27,10938,36
13123,Gilmer County,2021-05-27,15,10953,36
13123,Gilmer County,2021-05-28,17,10970,36.1
13123,Gilmer County,2021-05-29,16,10986,36.1
13123,Gilmer County,2021-05-30,8,10994,36.1
13123,Gilmer County,2021-05-31,9,11003,36.2
13123,Gilmer County,2021-06-01,27,11030,36.3
13123,Gilmer County,2021-06-02,27,11057,36.4
13123,Gilmer County,2021-06-03,27,11084,36.4
13123,Gilmer County,2021-06-04,23,11107,36.5
13123,Gilmer County,2021-06-05,10,11117,36.6
13123,Gilmer County,2021-06-06,5,11122,36.6
13123,Gilmer County,2021-06-07,18,11140,36.6
13123,Gilmer County,2021-06-08,23,11163,36.7
13123,Gilmer County,2021-06-09,28,11191,36.8
13123,Gilmer County,2021-06-10,20,11211,36.9
13123,Gilmer County,2021-06-11,16,11227,36.9
13123,Gilmer County,2021-06-12,9,11236,36.9
13123,Gilmer County,2021-06-13,4,11240,37
13123,Gilmer County,2021-06-14,10,11250,37
13123,Gilmer County,2021-06-15,17,11267,37
13123,Gilmer County,2021-06-16,13,11280,37.1
13123,Gilmer County,2021-06-17,7,11287,37.1
13123,Gilmer County,2021-06-18,21,11308,37.2
13123,Gilmer County,2021-06-19,9,11317,37.2
13123,Gilmer County,2021-06-20,4,11321,37.2
13123,Gilmer County,2021-06-21,22,11343,37.3
13123,Gilmer County,2021-06-22,15,11358,37.3
13123,Gilmer County,2021-06-23,12,11370,37.4
13123,Gilmer County,2021-06-24,7,11377,37.4
13123,Gilmer County,2021-06-25,13,11390,37.4
13123,Gilmer County,2021-06-26,5,11395,37.5
13123,Gilmer County,2021-06-27,2,11397,37.5
13123,Gilmer County,2021-06-28,10,11407,37.5
13123,Gilmer County,2021-06-29,26,11433,37.6
13123,Gilmer County,2021-06-30,15,11448,37.6
13123,Gilmer County,2021-07-01,6,11454,37.7
13123,Gilmer County,2021-07-02,9,11463,37.7
13123,Gilmer County,2021-07-03,2,11465,37.7
13123,Gilmer County,2021-07-04,2,11467,37.7
13123,Gilmer County,2021-07-05,8,11475,37.7
13123,Gilmer County,2021-07-06,8,11483,37.8
13123,Gilmer County,2021-07-07,9,11492,37.8
13123,Gilmer County,2021-07-08,12,11504,37.8
13123,Gilmer County,2021-07-09,21,11525,37.9
13123,Gilmer County,2021-07-10,10,11535,37.9
13123,Gilmer County,2021-07-11,3,11538,37.9
13123,Gilmer County,2021-07-12,7,11545,38
13123,Gilmer County,2021-07-13,13,11558,38
13123,Gilmer County,2021-07-14,9,11567,38
13123,Gilmer County,2021-07-15,20,11587,38.1
13123,Gilmer County,2021-07-16,17,11604,38.2
13123,Gilmer County,2021-07-17,14,11618,38.2
13123,Gilmer County,2021-07-18,4,11622,38.2
13123,Gilmer County,2021-07-19,11,11633,38.2
13123,Gilmer County,2021-07-20,20,11653,38.3
13123,Gilmer County,2021-07-21,20,11673,38.4
13123,Gilmer County,2021-07-22,15,11688,38.4
13123,Gilmer County,2021-07-23,30,11718,38.5
13123,Gilmer County,2021-07-24,19,11737,38.6
13123,Gilmer County,2021-07-25,8,11745,38.6
13123,Gilmer County,2021-07-26,25,11770,38.7
13123,Gilmer County,2021-07-27,37,11807,38.8
13123,Gilmer County,2021-07-28,25,11832,38.9
13123,Gilmer County,2021-07-29,29,11861,39
13123,Gilmer County,2021-07-30,27,11888,39.1
13123,Gilmer County,2021-07-31,21,11909,39.2
13123,Gilmer County,2021-08-01,13,11922,39.2
13123,Gilmer County,2021-08-02,42,11964,39.3
13123,Gilmer County,2021-08-03,39,12003,39.5
13123,Gilmer County,2021-08-04,27,12030,39.6
13123,Gilmer County,2021-08-05,43,12073,39.7
13123,Gilmer County,2021-08-06,37,12110,39.8
13123,Gilmer County,2021-08-07,13,12123,39.9
13123,Gilmer County,2021-08-08,17,12140,39.9
13123,Gilmer County,2021-08-09,26,12166,40
13123,Gilmer County,2021-08-10,53,12219,40.2
13123,Gilmer County,2021-08-11,39,12258,40.3
13123,Gilmer County,2021-08-12,56,12314,40.5
13123,Gilmer County,2021-08-13,56,12370,40.7
13123,Gilmer County,2021-08-14,36,12406,40.8
13123,Gilmer County,2021-08-15,26,12432,40.9
13123,Gilmer County,2021-08-16,33,12465,41
13123,Gilmer County,2021-08-17,67,12532,41.2
13123,Gilmer County,2021-08-18,46,12578,41.4
13123,Gilmer County,2021-08-19,38,12616,41.5
13123,Gilmer County,2021-08-20,39,12655,41.6
13123,Gilmer County,2021-08-21,26,12681,41.7
13123,Gilmer County,2021-08-22,15,12696,41.7
13123,Gilmer County,2021-08-23,41,12737,41.9
13123,Gilmer County,2021-08-24,42,12779,42
13123,Gilmer County,2021-08-25,21,12800,42.1
13123,Gilmer County,2021-08-26,33,12833,42.2
13123,Gilmer County,2021-08-27,61,12894,42.4
13123,Gilmer County,2021-08-28,17,12911,42.5
13123,Gilmer County,2021-08-29,7,12918,42.5
13123,Gilmer County,2021-08-30,46,12964,42.6
13123,Gilmer County,2021-08-31,27,12991,42.7
13123,Gilmer County,2021-09-01,37,13028,42.8
13123,Gilmer County,2021-09-02,46,13074,43
13123,Gilmer County,2021-09-03,44,13118,43.1
13123,Gilmer County,2021-09-04,25,13143,43.2
13123,Gilmer County,2021-09-05,11,13154,43.2
13123,Gilmer County,2021-09-06,2,13156,43.3
13123,Gilmer County,2021-09-07,45,13201,43.4
13123,Gilmer County,2021-09-08,26,13227,43.5
13123,Gilmer County,2021-09-09,36,13263,43.6
13123,Gilmer County,2021-09-10,44,13307,43.8
13123,Gilmer County,2021-09-11,16,13323,43.8
13123,Gilmer County,2021-09-12,13,13336,43.8
13123,Gilmer County,2021-09-13,36,13372,44
13123,Gilmer County,2021-09-14,29,13401,44.1
13123,Gilmer County,2021-09-15,29,13430,44.2
13123,Gilmer County,2021-09-16,27,13457,44.2
13123,Gilmer County,2021-09-17,27,13484,44.3
13123,Gilmer County,2021-09-18,11,13495,44.4
13123,Gilmer County,2021-09-19,11,13506,44.4
13123,Gilmer County,2021-09-20,25,13531,44.5
13123,Gilmer County,2021-09-21,22,13553,44.6
13123,Gilmer County,2021-09-22,16,13569,44.6
13123,Gilmer County,2021-09-23,11,13580,44.7
13123,Gilmer County,2021-09-24,7,13587,44.7
13123,Gilmer County,2021-09-25,8,13595,44.7
13123,Gilmer County,2021-09-26,3,13598,44.7
13123,Gilmer County,2021-09-27,17,13615,44.8
13123,Gilmer County,2021-09-28,19,13634,44.8
13123,Gilmer County,2021-09-29,16,13650,44.9
13123,Gilmer County,2021-09-30,11,13661,44.9
13123,Gilmer County,2021-10-01,15,13676,45
13123,Gilmer County,2021-10-02,5,13681,45
13123,Gilmer County,2021-10-03,1,13682,45
13123,Gilmer County,2021-10-04,5,13687,45
13123,Gilmer County,2021-10-05,7,13694,45
13123,Gilmer County,2021-10-06,8,13702,45.1
13123,Gilmer County,2021-10-07,6,13708,45.1
13125,Glascock County,2020-12-18,1,1,0
13125,Glascock County,2020-12-22,1,2,0.1
13125,Glascock County,2020-12-23,1,3,0.1
13125,Glascock County,2020-12-28,6,9,0.3
13125,Glascock County,2020-12-29,10,19,0.6
13125,Glascock County,2020-12-30,1,20,0.7
13125,Glascock County,2021-01-02,2,22,0.7
13125,Glascock County,2021-01-04,3,25,0.8
13125,Glascock County,2021-01-05,3,28,0.9
13125,Glascock County,2021-01-06,28,56,1.9
13125,Glascock County,2021-01-07,2,58,1.9
13125,Glascock County,2021-01-08,2,60,2
13125,Glascock County,2021-01-09,25,85,2.8
13125,Glascock County,2021-01-11,3,88,2.9
13125,Glascock County,2021-01-12,2,90,3
13125,Glascock County,2021-01-13,97,187,6.2
13125,Glascock County,2021-01-14,8,195,6.5
13125,Glascock County,2021-01-16,2,197,6.6
13125,Glascock County,2021-01-18,3,200,6.7
13125,Glascock County,2021-01-19,13,213,7.1
13125,Glascock County,2021-01-20,48,261,8.7
13125,Glascock County,2021-01-21,2,263,8.8
13125,Glascock County,2021-01-22,1,264,8.8
13125,Glascock County,2021-01-25,6,270,9
13125,Glascock County,2021-01-26,3,273,9.1
13125,Glascock County,2021-01-27,31,304,10.1
13125,Glascock County,2021-01-28,7,311,10.4
13125,Glascock County,2021-01-31,7,318,10.6
13125,Glascock County,2021-02-01,1,319,10.6
13125,Glascock County,2021-02-02,2,321,10.7
13125,Glascock County,2021-02-03,17,338,11.3
13125,Glascock County,2021-02-05,3,341,11.4
13125,Glascock County,2021-02-09,3,344,11.5
13125,Glascock County,2021-02-10,12,356,11.9
13125,Glascock County,2021-02-11,1,357,11.9
13125,Glascock County,2021-02-16,6,363,12.1
13125,Glascock County,2021-02-17,11,374,12.5
13125,Glascock County,2021-02-18,2,376,12.6
13125,Glascock County,2021-02-24,11,387,12.9
13125,Glascock County,2021-02-25,4,391,13.1
13125,Glascock County,2021-03-02,1,392,13.1
13125,Glascock County,2021-03-03,11,403,13.5
13125,Glascock County,2021-03-05,3,406,13.6
13125,Glascock County,2021-03-08,2,408,13.6
13125,Glascock County,2021-03-09,2,410,13.7
13125,Glascock County,2021-03-10,36,446,14.9
13125,Glascock County,2021-03-11,9,455,15.2
13125,Glascock County,2021-03-12,2,457,15.3
13125,Glascock County,2021-03-15,4,461,15.4
13125,Glascock County,2021-03-16,14,475,15.9
13125,Glascock County,2021-03-17,22,497,16.6
13125,Glascock County,2021-03-18,4,501,16.7
13125,Glascock County,2021-03-19,4,505,16.9
13125,Glascock County,2021-03-20,1,506,16.9
13125,Glascock County,2021-03-22,6,512,17.1
13125,Glascock County,2021-03-23,11,523,17.5
13125,Glascock County,2021-03-24,14,537,17.9
13125,Glascock County,2021-03-25,5,542,18.1
13125,Glascock County,2021-03-26,2,544,18.2
13125,Glascock County,2021-03-27,4,548,18.3
13125,Glascock County,2021-03-28,2,550,18.4
13125,Glascock County,2021-03-29,4,554,18.5
13125,Glascock County,2021-03-30,9,563,18.8
13125,Glascock County,2021-03-31,27,590,19.7
13125,Glascock County,2021-04-01,5,595,19.9
13125,Glascock County,2021-04-02,2,597,19.9
13125,Glascock County,2021-04-03,2,599,20
13125,Glascock County,2021-04-05,5,604,20.2
13125,Glascock County,2021-04-06,1,605,20.2
13125,Glascock County,2021-04-07,17,622,20.8
13125,Glascock County,2021-04-08,2,624,20.8
13125,Glascock County,2021-04-09,5,629,21
13125,Glascock County,2021-04-10,1,630,21
13125,Glascock County,2021-04-12,3,633,21.1
13125,Glascock County,2021-04-13,3,636,21.2
13125,Glascock County,2021-04-14,7,643,21.5
13125,Glascock County,2021-04-15,3,646,21.6
13125,Glascock County,2021-04-16,2,648,21.6
13125,Glascock County,2021-04-17,2,650,21.7
13125,Glascock County,2021-04-19,3,653,21.8
13125,Glascock County,2021-04-20,5,658,22
13125,Glascock County,2021-04-21,11,669,22.3
13125,Glascock County,2021-04-22,3,672,22.4
13125,Glascock County,2021-04-23,5,677,22.6
13125,Glascock County,2021-04-26,3,680,22.7
13125,Glascock County,2021-04-27,3,683,22.8
13125,Glascock County,2021-04-28,9,692,23.1
13125,Glascock County,2021-04-29,1,693,23.1
13125,Glascock County,2021-04-30,4,697,23.3
13125,Glascock County,2021-05-03,1,698,23.3
13125,Glascock County,2021-05-04,1,699,23.3
13125,Glascock County,2021-05-05,8,707,23.6
13125,Glascock County,2021-05-06,1,708,23.6
13125,Glascock County,2021-05-07,3,711,23.7
13125,Glascock County,2021-05-09,1,712,23.8
13125,Glascock County,2021-05-11,2,714,23.8
13125,Glascock County,2021-05-12,6,720,24
13125,Glascock County,2021-05-13,3,723,24.1
13125,Glascock County,2021-05-14,1,724,24.2
13125,Glascock County,2021-05-15,4,728,24.3
13125,Glascock County,2021-05-17,3,731,24.4
13125,Glascock County,2021-05-18,1,732,24.4
13125,Glascock County,2021-05-19,3,735,24.5
13125,Glascock County,2021-05-20,4,739,24.7
13125,Glascock County,2021-05-21,3,742,24.8
13125,Glascock County,2021-05-22,2,744,24.8
13125,Glascock County,2021-05-23,2,746,24.9
13125,Glascock County,2021-05-24,1,747,24.9
13125,Glascock County,2021-05-25,1,748,25
13125,Glascock County,2021-05-26,2,750,25
13125,Glascock County,2021-05-27,2,752,25.1
13125,Glascock County,2021-05-28,3,755,25.2
13125,Glascock County,2021-06-02,8,763,25.5
13125,Glascock County,2021-06-03,1,764,25.5
13125,Glascock County,2021-06-04,3,767,25.6
13125,Glascock County,2021-06-07,3,770,25.7
13125,Glascock County,2021-06-08,2,772,25.8
13125,Glascock County,2021-06-09,1,773,25.8
13125,Glascock County,2021-06-12,1,774,25.8
13125,Glascock County,2021-06-15,1,775,25.9
13125,Glascock County,2021-06-16,2,777,25.9
13125,Glascock County,2021-06-21,2,779,26
13125,Glascock County,2021-06-24,2,781,26.1
13125,Glascock County,2021-06-26,1,782,26.1
13125,Glascock County,2021-06-29,2,784,26.2
13125,Glascock County,2021-06-30,4,788,26.3
13125,Glascock County,2021-07-01,1,789,26.3
13125,Glascock County,2021-07-07,2,791,26.4
13125,Glascock County,2021-07-09,1,792,26.4
13125,Glascock County,2021-07-14,2,794,26.5
13125,Glascock County,2021-07-15,1,795,26.5
13125,Glascock County,2021-07-18,1,796,26.6
13125,Glascock County,2021-07-19,3,799,26.7
13125,Glascock County,2021-07-21,3,802,26.8
13125,Glascock County,2021-07-22,4,806,26.9
13125,Glascock County,2021-07-23,1,807,26.9
13125,Glascock County,2021-07-24,3,810,27
13125,Glascock County,2021-07-26,5,815,27.2
13125,Glascock County,2021-07-27,1,816,27.2
13125,Glascock County,2021-07-28,9,825,27.5
13125,Glascock County,2021-07-29,6,831,27.7
13125,Glascock County,2021-07-30,4,835,27.9
13125,Glascock County,2021-08-02,4,839,28
13125,Glascock County,2021-08-03,2,841,28.1
13125,Glascock County,2021-08-04,2,843,28.1
13125,Glascock County,2021-08-05,6,849,28.3
13125,Glascock County,2021-08-06,1,850,28.4
13125,Glascock County,2021-08-07,7,857,28.6
13125,Glascock County,2021-08-08,1,858,28.6
13125,Glascock County,2021-08-09,10,868,29
13125,Glascock County,2021-08-10,2,870,29
13125,Glascock County,2021-08-11,11,881,29.4
13125,Glascock County,2021-08-12,2,883,29.5
13125,Glascock County,2021-08-13,7,890,29.7
13125,Glascock County,2021-08-14,6,896,29.9
13125,Glascock County,2021-08-15,2,898,30
13125,Glascock County,2021-08-16,1,899,30
13125,Glascock County,2021-08-17,3,902,30.1
13125,Glascock County,2021-08-18,8,910,30.4
13125,Glascock County,2021-08-19,6,916,30.6
13125,Glascock County,2021-08-20,3,919,30.7
13125,Glascock County,2021-08-23,7,926,30.9
13125,Glascock County,2021-08-24,1,927,30.9
13125,Glascock County,2021-08-25,13,940,31.4
13125,Glascock County,2021-08-26,9,949,31.7
13125,Glascock County,2021-08-27,7,956,31.9
13125,Glascock County,2021-08-30,4,960,32
13125,Glascock County,2021-08-31,7,967,32.3
13125,Glascock County,2021-09-01,7,974,32.5
13125,Glascock County,2021-09-02,4,978,32.6
13125,Glascock County,2021-09-03,10,988,33
13125,Glascock County,2021-09-04,4,992,33.1
13125,Glascock County,2021-09-05,2,994,33.2
13125,Glascock County,2021-09-07,3,997,33.3
13125,Glascock County,2021-09-08,8,1005,33.5
13125,Glascock County,2021-09-09,3,1008,33.6
13125,Glascock County,2021-09-10,4,1012,33.8
13125,Glascock County,2021-09-11,3,1015,33.9
13125,Glascock County,2021-09-13,4,1019,34
13125,Glascock County,2021-09-15,7,1026,34.2
13125,Glascock County,2021-09-16,4,1030,34.4
13125,Glascock County,2021-09-17,1,1031,34.4
13125,Glascock County,2021-09-18,1,1032,34.4
13125,Glascock County,2021-09-19,1,1033,34.5
13125,Glascock County,2021-09-21,1,1034,34.5
13125,Glascock County,2021-09-22,2,1036,34.6
13125,Glascock County,2021-09-24,1,1037,34.6
13125,Glascock County,2021-09-25,1,1038,34.6
13125,Glascock County,2021-09-28,3,1041,34.7
13125,Glascock County,2021-09-29,1,1042,34.8
13125,Glascock County,2021-09-30,1,1043,34.8
13125,Glascock County,2021-10-01,1,1044,34.8
13125,Glascock County,2021-10-05,1,1045,34.9
13125,Glascock County,2021-10-07,1,1046,34.9
13127,Glynn County,2020-12-15,33,33,0
13127,Glynn County,2020-12-16,12,45,0.1
13127,Glynn County,2020-12-17,150,195,0.2
13127,Glynn County,2020-12-18,156,351,0.4
13127,Glynn County,2020-12-19,1,352,0.4
13127,Glynn County,2020-12-20,3,355,0.4
13127,Glynn County,2020-12-21,58,413,0.5
13127,Glynn County,2020-12-22,68,481,0.6
13127,Glynn County,2020-12-23,110,591,0.7
13127,Glynn County,2020-12-24,8,599,0.7
13127,Glynn County,2020-12-25,1,600,0.7
13127,Glynn County,2020-12-26,2,602,0.7
13127,Glynn County,2020-12-27,3,605,0.7
13127,Glynn County,2020-12-28,58,663,0.8
13127,Glynn County,2020-12-29,79,742,0.9
13127,Glynn County,2020-12-30,64,806,1
13127,Glynn County,2020-12-31,46,852,1
13127,Glynn County,2021-01-01,8,860,1
13127,Glynn County,2021-01-02,1,861,1
13127,Glynn County,2021-01-03,10,871,1
13127,Glynn County,2021-01-04,38,909,1.1
13127,Glynn County,2021-01-05,291,1200,1.4
13127,Glynn County,2021-01-06,151,1351,1.6
13127,Glynn County,2021-01-07,105,1456,1.7
13127,Glynn County,2021-01-08,287,1743,2.1
13127,Glynn County,2021-01-09,2,1745,2.1
13127,Glynn County,2021-01-10,102,1847,2.2
13127,Glynn County,2021-01-11,242,2089,2.5
13127,Glynn County,2021-01-12,496,2585,3.1
13127,Glynn County,2021-01-13,680,3265,3.9
13127,Glynn County,2021-01-14,844,4109,4.9
13127,Glynn County,2021-01-15,309,4418,5.2
13127,Glynn County,2021-01-16,376,4794,5.7
13127,Glynn County,2021-01-17,158,4952,5.9
13127,Glynn County,2021-01-18,413,5365,6.4
13127,Glynn County,2021-01-19,420,5785,6.8
13127,Glynn County,2021-01-20,794,6579,7.8
13127,Glynn County,2021-01-21,634,7213,8.5
13127,Glynn County,2021-01-22,325,7538,8.9
13127,Glynn County,2021-01-23,222,7760,9.2
13127,Glynn County,2021-01-24,7,7767,9.2
13127,Glynn County,2021-01-25,275,8042,9.5
13127,Glynn County,2021-01-26,687,8729,10.3
13127,Glynn County,2021-01-27,182,8911,10.5
13127,Glynn County,2021-01-28,269,9180,10.9
13127,Glynn County,2021-01-29,325,9505,11.3
13127,Glynn County,2021-01-30,609,10114,12
13127,Glynn County,2021-01-31,15,10129,12
13127,Glynn County,2021-02-01,346,10475,12.4
13127,Glynn County,2021-02-02,516,10991,13
13127,Glynn County,2021-02-03,260,11251,13.3
13127,Glynn County,2021-02-04,445,11696,13.8
13127,Glynn County,2021-02-05,126,11822,14
13127,Glynn County,2021-02-06,36,11858,14
13127,Glynn County,2021-02-07,9,11867,14
13127,Glynn County,2021-02-08,339,12206,14.5
13127,Glynn County,2021-02-09,305,12511,14.8
13127,Glynn County,2021-02-10,214,12725,15.1
13127,Glynn County,2021-02-11,370,13095,15.5
13127,Glynn County,2021-02-12,178,13273,15.7
13127,Glynn County,2021-02-13,39,13312,15.8
13127,Glynn County,2021-02-14,16,13328,15.8
13127,Glynn County,2021-02-15,238,13566,16.1
13127,Glynn County,2021-02-16,389,13955,16.5
13127,Glynn County,2021-02-17,562,14517,17.2
13127,Glynn County,2021-02-18,222,14739,17.4
13127,Glynn County,2021-02-19,147,14886,17.6
13127,Glynn County,2021-02-20,324,15210,18
13127,Glynn County,2021-02-21,37,15247,18.1
13127,Glynn County,2021-02-22,181,15428,18.3
13127,Glynn County,2021-02-23,203,15631,18.5
13127,Glynn County,2021-02-24,459,16090,19
13127,Glynn County,2021-02-25,240,16330,19.3
13127,Glynn County,2021-02-26,118,16448,19.5
13127,Glynn County,2021-02-27,346,16794,19.9
13127,Glynn County,2021-02-28,13,16807,19.9
13127,Glynn County,2021-03-01,171,16978,20.1
13127,Glynn County,2021-03-02,178,17156,20.3
13127,Glynn County,2021-03-03,427,17583,20.8
13127,Glynn County,2021-03-04,187,17770,21
13127,Glynn County,2021-03-05,92,17862,21.1
13127,Glynn County,2021-03-06,319,18181,21.5
13127,Glynn County,2021-03-07,12,18193,21.5
13127,Glynn County,2021-03-08,229,18422,21.8
13127,Glynn County,2021-03-09,247,18669,22.1
13127,Glynn County,2021-03-10,556,19225,22.8
13127,Glynn County,2021-03-11,245,19470,23
13127,Glynn County,2021-03-12,354,19824,23.5
13127,Glynn County,2021-03-13,483,20307,24
13127,Glynn County,2021-03-14,25,20332,24.1
13127,Glynn County,2021-03-15,306,20638,24.4
13127,Glynn County,2021-03-16,428,21066,24.9
13127,Glynn County,2021-03-17,504,21570,25.5
13127,Glynn County,2021-03-18,400,21970,26
13127,Glynn County,2021-03-19,297,22267,26.4
13127,Glynn County,2021-03-20,304,22571,26.7
13127,Glynn County,2021-03-21,22,22593,26.7
13127,Glynn County,2021-03-22,258,22851,27.1
13127,Glynn County,2021-03-23,415,23266,27.5
13127,Glynn County,2021-03-24,488,23754,28.1
13127,Glynn County,2021-03-25,588,24342,28.8
13127,Glynn County,2021-03-26,288,24630,29.2
13127,Glynn County,2021-03-27,369,24999,29.6
13127,Glynn County,2021-03-28,46,25045,29.6
13127,Glynn County,2021-03-29,259,25304,30
13127,Glynn County,2021-03-30,318,25622,30.3
13127,Glynn County,2021-03-31,566,26188,31
13127,Glynn County,2021-04-01,440,26628,31.5
13127,Glynn County,2021-04-02,175,26803,31.7
13127,Glynn County,2021-04-03,210,27013,32
13127,Glynn County,2021-04-04,35,27048,32
13127,Glynn County,2021-04-05,194,27242,32.3
13127,Glynn County,2021-04-06,648,27890,33
13127,Glynn County,2021-04-07,334,28224,33.4
13127,Glynn County,2021-04-08,381,28605,33.9
13127,Glynn County,2021-04-09,206,28811,34.1
13127,Glynn County,2021-04-10,191,29002,34.3
13127,Glynn County,2021-04-11,27,29029,34.4
13127,Glynn County,2021-04-12,129,29158,34.5
13127,Glynn County,2021-04-13,153,29311,34.7
13127,Glynn County,2021-04-14,207,29518,34.9
13127,Glynn County,2021-04-15,148,29666,35.1
13127,Glynn County,2021-04-16,100,29766,35.2
13127,Glynn County,2021-04-17,106,29872,35.4
13127,Glynn County,2021-04-18,4,29876,35.4
13127,Glynn County,2021-04-19,71,29947,35.5
13127,Glynn County,2021-04-20,131,30078,35.6
13127,Glynn County,2021-04-21,164,30242,35.8
13127,Glynn County,2021-04-22,129,30371,36
13127,Glynn County,2021-04-23,96,30467,36.1
13127,Glynn County,2021-04-24,96,30563,36.2
13127,Glynn County,2021-04-25,14,30577,36.2
13127,Glynn County,2021-04-26,83,30660,36.3
13127,Glynn County,2021-04-27,99,30759,36.4
13127,Glynn County,2021-04-28,152,30911,36.6
13127,Glynn County,2021-04-29,99,31010,36.7
13127,Glynn County,2021-04-30,108,31118,36.8
13127,Glynn County,2021-05-01,54,31172,36.9
13127,Glynn County,2021-05-02,9,31181,36.9
13127,Glynn County,2021-05-03,68,31249,37
13127,Glynn County,2021-05-04,75,31324,37.1
13127,Glynn County,2021-05-05,140,31464,37.2
13127,Glynn County,2021-05-06,105,31569,37.4
13127,Glynn County,2021-05-07,79,31648,37.5
13127,Glynn County,2021-05-08,70,31718,37.5
13127,Glynn County,2021-05-09,4,31722,37.6
13127,Glynn County,2021-05-10,52,31774,37.6
13127,Glynn County,2021-05-11,94,31868,37.7
13127,Glynn County,2021-05-12,122,31990,37.9
13127,Glynn County,2021-05-13,102,32092,38
13127,Glynn County,2021-05-14,92,32184,38.1
13127,Glynn County,2021-05-15,151,32335,38.3
13127,Glynn County,2021-05-16,31,32366,38.3
13127,Glynn County,2021-05-17,113,32479,38.5
13127,Glynn County,2021-05-18,115,32594,38.6
13127,Glynn County,2021-05-19,160,32754,38.8
13127,Glynn County,2021-05-20,143,32897,38.9
13127,Glynn County,2021-05-21,78,32975,39
13127,Glynn County,2021-05-22,111,33086,39.2
13127,Glynn County,2021-05-23,16,33102,39.2
13127,Glynn County,2021-05-24,62,33164,39.3
13127,Glynn County,2021-05-25,62,33226,39.3
13127,Glynn County,2021-05-26,69,33295,39.4
13127,Glynn County,2021-05-27,115,33410,39.6
13127,Glynn County,2021-05-28,53,33463,39.6
13127,Glynn County,2021-05-29,26,33489,39.6
13127,Glynn County,2021-05-30,11,33500,39.7
13127,Glynn County,2021-05-31,9,33509,39.7
13127,Glynn County,2021-06-01,70,33579,39.8
13127,Glynn County,2021-06-02,108,33687,39.9
13127,Glynn County,2021-06-03,110,33797,40
13127,Glynn County,2021-06-04,54,33851,40.1
13127,Glynn County,2021-06-05,54,33905,40.1
13127,Glynn County,2021-06-06,14,33919,40.2
13127,Glynn County,2021-06-07,83,34002,40.3
13127,Glynn County,2021-06-08,110,34112,40.4
13127,Glynn County,2021-06-09,57,34169,40.5
13127,Glynn County,2021-06-10,95,34264,40.6
13127,Glynn County,2021-06-11,35,34299,40.6
13127,Glynn County,2021-06-12,40,34339,40.7
13127,Glynn County,2021-06-13,9,34348,40.7
13127,Glynn County,2021-06-14,46,34394,40.7
13127,Glynn County,2021-06-15,39,34433,40.8
13127,Glynn County,2021-06-16,56,34489,40.8
13127,Glynn County,2021-06-17,56,34545,40.9
13127,Glynn County,2021-06-18,38,34583,40.9
13127,Glynn County,2021-06-19,42,34625,41
13127,Glynn County,2021-06-20,7,34632,41
13127,Glynn County,2021-06-21,37,34669,41
13127,Glynn County,2021-06-22,59,34728,41.1
13127,Glynn County,2021-06-23,74,34802,41.2
13127,Glynn County,2021-06-24,87,34889,41.3
13127,Glynn County,2021-06-25,41,34930,41.4
13127,Glynn County,2021-06-26,21,34951,41.4
13127,Glynn County,2021-06-27,6,34957,41.4
13127,Glynn County,2021-06-28,46,35003,41.4
13127,Glynn County,2021-06-29,65,35068,41.5
13127,Glynn County,2021-06-30,26,35094,41.5
13127,Glynn County,2021-07-01,50,35144,41.6
13127,Glynn County,2021-07-02,37,35181,41.6
13127,Glynn County,2021-07-03,16,35197,41.7
13127,Glynn County,2021-07-04,1,35198,41.7
13127,Glynn County,2021-07-05,33,35231,41.7
13127,Glynn County,2021-07-06,47,35278,41.8
13127,Glynn County,2021-07-07,20,35298,41.8
13127,Glynn County,2021-07-08,30,35328,41.8
13127,Glynn County,2021-07-09,51,35379,41.9
13127,Glynn County,2021-07-10,18,35397,41.9
13127,Glynn County,2021-07-11,11,35408,41.9
13127,Glynn County,2021-07-12,43,35451,42
13127,Glynn County,2021-07-13,109,35560,42.1
13127,Glynn County,2021-07-14,53,35613,42.2
13127,Glynn County,2021-07-15,40,35653,42.2
13127,Glynn County,2021-07-16,46,35699,42.3
13127,Glynn County,2021-07-17,17,35716,42.3
13127,Glynn County,2021-07-18,30,35746,42.3
13127,Glynn County,2021-07-19,75,35821,42.4
13127,Glynn County,2021-07-20,100,35921,42.5
13127,Glynn County,2021-07-21,81,36002,42.6
13127,Glynn County,2021-07-22,110,36112,42.8
13127,Glynn County,2021-07-23,119,36231,42.9
13127,Glynn County,2021-07-24,79,36310,43
13127,Glynn County,2021-07-25,59,36369,43.1
13127,Glynn County,2021-07-26,125,36494,43.2
13127,Glynn County,2021-07-27,272,36766,43.5
13127,Glynn County,2021-07-28,129,36895,43.7
13127,Glynn County,2021-07-29,217,37112,43.9
13127,Glynn County,2021-07-30,142,37254,44.1
13127,Glynn County,2021-07-31,93,37347,44.2
13127,Glynn County,2021-08-01,52,37399,44.3
13127,Glynn County,2021-08-02,156,37555,44.5
13127,Glynn County,2021-08-03,334,37889,44.9
13127,Glynn County,2021-08-04,144,38033,45
13127,Glynn County,2021-08-05,263,38296,45.3
13127,Glynn County,2021-08-06,172,38468,45.5
13127,Glynn County,2021-08-07,107,38575,45.7
13127,Glynn County,2021-08-08,74,38649,45.8
13127,Glynn County,2021-08-09,167,38816,46
13127,Glynn County,2021-08-10,285,39101,46.3
13127,Glynn County,2021-08-11,153,39254,46.5
13127,Glynn County,2021-08-12,289,39543,46.8
13127,Glynn County,2021-08-13,171,39714,47
13127,Glynn County,2021-08-14,97,39811,47.1
13127,Glynn County,2021-08-15,55,39866,47.2
13127,Glynn County,2021-08-16,175,40041,47.4
13127,Glynn County,2021-08-17,249,40290,47.7
13127,Glynn County,2021-08-18,203,40493,47.9
13127,Glynn County,2021-08-19,330,40823,48.3
13127,Glynn County,2021-08-20,158,40981,48.5
13127,Glynn County,2021-08-21,71,41052,48.6
13127,Glynn County,2021-08-22,59,41111,48.7
13127,Glynn County,2021-08-23,147,41258,48.8
13127,Glynn County,2021-08-24,315,41573,49.2
13127,Glynn County,2021-08-25,133,41706,49.4
13127,Glynn County,2021-08-26,273,41979,49.7
13127,Glynn County,2021-08-27,124,42103,49.8
13127,Glynn County,2021-08-28,62,42165,49.9
13127,Glynn County,2021-08-29,33,42198,50
13127,Glynn County,2021-08-30,141,42339,50.1
13127,Glynn County,2021-08-31,227,42566,50.4
13127,Glynn County,2021-09-01,95,42661,50.5
13127,Glynn County,2021-09-02,204,42865,50.7
13127,Glynn County,2021-09-03,147,43012,50.9
13127,Glynn County,2021-09-04,34,43046,51
13127,Glynn County,2021-09-05,31,43077,51
13127,Glynn County,2021-09-06,21,43098,51
13127,Glynn County,2021-09-07,102,43200,51.1
13127,Glynn County,2021-09-08,137,43337,51.3
13127,Glynn County,2021-09-09,165,43502,51.5
13127,Glynn County,2021-09-10,99,43601,51.6
13127,Glynn County,2021-09-11,37,43638,51.7
13127,Glynn County,2021-09-12,40,43678,51.7
13127,Glynn County,2021-09-13,77,43755,51.8
13127,Glynn County,2021-09-14,121,43876,51.9
13127,Glynn County,2021-09-15,77,43953,52
13127,Glynn County,2021-09-16,93,44046,52.1
13127,Glynn County,2021-09-17,68,44114,52.2
13127,Glynn County,2021-09-18,42,44156,52.3
13127,Glynn County,2021-09-19,34,44190,52.3
13127,Glynn County,2021-09-20,59,44249,52.4
13127,Glynn County,2021-09-21,64,44313,52.5
13127,Glynn County,2021-09-22,54,44367,52.5
13127,Glynn County,2021-09-23,62,44429,52.6
13127,Glynn County,2021-09-24,44,44473,52.6
13127,Glynn County,2021-09-25,38,44511,52.7
13127,Glynn County,2021-09-26,7,44518,52.7
13127,Glynn County,2021-09-27,26,44544,52.7
13127,Glynn County,2021-09-28,31,44575,52.8
13127,Glynn County,2021-09-29,19,44594,52.8
13127,Glynn County,2021-09-30,42,44636,52.8
13127,Glynn County,2021-10-01,25,44661,52.9
13127,Glynn County,2021-10-02,10,44671,52.9
13127,Glynn County,2021-10-03,7,44678,52.9
13127,Glynn County,2021-10-04,12,44690,52.9
13127,Glynn County,2021-10-05,40,44730,53
13127,Glynn County,2021-10-06,17,44747,53
13127,Glynn County,2021-10-07,32,44779,53
13129,Gordon County,2020-12-17,1,1,0
13129,Gordon County,2020-12-18,15,16,0
13129,Gordon County,2020-12-19,3,19,0
13129,Gordon County,2020-12-20,4,23,0
13129,Gordon County,2020-12-21,25,48,0.1
13129,Gordon County,2020-12-22,37,85,0.1
13129,Gordon County,2020-12-23,43,128,0.2
13129,Gordon County,2020-12-24,9,137,0.2
13129,Gordon County,2020-12-26,3,140,0.2
13129,Gordon County,2020-12-27,42,182,0.3
13129,Gordon County,2020-12-28,60,242,0.4
13129,Gordon County,2020-12-29,46,288,0.5
13129,Gordon County,2020-12-30,64,352,0.6
13129,Gordon County,2020-12-31,42,394,0.7
13129,Gordon County,2021-01-01,12,406,0.7
13129,Gordon County,2021-01-02,8,414,0.7
13129,Gordon County,2021-01-03,55,469,0.8
13129,Gordon County,2021-01-04,25,494,0.9
13129,Gordon County,2021-01-05,116,610,1.1
13129,Gordon County,2021-01-06,111,721,1.3
13129,Gordon County,2021-01-07,108,829,1.4
13129,Gordon County,2021-01-08,112,941,1.6
13129,Gordon County,2021-01-09,5,946,1.7
13129,Gordon County,2021-01-10,11,957,1.7
13129,Gordon County,2021-01-11,154,1111,1.9
13129,Gordon County,2021-01-12,245,1356,2.4
13129,Gordon County,2021-01-13,252,1608,2.8
13129,Gordon County,2021-01-14,374,1982,3.5
13129,Gordon County,2021-01-15,129,2111,3.7
13129,Gordon County,2021-01-16,17,2128,3.7
13129,Gordon County,2021-01-17,11,2139,3.7
13129,Gordon County,2021-01-18,276,2415,4.2
13129,Gordon County,2021-01-19,356,2771,4.8
13129,Gordon County,2021-01-20,384,3155,5.5
13129,Gordon County,2021-01-21,331,3486,6.1
13129,Gordon County,2021-01-22,136,3622,6.3
13129,Gordon County,2021-01-23,8,3630,6.3
13129,Gordon County,2021-01-24,28,3658,6.4
13129,Gordon County,2021-01-25,213,3871,6.8
13129,Gordon County,2021-01-26,181,4052,7.1
13129,Gordon County,2021-01-27,358,4410,7.7
13129,Gordon County,2021-01-28,358,4768,8.3
13129,Gordon County,2021-01-29,209,4977,8.7
13129,Gordon County,2021-01-30,2,4979,8.7
13129,Gordon County,2021-02-01,228,5207,9.1
13129,Gordon County,2021-02-02,138,5345,9.3
13129,Gordon County,2021-02-03,146,5491,9.6
13129,Gordon County,2021-02-04,156,5647,9.9
13129,Gordon County,2021-02-05,192,5839,10.2
13129,Gordon County,2021-02-06,9,5848,10.2
13129,Gordon County,2021-02-07,3,5851,10.2
13129,Gordon County,2021-02-08,49,5900,10.3
13129,Gordon County,2021-02-09,103,6003,10.5
13129,Gordon County,2021-02-10,94,6097,10.7
13129,Gordon County,2021-02-11,28,6125,10.7
13129,Gordon County,2021-02-12,33,6158,10.8
13129,Gordon County,2021-02-13,2,6160,10.8
13129,Gordon County,2021-02-14,7,6167,10.8
13129,Gordon County,2021-02-15,23,6190,10.8
13129,Gordon County,2021-02-16,11,6201,10.8
13129,Gordon County,2021-02-17,81,6282,11
13129,Gordon County,2021-02-18,9,6291,11
13129,Gordon County,2021-02-19,39,6330,11.1
13129,Gordon County,2021-02-20,3,6333,11.1
13129,Gordon County,2021-02-22,7,6340,11.1
13129,Gordon County,2021-02-23,22,6362,11.1
13129,Gordon County,2021-02-24,23,6385,11.2
13129,Gordon County,2021-02-25,32,6417,11.2
13129,Gordon County,2021-02-26,49,6466,11.3
13129,Gordon County,2021-02-27,19,6485,11.3
13129,Gordon County,2021-02-28,20,6505,11.4
13129,Gordon County,2021-03-01,64,6569,11.5
13129,Gordon County,2021-03-02,52,6621,11.6
13129,Gordon County,2021-03-03,67,6688,11.7
13129,Gordon County,2021-03-04,132,6820,11.9
13129,Gordon County,2021-03-05,98,6918,12.1
13129,Gordon County,2021-03-06,23,6941,12.1
13129,Gordon County,2021-03-07,17,6958,12.2
13129,Gordon County,2021-03-08,198,7156,12.5
13129,Gordon County,2021-03-09,140,7296,12.8
13129,Gordon County,2021-03-10,177,7473,13.1
13129,Gordon County,2021-03-11,177,7650,13.4
13129,Gordon County,2021-03-12,466,8116,14.2
13129,Gordon County,2021-03-13,26,8142,14.2
13129,Gordon County,2021-03-14,28,8170,14.3
13129,Gordon County,2021-03-15,302,8472,14.8
13129,Gordon County,2021-03-16,403,8875,15.5
13129,Gordon County,2021-03-17,224,9099,15.9
13129,Gordon County,2021-03-18,138,9237,16.1
13129,Gordon County,2021-03-19,434,9671,16.9
13129,Gordon County,2021-03-20,15,9686,16.9
13129,Gordon County,2021-03-21,32,9718,17
13129,Gordon County,2021-03-22,153,9871,17.3
13129,Gordon County,2021-03-23,191,10062,17.6
13129,Gordon County,2021-03-24,238,10300,18
13129,Gordon County,2021-03-25,149,10449,18.3
13129,Gordon County,2021-03-26,568,11017,19.3
13129,Gordon County,2021-03-27,83,11100,19.4
13129,Gordon County,2021-03-28,35,11135,19.5
13129,Gordon County,2021-03-29,256,11391,19.9
13129,Gordon County,2021-03-30,428,11819,20.7
13129,Gordon County,2021-03-31,289,12108,21.2
13129,Gordon County,2021-04-01,190,12298,21.5
13129,Gordon County,2021-04-02,279,12577,22
13129,Gordon County,2021-04-03,93,12670,22.1
13129,Gordon County,2021-04-04,48,12718,22.2
13129,Gordon County,2021-04-05,134,12852,22.5
13129,Gordon County,2021-04-06,149,13001,22.7
13129,Gordon County,2021-04-07,219,13220,23.1
13129,Gordon County,2021-04-08,207,13427,23.5
13129,Gordon County,2021-04-09,157,13584,23.7
13129,Gordon County,2021-04-10,43,13627,23.8
13129,Gordon County,2021-04-11,29,13656,23.9
13129,Gordon County,2021-04-12,123,13779,24.1
13129,Gordon County,2021-04-13,104,13883,24.3
13129,Gordon County,2021-04-14,71,13954,24.4
13129,Gordon County,2021-04-15,114,14068,24.6
13129,Gordon County,2021-04-16,123,14191,24.8
13129,Gordon County,2021-04-17,28,14219,24.9
13129,Gordon County,2021-04-18,7,14226,24.9
13129,Gordon County,2021-04-19,63,14289,25
13129,Gordon County,2021-04-20,95,14384,25.1
13129,Gordon County,2021-04-21,122,14506,25.4
13129,Gordon County,2021-04-22,86,14592,25.5
13129,Gordon County,2021-04-23,235,14827,25.9
13129,Gordon County,2021-04-24,40,14867,26
13129,Gordon County,2021-04-25,18,14885,26
13129,Gordon County,2021-04-26,43,14928,26.1
13129,Gordon County,2021-04-27,69,14997,26.2
13129,Gordon County,2021-04-28,94,15091,26.4
13129,Gordon County,2021-04-29,67,15158,26.5
13129,Gordon County,2021-04-30,116,15274,26.7
13129,Gordon County,2021-05-01,21,15295,26.7
13129,Gordon County,2021-05-02,18,15313,26.8
13129,Gordon County,2021-05-03,54,15367,26.9
13129,Gordon County,2021-05-04,79,15446,27
13129,Gordon County,2021-05-05,68,15514,27.1
13129,Gordon County,2021-05-06,56,15570,27.2
13129,Gordon County,2021-05-07,69,15639,27.3
13129,Gordon County,2021-05-08,33,15672,27.4
13129,Gordon County,2021-05-09,19,15691,27.4
13129,Gordon County,2021-05-10,35,15726,27.5
13129,Gordon County,2021-05-11,61,15787,27.6
13129,Gordon County,2021-05-12,38,15825,27.7
13129,Gordon County,2021-05-13,68,15893,27.8
13129,Gordon County,2021-05-14,54,15947,27.9
13129,Gordon County,2021-05-15,49,15996,28
13129,Gordon County,2021-05-16,32,16028,28
13129,Gordon County,2021-05-17,78,16106,28.2
13129,Gordon County,2021-05-18,67,16173,28.3
13129,Gordon County,2021-05-19,61,16234,28.4
13129,Gordon County,2021-05-20,46,16280,28.5
13129,Gordon County,2021-05-21,75,16355,28.6
13129,Gordon County,2021-05-22,34,16389,28.7
13129,Gordon County,2021-05-23,18,16407,28.7
13129,Gordon County,2021-05-24,48,16455,28.8
13129,Gordon County,2021-05-25,63,16518,28.9
13129,Gordon County,2021-05-26,46,16564,29
13129,Gordon County,2021-05-27,49,16613,29
13129,Gordon County,2021-05-28,117,16730,29.2
13129,Gordon County,2021-05-29,29,16759,29.3
13129,Gordon County,2021-05-30,17,16776,29.3
13129,Gordon County,2021-05-31,9,16785,29.3
13129,Gordon County,2021-06-01,42,16827,29.4
13129,Gordon County,2021-06-02,38,16865,29.5
13129,Gordon County,2021-06-03,25,16890,29.5
13129,Gordon County,2021-06-04,61,16951,29.6
13129,Gordon County,2021-06-05,20,16971,29.7
13129,Gordon County,2021-06-06,21,16992,29.7
13129,Gordon County,2021-06-07,23,17015,29.7
13129,Gordon County,2021-06-08,23,17038,29.8
13129,Gordon County,2021-06-09,33,17071,29.8
13129,Gordon County,2021-06-10,20,17091,29.9
13129,Gordon County,2021-06-11,45,17136,30
13129,Gordon County,2021-06-12,19,17155,30
13129,Gordon County,2021-06-13,11,17166,30
13129,Gordon County,2021-06-14,26,17192,30.1
13129,Gordon County,2021-06-15,34,17226,30.1
13129,Gordon County,2021-06-16,25,17251,30.2
13129,Gordon County,2021-06-17,32,17283,30.2
13129,Gordon County,2021-06-18,45,17328,30.3
13129,Gordon County,2021-06-19,15,17343,30.3
13129,Gordon County,2021-06-20,11,17354,30.3
13129,Gordon County,2021-06-21,22,17376,30.4
13129,Gordon County,2021-06-22,40,17416,30.4
13129,Gordon County,2021-06-23,30,17446,30.5
13129,Gordon County,2021-06-24,31,17477,30.6
13129,Gordon County,2021-06-25,31,17508,30.6
13129,Gordon County,2021-06-26,22,17530,30.6
13129,Gordon County,2021-06-27,16,17546,30.7
13129,Gordon County,2021-06-28,16,17562,30.7
13129,Gordon County,2021-06-29,24,17586,30.7
13129,Gordon County,2021-06-30,20,17606,30.8
13129,Gordon County,2021-07-01,17,17623,30.8
13129,Gordon County,2021-07-02,30,17653,30.9
13129,Gordon County,2021-07-03,13,17666,30.9
13129,Gordon County,2021-07-04,1,17667,30.9
13129,Gordon County,2021-07-05,19,17686,30.9
13129,Gordon County,2021-07-06,32,17718,31
13129,Gordon County,2021-07-07,31,17749,31
13129,Gordon County,2021-07-08,25,17774,31.1
13129,Gordon County,2021-07-09,27,17801,31.1
13129,Gordon County,2021-07-10,13,17814,31.1
13129,Gordon County,2021-07-11,13,17827,31.2
13129,Gordon County,2021-07-12,32,17859,31.2
13129,Gordon County,2021-07-13,36,17895,31.3
13129,Gordon County,2021-07-14,22,17917,31.3
13129,Gordon County,2021-07-15,31,17948,31.4
13129,Gordon County,2021-07-16,38,17986,31.4
13129,Gordon County,2021-07-17,16,18002,31.5
13129,Gordon County,2021-07-18,17,18019,31.5
13129,Gordon County,2021-07-19,30,18049,31.6
13129,Gordon County,2021-07-20,45,18094,31.6
13129,Gordon County,2021-07-21,35,18129,31.7
13129,Gordon County,2021-07-22,45,18174,31.8
13129,Gordon County,2021-07-23,68,18242,31.9
13129,Gordon County,2021-07-24,40,18282,32
13129,Gordon County,2021-07-25,27,18309,32
13129,Gordon County,2021-07-26,62,18371,32.1
13129,Gordon County,2021-07-27,58,18429,32.2
13129,Gordon County,2021-07-28,95,18524,32.4
13129,Gordon County,2021-07-29,74,18598,32.5
13129,Gordon County,2021-07-30,94,18692,32.7
13129,Gordon County,2021-07-31,73,18765,32.8
13129,Gordon County,2021-08-01,38,18803,32.9
13129,Gordon County,2021-08-02,84,18887,33
13129,Gordon County,2021-08-03,117,19004,33.2
13129,Gordon County,2021-08-04,97,19101,33.4
13129,Gordon County,2021-08-05,70,19171,33.5
13129,Gordon County,2021-08-06,129,19300,33.7
13129,Gordon County,2021-08-07,76,19376,33.9
13129,Gordon County,2021-08-08,23,19399,33.9
13129,Gordon County,2021-08-09,76,19475,34
13129,Gordon County,2021-08-10,124,19599,34.3
13129,Gordon County,2021-08-11,82,19681,34.4
13129,Gordon County,2021-08-12,106,19787,34.6
13129,Gordon County,2021-08-13,123,19910,34.8
13129,Gordon County,2021-08-14,64,19974,34.9
13129,Gordon County,2021-08-15,31,20005,35
13129,Gordon County,2021-08-16,98,20103,35.1
13129,Gordon County,2021-08-17,116,20219,35.3
13129,Gordon County,2021-08-18,73,20292,35.5
13129,Gordon County,2021-08-19,130,20422,35.7
13129,Gordon County,2021-08-20,145,20567,36
13129,Gordon County,2021-08-21,75,20642,36.1
13129,Gordon County,2021-08-22,52,20694,36.2
13129,Gordon County,2021-08-23,107,20801,36.4
13129,Gordon County,2021-08-24,124,20925,36.6
13129,Gordon County,2021-08-25,85,21010,36.7
13129,Gordon County,2021-08-26,128,21138,37
13129,Gordon County,2021-08-27,140,21278,37.2
13129,Gordon County,2021-08-28,65,21343,37.3
13129,Gordon County,2021-08-29,40,21383,37.4
13129,Gordon County,2021-08-30,93,21476,37.5
13129,Gordon County,2021-08-31,94,21570,37.7
13129,Gordon County,2021-09-01,95,21665,37.9
13129,Gordon County,2021-09-02,150,21815,38.1
13129,Gordon County,2021-09-03,145,21960,38.4
13129,Gordon County,2021-09-04,67,22027,38.5
13129,Gordon County,2021-09-05,48,22075,38.6
13129,Gordon County,2021-09-06,20,22095,38.6
13129,Gordon County,2021-09-07,79,22174,38.8
13129,Gordon County,2021-09-08,97,22271,38.9
13129,Gordon County,2021-09-09,76,22347,39.1
13129,Gordon County,2021-09-10,80,22427,39.2
13129,Gordon County,2021-09-11,60,22487,39.3
13129,Gordon County,2021-09-12,39,22526,39.4
13129,Gordon County,2021-09-13,54,22580,39.5
13129,Gordon County,2021-09-14,68,22648,39.6
13129,Gordon County,2021-09-15,56,22704,39.7
13129,Gordon County,2021-09-16,71,22775,39.8
13129,Gordon County,2021-09-17,75,22850,39.9
13129,Gordon County,2021-09-18,33,22883,40
13129,Gordon County,2021-09-19,19,22902,40
13129,Gordon County,2021-09-20,48,22950,40.1
13129,Gordon County,2021-09-21,42,22992,40.2
13129,Gordon County,2021-09-22,40,23032,40.3
13129,Gordon County,2021-09-23,34,23066,40.3
13129,Gordon County,2021-09-24,38,23104,40.4
13129,Gordon County,2021-09-25,24,23128,40.4
13129,Gordon County,2021-09-26,8,23136,40.4
13129,Gordon County,2021-09-27,29,23165,40.5
13129,Gordon County,2021-09-28,21,23186,40.5
13129,Gordon County,2021-09-29,24,23210,40.6
13129,Gordon County,2021-09-30,18,23228,40.6
13129,Gordon County,2021-10-01,27,23255,40.7
13129,Gordon County,2021-10-02,12,23267,40.7
13129,Gordon County,2021-10-03,2,23269,40.7
13129,Gordon County,2021-10-04,14,23283,40.7
13129,Gordon County,2021-10-05,22,23305,40.7
13129,Gordon County,2021-10-06,15,23320,40.8
13129,Gordon County,2021-10-07,9,23329,40.8
13131,Grady County,2020-12-17,1,1,0
13131,Grady County,2020-12-18,4,5,0
13131,Grady County,2020-12-19,10,15,0.1
13131,Grady County,2020-12-21,24,39,0.2
13131,Grady County,2020-12-22,18,57,0.2
13131,Grady County,2020-12-23,68,125,0.5
13131,Grady County,2020-12-24,5,130,0.5
13131,Grady County,2020-12-26,2,132,0.5
13131,Grady County,2020-12-28,62,194,0.8
13131,Grady County,2020-12-29,81,275,1.1
13131,Grady County,2020-12-30,73,348,1.4
13131,Grady County,2020-12-31,12,360,1.4
13131,Grady County,2021-01-02,1,361,1.5
13131,Grady County,2021-01-04,62,423,1.7
13131,Grady County,2021-01-05,70,493,2
13131,Grady County,2021-01-06,42,535,2.2
13131,Grady County,2021-01-07,12,547,2.2
13131,Grady County,2021-01-08,35,582,2.3
13131,Grady County,2021-01-09,2,584,2.4
13131,Grady County,2021-01-10,2,586,2.4
13131,Grady County,2021-01-11,103,689,2.8
13131,Grady County,2021-01-12,122,811,3.3
13131,Grady County,2021-01-13,123,934,3.8
13131,Grady County,2021-01-14,166,1100,4.4
13131,Grady County,2021-01-15,91,1191,4.8
13131,Grady County,2021-01-16,36,1227,4.9
13131,Grady County,2021-01-17,6,1233,5
13131,Grady County,2021-01-18,122,1355,5.5
13131,Grady County,2021-01-19,133,1488,6
13131,Grady County,2021-01-20,108,1596,6.4
13131,Grady County,2021-01-21,179,1775,7.1
13131,Grady County,2021-01-22,97,1872,7.5
13131,Grady County,2021-01-23,48,1920,7.7
13131,Grady County,2021-01-25,101,2021,8.1
13131,Grady County,2021-01-26,146,2167,8.7
13131,Grady County,2021-01-27,125,2292,9.2
13131,Grady County,2021-01-28,130,2422,9.8
13131,Grady County,2021-01-29,73,2495,10
13131,Grady County,2021-01-30,44,2539,10.2
13131,Grady County,2021-01-31,1,2540,10.2
13131,Grady County,2021-02-01,61,2601,10.5
13131,Grady County,2021-02-02,79,2680,10.8
13131,Grady County,2021-02-03,128,2808,11.3
13131,Grady County,2021-02-04,100,2908,11.7
13131,Grady County,2021-02-05,75,2983,12
13131,Grady County,2021-02-06,28,3011,12.1
13131,Grady County,2021-02-08,34,3045,12.3
13131,Grady County,2021-02-09,64,3109,12.5
13131,Grady County,2021-02-10,20,3129,12.6
13131,Grady County,2021-02-11,36,3165,12.7
13131,Grady County,2021-02-12,38,3203,12.9
13131,Grady County,2021-02-13,17,3220,13
13131,Grady County,2021-02-14,2,3222,13
13131,Grady County,2021-02-15,24,3246,13.1
13131,Grady County,2021-02-16,95,3341,13.5
13131,Grady County,2021-02-17,29,3370,13.6
13131,Grady County,2021-02-18,48,3418,13.8
13131,Grady County,2021-02-19,63,3481,14
13131,Grady County,2021-02-20,43,3524,14.2
13131,Grady County,2021-02-21,1,3525,14.2
13131,Grady County,2021-02-22,33,3558,14.3
13131,Grady County,2021-02-23,22,3580,14.4
13131,Grady County,2021-02-24,18,3598,14.5
13131,Grady County,2021-02-25,19,3617,14.6
13131,Grady County,2021-02-26,22,3639,14.7
13131,Grady County,2021-02-27,10,3649,14.7
13131,Grady County,2021-02-28,3,3652,14.7
13131,Grady County,2021-03-01,38,3690,14.9
13131,Grady County,2021-03-02,23,3713,15
13131,Grady County,2021-03-03,28,3741,15.1
13131,Grady County,2021-03-04,43,3784,15.2
13131,Grady County,2021-03-05,12,3796,15.3
13131,Grady County,2021-03-06,8,3804,15.3
13131,Grady County,2021-03-07,5,3809,15.3
13131,Grady County,2021-03-08,56,3865,15.6
13131,Grady County,2021-03-09,49,3914,15.8
13131,Grady County,2021-03-10,76,3990,16.1
13131,Grady County,2021-03-11,86,4076,16.4
13131,Grady County,2021-03-12,97,4173,16.8
13131,Grady County,2021-03-13,14,4187,16.9
13131,Grady County,2021-03-14,14,4201,16.9
13131,Grady County,2021-03-15,90,4291,17.3
13131,Grady County,2021-03-16,118,4409,17.8
13131,Grady County,2021-03-17,109,4518,18.2
13131,Grady County,2021-03-18,74,4592,18.5
13131,Grady County,2021-03-19,74,4666,18.8
13131,Grady County,2021-03-20,14,4680,18.8
13131,Grady County,2021-03-21,9,4689,18.9
13131,Grady County,2021-03-22,48,4737,19.1
13131,Grady County,2021-03-23,96,4833,19.5
13131,Grady County,2021-03-24,97,4930,19.9
13131,Grady County,2021-03-25,114,5044,20.3
13131,Grady County,2021-03-26,73,5117,20.6
13131,Grady County,2021-03-27,12,5129,20.7
13131,Grady County,2021-03-28,20,5149,20.7
13131,Grady County,2021-03-29,105,5254,21.2
13131,Grady County,2021-03-30,144,5398,21.7
13131,Grady County,2021-03-31,88,5486,22.1
13131,Grady County,2021-04-01,110,5596,22.5
13131,Grady County,2021-04-02,107,5703,23
13131,Grady County,2021-04-03,10,5713,23
13131,Grady County,2021-04-04,7,5720,23
13131,Grady County,2021-04-05,93,5813,23.4
13131,Grady County,2021-04-06,72,5885,23.7
13131,Grady County,2021-04-07,85,5970,24
13131,Grady County,2021-04-08,57,6027,24.3
13131,Grady County,2021-04-09,58,6085,24.5
13131,Grady County,2021-04-10,11,6096,24.6
13131,Grady County,2021-04-11,5,6101,24.6
13131,Grady County,2021-04-12,40,6141,24.7
13131,Grady County,2021-04-13,39,6180,24.9
13131,Grady County,2021-04-14,48,6228,25.1
13131,Grady County,2021-04-15,55,6283,25.3
13131,Grady County,2021-04-16,17,6300,25.4
13131,Grady County,2021-04-17,4,6304,25.4
13131,Grady County,2021-04-18,5,6309,25.4
13131,Grady County,2021-04-19,46,6355,25.6
13131,Grady County,2021-04-20,52,6407,25.8
13131,Grady County,2021-04-21,37,6444,26
13131,Grady County,2021-04-22,37,6481,26.1
13131,Grady County,2021-04-23,41,6522,26.3
13131,Grady County,2021-04-24,3,6525,26.3
13131,Grady County,2021-04-25,1,6526,26.3
13131,Grady County,2021-04-26,31,6557,26.4
13131,Grady County,2021-04-27,39,6596,26.6
13131,Grady County,2021-04-28,46,6642,26.8
13131,Grady County,2021-04-29,26,6668,26.9
13131,Grady County,2021-04-30,25,6693,27
13131,Grady County,2021-05-01,13,6706,27
13131,Grady County,2021-05-02,6,6712,27
13131,Grady County,2021-05-03,22,6734,27.1
13131,Grady County,2021-05-04,48,6782,27.3
13131,Grady County,2021-05-05,16,6798,27.4
13131,Grady County,2021-05-06,29,6827,27.5
13131,Grady County,2021-05-07,14,6841,27.6
13131,Grady County,2021-05-08,10,6851,27.6
13131,Grady County,2021-05-09,1,6852,27.6
13131,Grady County,2021-05-10,35,6887,27.7
13131,Grady County,2021-05-11,42,6929,27.9
13131,Grady County,2021-05-12,25,6954,28
13131,Grady County,2021-05-13,26,6980,28.1
13131,Grady County,2021-05-14,37,7017,28.3
13131,Grady County,2021-05-15,9,7026,28.3
13131,Grady County,2021-05-16,8,7034,28.3
13131,Grady County,2021-05-17,28,7062,28.4
13131,Grady County,2021-05-18,34,7096,28.6
13131,Grady County,2021-05-19,36,7132,28.7
13131,Grady County,2021-05-20,33,7165,28.9
13131,Grady County,2021-05-21,37,7202,29
13131,Grady County,2021-05-22,11,7213,29.1
13131,Grady County,2021-05-24,19,7232,29.1
13131,Grady County,2021-05-25,17,7249,29.2
13131,Grady County,2021-05-26,20,7269,29.3
13131,Grady County,2021-05-27,33,7302,29.4
13131,Grady County,2021-05-28,10,7312,29.5
13131,Grady County,2021-05-29,8,7320,29.5
13131,Grady County,2021-05-30,4,7324,29.5
13131,Grady County,2021-05-31,1,7325,29.5
13131,Grady County,2021-06-01,33,7358,29.6
13131,Grady County,2021-06-02,34,7392,29.8
13131,Grady County,2021-06-03,48,7440,30
13131,Grady County,2021-06-04,24,7464,30.1
13131,Grady County,2021-06-05,9,7473,30.1
13131,Grady County,2021-06-06,2,7475,30.1
13131,Grady County,2021-06-07,8,7483,30.1
13131,Grady County,2021-06-08,12,7495,30.2
13131,Grady County,2021-06-09,9,7504,30.2
13131,Grady County,2021-06-10,31,7535,30.3
13131,Grady County,2021-06-11,19,7554,30.4
13131,Grady County,2021-06-12,3,7557,30.4
13131,Grady County,2021-06-14,8,7565,30.5
13131,Grady County,2021-06-15,26,7591,30.6
13131,Grady County,2021-06-16,17,7608,30.6
13131,Grady County,2021-06-17,10,7618,30.7
13131,Grady County,2021-06-18,16,7634,30.7
13131,Grady County,2021-06-19,8,7642,30.8
13131,Grady County,2021-06-20,2,7644,30.8
13131,Grady County,2021-06-21,8,7652,30.8
13131,Grady County,2021-06-22,13,7665,30.9
13131,Grady County,2021-06-23,20,7685,31
13131,Grady County,2021-06-24,15,7700,31
13131,Grady County,2021-06-25,20,7720,31.1
13131,Grady County,2021-06-27,3,7723,31.1
13131,Grady County,2021-06-28,5,7728,31.1
13131,Grady County,2021-06-29,24,7752,31.2
13131,Grady County,2021-06-30,11,7763,31.3
13131,Grady County,2021-07-01,12,7775,31.3
13131,Grady County,2021-07-02,13,7788,31.4
13131,Grady County,2021-07-03,6,7794,31.4
13131,Grady County,2021-07-04,1,7795,31.4
13131,Grady County,2021-07-05,10,7805,31.4
13131,Grady County,2021-07-06,17,7822,31.5
13131,Grady County,2021-07-07,3,7825,31.5
13131,Grady County,2021-07-08,15,7840,31.6
13131,Grady County,2021-07-09,13,7853,31.6
13131,Grady County,2021-07-10,6,7859,31.7
13131,Grady County,2021-07-11,6,7865,31.7
13131,Grady County,2021-07-12,10,7875,31.7
13131,Grady County,2021-07-13,28,7903,31.8
13131,Grady County,2021-07-14,16,7919,31.9
13131,Grady County,2021-07-15,16,7935,32
13131,Grady County,2021-07-16,27,7962,32.1
13131,Grady County,2021-07-17,5,7967,32.1
13131,Grady County,2021-07-18,2,7969,32.1
13131,Grady County,2021-07-19,23,7992,32.2
13131,Grady County,2021-07-20,26,8018,32.3
13131,Grady County,2021-07-21,51,8069,32.5
13131,Grady County,2021-07-22,37,8106,32.6
13131,Grady County,2021-07-23,42,8148,32.8
13131,Grady County,2021-07-24,8,8156,32.9
13131,Grady County,2021-07-25,6,8162,32.9
13131,Grady County,2021-07-26,64,8226,33.1
13131,Grady County,2021-07-27,61,8287,33.4
13131,Grady County,2021-07-28,66,8353,33.6
13131,Grady County,2021-07-29,116,8469,34.1
13131,Grady County,2021-07-30,62,8531,34.4
13131,Grady County,2021-07-31,30,8561,34.5
13131,Grady County,2021-08-01,11,8572,34.5
13131,Grady County,2021-08-02,70,8642,34.8
13131,Grady County,2021-08-03,58,8700,35
13131,Grady County,2021-08-04,123,8823,35.5
13131,Grady County,2021-08-05,83,8906,35.9
13131,Grady County,2021-08-06,59,8965,36.1
13131,Grady County,2021-08-07,33,8998,36.2
13131,Grady County,2021-08-08,19,9017,36.3
13131,Grady County,2021-08-09,84,9101,36.7
13131,Grady County,2021-08-10,59,9160,36.9
13131,Grady County,2021-08-11,109,9269,37.3
13131,Grady County,2021-08-12,97,9366,37.7
13131,Grady County,2021-08-13,78,9444,38
13131,Grady County,2021-08-14,28,9472,38.2
13131,Grady County,2021-08-15,27,9499,38.3
13131,Grady County,2021-08-16,55,9554,38.5
13131,Grady County,2021-08-17,80,9634,38.8
13131,Grady County,2021-08-18,88,9722,39.2
13131,Grady County,2021-08-19,112,9834,39.6
13131,Grady County,2021-08-20,84,9918,39.9
13131,Grady County,2021-08-21,43,9961,40.1
13131,Grady County,2021-08-22,20,9981,40.2
13131,Grady County,2021-08-23,65,10046,40.5
13131,Grady County,2021-08-24,69,10115,40.7
13131,Grady County,2021-08-25,82,10197,41.1
13131,Grady County,2021-08-26,71,10268,41.4
13131,Grady County,2021-08-27,61,10329,41.6
13131,Grady County,2021-08-28,28,10357,41.7
13131,Grady County,2021-08-29,16,10373,41.8
13131,Grady County,2021-08-30,63,10436,42
13131,Grady County,2021-08-31,68,10504,42.3
13131,Grady County,2021-09-01,85,10589,42.6
13131,Grady County,2021-09-02,50,10639,42.9
13131,Grady County,2021-09-03,40,10679,43
13131,Grady County,2021-09-04,21,10700,43.1
13131,Grady County,2021-09-05,11,10711,43.1
13131,Grady County,2021-09-07,30,10741,43.3
13131,Grady County,2021-09-08,48,10789,43.5
13131,Grady County,2021-09-09,37,10826,43.6
13131,Grady County,2021-09-10,34,10860,43.7
13131,Grady County,2021-09-11,40,10900,43.9
13131,Grady County,2021-09-12,19,10919,44
13131,Grady County,2021-09-13,29,10948,44.1
13131,Grady County,2021-09-14,35,10983,44.2
13131,Grady County,2021-09-15,38,11021,44.4
13131,Grady County,2021-09-16,22,11043,44.5
13131,Grady County,2021-09-17,27,11070,44.6
13131,Grady County,2021-09-18,8,11078,44.6
13131,Grady County,2021-09-19,10,11088,44.7
13131,Grady County,2021-09-20,18,11106,44.7
13131,Grady County,2021-09-21,23,11129,44.8
13131,Grady County,2021-09-22,14,11143,44.9
13131,Grady County,2021-09-23,24,11167,45
13131,Grady County,2021-09-24,15,11182,45
13131,Grady County,2021-09-25,6,11188,45.1
13131,Grady County,2021-09-27,15,11203,45.1
13131,Grady County,2021-09-28,13,11216,45.2
13131,Grady County,2021-09-29,13,11229,45.2
13131,Grady County,2021-09-30,10,11239,45.3
13131,Grady County,2021-10-01,6,11245,45.3
13131,Grady County,2021-10-02,5,11250,45.3
13131,Grady County,2021-10-04,7,11257,45.3
13131,Grady County,2021-10-05,6,11263,45.4
13131,Grady County,2021-10-06,11,11274,45.4
13131,Grady County,2021-10-07,8,11282,45.4
13133,Greene County,2020-12-16,1,1,0
13133,Greene County,2020-12-18,1,2,0
13133,Greene County,2020-12-19,1,3,0
13133,Greene County,2020-12-20,1,4,0
13133,Greene County,2020-12-21,3,7,0
13133,Greene County,2020-12-22,7,14,0.1
13133,Greene County,2020-12-23,27,41,0.2
13133,Greene County,2020-12-24,2,43,0.2
13133,Greene County,2020-12-26,1,44,0.3
13133,Greene County,2020-12-27,1,45,0.3
13133,Greene County,2020-12-28,16,61,0.4
13133,Greene County,2020-12-29,23,84,0.5
13133,Greene County,2020-12-30,20,104,0.6
13133,Greene County,2020-12-31,11,115,0.7
13133,Greene County,2021-01-01,3,118,0.7
13133,Greene County,2021-01-02,8,126,0.7
13133,Greene County,2021-01-03,27,153,0.9
13133,Greene County,2021-01-04,60,213,1.2
13133,Greene County,2021-01-05,33,246,1.4
13133,Greene County,2021-01-06,25,271,1.6
13133,Greene County,2021-01-07,46,317,1.8
13133,Greene County,2021-01-08,16,333,1.9
13133,Greene County,2021-01-09,5,338,1.9
13133,Greene County,2021-01-10,7,345,2
13133,Greene County,2021-01-11,62,407,2.3
13133,Greene County,2021-01-12,91,498,2.9
13133,Greene County,2021-01-13,67,565,3.3
13133,Greene County,2021-01-14,99,664,3.8
13133,Greene County,2021-01-15,80,744,4.3
13133,Greene County,2021-01-16,51,795,4.6
13133,Greene County,2021-01-17,110,905,5.2
13133,Greene County,2021-01-18,87,992,5.7
13133,Greene County,2021-01-19,165,1157,6.7
13133,Greene County,2021-01-20,61,1218,7
13133,Greene County,2021-01-21,127,1345,7.8
13133,Greene County,2021-01-22,120,1465,8.4
13133,Greene County,2021-01-23,73,1538,8.9
13133,Greene County,2021-01-24,10,1548,8.9
13133,Greene County,2021-01-25,207,1755,10.1
13133,Greene County,2021-01-26,98,1853,10.7
13133,Greene County,2021-01-27,54,1907,11
13133,Greene County,2021-01-28,108,2015,11.6
13133,Greene County,2021-01-29,123,2138,12.3
13133,Greene County,2021-01-30,17,2155,12.4
13133,Greene County,2021-01-31,14,2169,12.5
13133,Greene County,2021-02-01,149,2318,13.4
13133,Greene County,2021-02-02,44,2362,13.6
13133,Greene County,2021-02-03,56,2418,13.9
13133,Greene County,2021-02-04,53,2471,14.2
13133,Greene County,2021-02-05,54,2525,14.6
13133,Greene County,2021-02-06,15,2540,14.6
13133,Greene County,2021-02-07,21,2561,14.8
13133,Greene County,2021-02-08,130,2691,15.5
13133,Greene County,2021-02-09,42,2733,15.8
13133,Greene County,2021-02-10,48,2781,16
13133,Greene County,2021-02-11,53,2834,16.3
13133,Greene County,2021-02-12,47,2881,16.6
13133,Greene County,2021-02-13,37,2918,16.8
13133,Greene County,2021-02-14,19,2937,16.9
13133,Greene County,2021-02-15,140,3077,17.7
13133,Greene County,2021-02-16,83,3160,18.2
13133,Greene County,2021-02-17,66,3226,18.6
13133,Greene County,2021-02-18,69,3295,19
13133,Greene County,2021-02-19,28,3323,19.2
13133,Greene County,2021-02-20,3,3326,19.2
13133,Greene County,2021-02-21,4,3330,19.2
13133,Greene County,2021-02-22,50,3380,19.5
13133,Greene County,2021-02-23,36,3416,19.7
13133,Greene County,2021-02-24,33,3449,19.9
13133,Greene County,2021-02-25,54,3503,20.2
13133,Greene County,2021-02-26,37,3540,20.4
13133,Greene County,2021-02-27,97,3637,21
13133,Greene County,2021-02-28,16,3653,21.1
13133,Greene County,2021-03-01,40,3693,21.3
13133,Greene County,2021-03-02,41,3734,21.5
13133,Greene County,2021-03-03,71,3805,21.9
13133,Greene County,2021-03-04,74,3879,22.4
13133,Greene County,2021-03-05,79,3958,22.8
13133,Greene County,2021-03-06,42,4000,23.1
13133,Greene County,2021-03-07,11,4011,23.1
13133,Greene County,2021-03-08,116,4127,23.8
13133,Greene County,2021-03-09,192,4319,24.9
13133,Greene County,2021-03-10,73,4392,25.3
13133,Greene County,2021-03-11,141,4533,26.1
13133,Greene County,2021-03-12,53,4586,26.4
13133,Greene County,2021-03-13,20,4606,26.5
13133,Greene County,2021-03-14,9,4615,26.6
13133,Greene County,2021-03-15,57,4672,26.9
13133,Greene County,2021-03-16,205,4877,28.1
13133,Greene County,2021-03-17,93,4970,28.6
13133,Greene County,2021-03-18,94,5064,29.2
13133,Greene County,2021-03-19,92,5156,29.7
13133,Greene County,2021-03-20,25,5181,29.9
13133,Greene County,2021-03-21,15,5196,29.9
13133,Greene County,2021-03-22,80,5276,30.4
13133,Greene County,2021-03-23,225,5501,31.7
13133,Greene County,2021-03-24,72,5573,32.1
13133,Greene County,2021-03-25,115,5688,32.8
13133,Greene County,2021-03-26,93,5781,33.3
13133,Greene County,2021-03-27,26,5807,33.5
13133,Greene County,2021-03-28,13,5820,33.5
13133,Greene County,2021-03-29,117,5937,34.2
13133,Greene County,2021-03-30,146,6083,35.1
13133,Greene County,2021-03-31,95,6178,35.6
13133,Greene County,2021-04-01,152,6330,36.5
13133,Greene County,2021-04-02,95,6425,37
13133,Greene County,2021-04-03,15,6440,37.1
13133,Greene County,2021-04-04,19,6459,37.2
13133,Greene County,2021-04-05,88,6547,37.7
13133,Greene County,2021-04-06,121,6668,38.4
13133,Greene County,2021-04-07,85,6753,38.9
13133,Greene County,2021-04-08,94,6847,39.5
13133,Greene County,2021-04-09,59,6906,39.8
13133,Greene County,2021-04-10,25,6931,40
13133,Greene County,2021-04-11,21,6952,40.1
13133,Greene County,2021-04-12,151,7103,40.9
13133,Greene County,2021-04-13,63,7166,41.3
13133,Greene County,2021-04-14,48,7214,41.6
13133,Greene County,2021-04-15,47,7261,41.9
13133,Greene County,2021-04-16,34,7295,42
13133,Greene County,2021-04-17,16,7311,42.1
13133,Greene County,2021-04-18,4,7315,42.2
13133,Greene County,2021-04-19,39,7354,42.4
13133,Greene County,2021-04-20,27,7381,42.5
13133,Greene County,2021-04-21,27,7408,42.7
13133,Greene County,2021-04-22,33,7441,42.9
13133,Greene County,2021-04-23,41,7482,43.1
13133,Greene County,2021-04-24,1,7483,43.1
13133,Greene County,2021-04-25,2,7485,43.1
13133,Greene County,2021-04-26,31,7516,43.3
13133,Greene County,2021-04-27,35,7551,43.5
13133,Greene County,2021-04-28,44,7595,43.8
13133,Greene County,2021-04-29,39,7634,44
13133,Greene County,2021-04-30,48,7682,44.3
13133,Greene County,2021-05-01,15,7697,44.4
13133,Greene County,2021-05-02,8,7705,44.4
13133,Greene County,2021-05-03,20,7725,44.5
13133,Greene County,2021-05-04,21,7746,44.6
13133,Greene County,2021-05-05,29,7775,44.8
13133,Greene County,2021-05-06,73,7848,45.2
13133,Greene County,2021-05-07,16,7864,45.3
13133,Greene County,2021-05-08,13,7877,45.4
13133,Greene County,2021-05-09,1,7878,45.4
13133,Greene County,2021-05-10,16,7894,45.5
13133,Greene County,2021-05-11,34,7928,45.7
13133,Greene County,2021-05-12,22,7950,45.8
13133,Greene County,2021-05-13,15,7965,45.9
13133,Greene County,2021-05-14,24,7989,46
13133,Greene County,2021-05-15,14,8003,46.1
13133,Greene County,2021-05-16,9,8012,46.2
13133,Greene County,2021-05-17,22,8034,46.3
13133,Greene County,2021-05-18,38,8072,46.5
13133,Greene County,2021-05-19,21,8093,46.6
13133,Greene County,2021-05-20,14,8107,46.7
13133,Greene County,2021-05-21,13,8120,46.8
13133,Greene County,2021-05-22,9,8129,46.9
13133,Greene County,2021-05-23,4,8133,46.9
13133,Greene County,2021-05-24,31,8164,47.1
13133,Greene County,2021-05-25,22,8186,47.2
13133,Greene County,2021-05-26,14,8200,47.3
13133,Greene County,2021-05-27,11,8211,47.3
13133,Greene County,2021-05-28,8,8219,47.4
13133,Greene County,2021-05-29,9,8228,47.4
13133,Greene County,2021-05-30,5,8233,47.5
13133,Greene County,2021-05-31,5,8238,47.5
13133,Greene County,2021-06-01,16,8254,47.6
13133,Greene County,2021-06-02,16,8270,47.7
13133,Greene County,2021-06-03,16,8286,47.8
13133,Greene County,2021-06-04,17,8303,47.9
13133,Greene County,2021-06-05,18,8321,48
13133,Greene County,2021-06-06,4,8325,48
13133,Greene County,2021-06-07,10,8335,48
13133,Greene County,2021-06-08,9,8344,48.1
13133,Greene County,2021-06-09,13,8357,48.2
13133,Greene County,2021-06-10,16,8373,48.3
13133,Greene County,2021-06-11,3,8376,48.3
13133,Greene County,2021-06-12,8,8384,48.3
13133,Greene County,2021-06-13,5,8389,48.4
13133,Greene County,2021-06-14,12,8401,48.4
13133,Greene County,2021-06-15,13,8414,48.5
13133,Greene County,2021-06-16,10,8424,48.6
13133,Greene County,2021-06-17,16,8440,48.6
13133,Greene County,2021-06-18,7,8447,48.7
13133,Greene County,2021-06-19,10,8457,48.7
13133,Greene County,2021-06-20,1,8458,48.8
13133,Greene County,2021-06-21,12,8470,48.8
13133,Greene County,2021-06-22,15,8485,48.9
13133,Greene County,2021-06-23,10,8495,49
13133,Greene County,2021-06-24,14,8509,49
13133,Greene County,2021-06-25,9,8518,49.1
13133,Greene County,2021-06-26,13,8531,49.2
13133,Greene County,2021-06-27,1,8532,49.2
13133,Greene County,2021-06-28,8,8540,49.2
13133,Greene County,2021-06-29,12,8552,49.3
13133,Greene County,2021-06-30,13,8565,49.4
13133,Greene County,2021-07-01,16,8581,49.5
13133,Greene County,2021-07-02,13,8594,49.5
13133,Greene County,2021-07-03,4,8598,49.6
13133,Greene County,2021-07-05,8,8606,49.6
13133,Greene County,2021-07-06,13,8619,49.7
13133,Greene County,2021-07-07,7,8626,49.7
13133,Greene County,2021-07-08,11,8637,49.8
13133,Greene County,2021-07-09,8,8645,49.8
13133,Greene County,2021-07-10,5,8650,49.9
13133,Greene County,2021-07-11,2,8652,49.9
13133,Greene County,2021-07-12,7,8659,49.9
13133,Greene County,2021-07-13,9,8668,50
13133,Greene County,2021-07-14,5,8673,50
13133,Greene County,2021-07-15,17,8690,50.1
13133,Greene County,2021-07-16,15,8705,50.2
13133,Greene County,2021-07-17,18,8723,50.3
13133,Greene County,2021-07-18,2,8725,50.3
13133,Greene County,2021-07-19,18,8743,50.4
13133,Greene County,2021-07-20,16,8759,50.5
13133,Greene County,2021-07-21,15,8774,50.6
13133,Greene County,2021-07-22,35,8809,50.8
13133,Greene County,2021-07-23,17,8826,50.9
13133,Greene County,2021-07-24,17,8843,51
13133,Greene County,2021-07-25,2,8845,51
13133,Greene County,2021-07-26,29,8874,51.1
13133,Greene County,2021-07-27,28,8902,51.3
13133,Greene County,2021-07-28,25,8927,51.5
13133,Greene County,2021-07-29,37,8964,51.7
13133,Greene County,2021-07-30,36,9000,51.9
13133,Greene County,2021-07-31,13,9013,52
13133,Greene County,2021-08-01,6,9019,52
13133,Greene County,2021-08-02,21,9040,52.1
13133,Greene County,2021-08-03,25,9065,52.3
13133,Greene County,2021-08-04,27,9092,52.4
13133,Greene County,2021-08-05,25,9117,52.6
13133,Greene County,2021-08-06,38,9155,52.8
13133,Greene County,2021-08-07,9,9164,52.8
13133,Greene County,2021-08-08,32,9196,53
13133,Greene County,2021-08-09,31,9227,53.2
13133,Greene County,2021-08-10,24,9251,53.3
13133,Greene County,2021-08-11,45,9296,53.6
13133,Greene County,2021-08-12,18,9314,53.7
13133,Greene County,2021-08-13,34,9348,53.9
13133,Greene County,2021-08-14,16,9364,54
13133,Greene County,2021-08-15,8,9372,54
13133,Greene County,2021-08-16,24,9396,54.2
13133,Greene County,2021-08-17,32,9428,54.3
13133,Greene County,2021-08-18,25,9453,54.5
13133,Greene County,2021-08-19,34,9487,54.7
13133,Greene County,2021-08-20,30,9517,54.9
13133,Greene County,2021-08-21,15,9532,54.9
13133,Greene County,2021-08-22,19,9551,55.1
13133,Greene County,2021-08-23,23,9574,55.2
13133,Greene County,2021-08-24,42,9616,55.4
13133,Greene County,2021-08-25,20,9636,55.5
13133,Greene County,2021-08-26,27,9663,55.7
13133,Greene County,2021-08-27,36,9699,55.9
13133,Greene County,2021-08-28,16,9715,56
13133,Greene County,2021-08-29,25,9740,56.1
13133,Greene County,2021-08-30,24,9764,56.3
13133,Greene County,2021-08-31,20,9784,56.4
13133,Greene County,2021-09-01,28,9812,56.6
13133,Greene County,2021-09-02,25,9837,56.7
13133,Greene County,2021-09-03,21,9858,56.8
13133,Greene County,2021-09-04,8,9866,56.9
13133,Greene County,2021-09-05,12,9878,56.9
13133,Greene County,2021-09-07,16,9894,57
13133,Greene County,2021-09-08,27,9921,57.2
13133,Greene County,2021-09-09,22,9943,57.3
13133,Greene County,2021-09-10,19,9962,57.4
13133,Greene County,2021-09-11,9,9971,57.5
13133,Greene County,2021-09-12,8,9979,57.5
13133,Greene County,2021-09-13,21,10000,57.6
13133,Greene County,2021-09-14,15,10015,57.7
13133,Greene County,2021-09-15,20,10035,57.8
13133,Greene County,2021-09-16,17,10052,57.9
13133,Greene County,2021-09-17,17,10069,58
13133,Greene County,2021-09-18,8,10077,58.1
13133,Greene County,2021-09-19,6,10083,58.1
13133,Greene County,2021-09-20,11,10094,58.2
13133,Greene County,2021-09-21,13,10107,58.3
13133,Greene County,2021-09-22,16,10123,58.3
13133,Greene County,2021-09-23,11,10134,58.4
13133,Greene County,2021-09-24,9,10143,58.5
13133,Greene County,2021-09-25,4,10147,58.5
13133,Greene County,2021-09-26,4,10151,58.5
13133,Greene County,2021-09-27,7,10158,58.6
13133,Greene County,2021-09-28,8,10166,58.6
13133,Greene County,2021-09-29,12,10178,58.7
13133,Greene County,2021-09-30,15,10193,58.8
13133,Greene County,2021-10-01,9,10202,58.8
13133,Greene County,2021-10-02,1,10203,58.8
13133,Greene County,2021-10-03,1,10204,58.8
13133,Greene County,2021-10-04,1,10205,58.8
13133,Greene County,2021-10-05,1,10206,58.8
13133,Greene County,2021-10-06,4,10210,58.9
13133,Greene County,2021-10-07,1,10211,58.9
13135,Gwinnett County,2020-12-14,2,2,0
13135,Gwinnett County,2020-12-15,2,4,0
13135,Gwinnett County,2020-12-16,34,38,0
13135,Gwinnett County,2020-12-17,245,283,0
13135,Gwinnett County,2020-12-18,449,732,0.1
13135,Gwinnett County,2020-12-19,346,1078,0.1
13135,Gwinnett County,2020-12-20,371,1449,0.2
13135,Gwinnett County,2020-12-21,481,1930,0.2
13135,Gwinnett County,2020-12-22,756,2686,0.3
13135,Gwinnett County,2020-12-23,982,3668,0.4
13135,Gwinnett County,2020-12-24,227,3895,0.4
13135,Gwinnett County,2020-12-25,13,3908,0.4
13135,Gwinnett County,2020-12-26,140,4048,0.4
13135,Gwinnett County,2020-12-27,215,4263,0.5
13135,Gwinnett County,2020-12-28,969,5232,0.6
13135,Gwinnett County,2020-12-29,1132,6364,0.7
13135,Gwinnett County,2020-12-30,1223,7587,0.8
13135,Gwinnett County,2020-12-31,661,8248,0.9
13135,Gwinnett County,2021-01-01,183,8431,0.9
13135,Gwinnett County,2021-01-02,350,8781,1
13135,Gwinnett County,2021-01-03,275,9056,1
13135,Gwinnett County,2021-01-04,1066,10122,1.1
13135,Gwinnett County,2021-01-05,1208,11330,1.2
13135,Gwinnett County,2021-01-06,1222,12552,1.4
13135,Gwinnett County,2021-01-07,1291,13843,1.5
13135,Gwinnett County,2021-01-08,1438,15281,1.7
13135,Gwinnett County,2021-01-09,607,15888,1.7
13135,Gwinnett County,2021-01-10,287,16175,1.8
13135,Gwinnett County,2021-01-11,1209,17384,1.9
13135,Gwinnett County,2021-01-12,1210,18594,2
13135,Gwinnett County,2021-01-13,2190,20784,2.3
13135,Gwinnett County,2021-01-14,1775,22559,2.5
13135,Gwinnett County,2021-01-15,1963,24522,2.7
13135,Gwinnett County,2021-01-16,2066,26588,2.9
13135,Gwinnett County,2021-01-17,680,27268,3
13135,Gwinnett County,2021-01-18,1996,29264,3.2
13135,Gwinnett County,2021-01-19,2603,31867,3.5
13135,Gwinnett County,2021-01-20,2525,34392,3.8
13135,Gwinnett County,2021-01-21,2770,37162,4.1
13135,Gwinnett County,2021-01-22,2642,39804,4.3
13135,Gwinnett County,2021-01-23,1265,41069,4.5
13135,Gwinnett County,2021-01-24,488,41557,4.5
13135,Gwinnett County,2021-01-25,1451,43008,4.7
13135,Gwinnett County,2021-01-26,1930,44938,4.9
13135,Gwinnett County,2021-01-27,1946,46884,5.1
13135,Gwinnett County,2021-01-28,3015,49899,5.5
13135,Gwinnett County,2021-01-29,2922,52821,5.8
13135,Gwinnett County,2021-01-30,627,53448,5.8
13135,Gwinnett County,2021-01-31,206,53654,5.9
13135,Gwinnett County,2021-02-01,1188,54842,6
13135,Gwinnett County,2021-02-02,1704,56546,6.2
13135,Gwinnett County,2021-02-03,1557,58103,6.3
13135,Gwinnett County,2021-02-04,1972,60075,6.6
13135,Gwinnett County,2021-02-05,1803,61878,6.8
13135,Gwinnett County,2021-02-06,752,62630,6.8
13135,Gwinnett County,2021-02-07,197,62827,6.9
13135,Gwinnett County,2021-02-08,1802,64629,7.1
13135,Gwinnett County,2021-02-09,1716,66345,7.3
13135,Gwinnett County,2021-02-10,1666,68011,7.4
13135,Gwinnett County,2021-02-11,1966,69977,7.6
13135,Gwinnett County,2021-02-12,1545,71522,7.8
13135,Gwinnett County,2021-02-13,1289,72811,8
13135,Gwinnett County,2021-02-14,338,73149,8
13135,Gwinnett County,2021-02-15,1829,74978,8.2
13135,Gwinnett County,2021-02-16,1416,76394,8.3
13135,Gwinnett County,2021-02-17,1490,77884,8.5
13135,Gwinnett County,2021-02-18,1360,79244,8.7
13135,Gwinnett County,2021-02-19,1261,80505,8.8
13135,Gwinnett County,2021-02-20,752,81257,8.9
13135,Gwinnett County,2021-02-21,250,81507,8.9
13135,Gwinnett County,2021-02-22,1326,82833,9.1
13135,Gwinnett County,2021-02-23,1555,84388,9.2
13135,Gwinnett County,2021-02-24,1932,86320,9.4
13135,Gwinnett County,2021-02-25,1983,88303,9.7
13135,Gwinnett County,2021-02-26,2091,90394,9.9
13135,Gwinnett County,2021-02-27,1487,91881,10
13135,Gwinnett County,2021-02-28,647,92528,10.1
13135,Gwinnett County,2021-03-01,2501,95029,10.4
13135,Gwinnett County,2021-03-02,2556,97585,10.7
13135,Gwinnett County,2021-03-03,2442,100027,10.9
13135,Gwinnett County,2021-03-04,2701,102728,11.2
13135,Gwinnett County,2021-03-05,2866,105594,11.5
13135,Gwinnett County,2021-03-06,1822,107416,11.7
13135,Gwinnett County,2021-03-07,787,108203,11.8
13135,Gwinnett County,2021-03-08,3996,112199,12.3
13135,Gwinnett County,2021-03-09,4883,117082,12.8
13135,Gwinnett County,2021-03-10,4512,121594,13.3
13135,Gwinnett County,2021-03-11,4660,126254,13.8
13135,Gwinnett County,2021-03-12,4922,131176,14.3
13135,Gwinnett County,2021-03-13,2392,133568,14.6
13135,Gwinnett County,2021-03-14,1648,135216,14.8
13135,Gwinnett County,2021-03-15,4897,140113,15.3
13135,Gwinnett County,2021-03-16,6068,146181,16
13135,Gwinnett County,2021-03-17,6279,152460,16.7
13135,Gwinnett County,2021-03-18,5858,158318,17.3
13135,Gwinnett County,2021-03-19,6198,164516,18
13135,Gwinnett County,2021-03-20,4174,168690,18.4
13135,Gwinnett County,2021-03-21,1668,170358,18.6
13135,Gwinnett County,2021-03-22,6039,176397,19.3
13135,Gwinnett County,2021-03-23,6896,183293,20
13135,Gwinnett County,2021-03-24,7476,190769,20.8
13135,Gwinnett County,2021-03-25,7933,198702,21.7
13135,Gwinnett County,2021-03-26,7379,206081,22.5
13135,Gwinnett County,2021-03-27,5136,211217,23.1
13135,Gwinnett County,2021-03-28,2126,213343,23.3
13135,Gwinnett County,2021-03-29,6553,219896,24
13135,Gwinnett County,2021-03-30,8829,228725,25
13135,Gwinnett County,2021-03-31,8916,237641,26
13135,Gwinnett County,2021-04-01,7873,245514,26.8
13135,Gwinnett County,2021-04-02,6041,251555,27.5
13135,Gwinnett County,2021-04-03,3501,255056,27.9
13135,Gwinnett County,2021-04-04,1798,256854,28.1
13135,Gwinnett County,2021-04-05,5480,262334,28.7
13135,Gwinnett County,2021-04-06,7375,269709,29.5
13135,Gwinnett County,2021-04-07,8269,277978,30.4
13135,Gwinnett County,2021-04-08,7662,285640,31.2
13135,Gwinnett County,2021-04-09,7547,293187,32
13135,Gwinnett County,2021-04-10,5516,298703,32.6
13135,Gwinnett County,2021-04-11,1914,300617,32.9
13135,Gwinnett County,2021-04-12,4225,304842,33.3
13135,Gwinnett County,2021-04-13,5068,309910,33.9
13135,Gwinnett County,2021-04-14,4587,314497,34.4
13135,Gwinnett County,2021-04-15,3531,318028,34.8
13135,Gwinnett County,2021-04-16,3342,321370,35.1
13135,Gwinnett County,2021-04-17,2068,323438,35.3
13135,Gwinnett County,2021-04-18,1707,325145,35.5
13135,Gwinnett County,2021-04-19,3111,328256,35.9
13135,Gwinnett County,2021-04-20,3804,332060,36.3
13135,Gwinnett County,2021-04-21,4214,336274,36.7
13135,Gwinnett County,2021-04-22,3272,339546,37.1
13135,Gwinnett County,2021-04-23,3135,342681,37.4
13135,Gwinnett County,2021-04-24,2327,345008,37.7
13135,Gwinnett County,2021-04-25,1100,346108,37.8
13135,Gwinnett County,2021-04-26,2505,348613,38.1
13135,Gwinnett County,2021-04-27,2794,351407,38.4
13135,Gwinnett County,2021-04-28,3459,354866,38.8
13135,Gwinnett County,2021-04-29,2658,357524,39.1
13135,Gwinnett County,2021-04-30,2731,360255,39.4
13135,Gwinnett County,2021-05-01,2196,362451,39.6
13135,Gwinnett County,2021-05-02,982,363433,39.7
13135,Gwinnett County,2021-05-03,1826,365259,39.9
13135,Gwinnett County,2021-05-04,2313,367572,40.2
13135,Gwinnett County,2021-05-05,2478,370050,40.4
13135,Gwinnett County,2021-05-06,1883,371933,40.6
13135,Gwinnett County,2021-05-07,2134,374067,40.9
13135,Gwinnett County,2021-05-08,1630,375697,41.1
13135,Gwinnett County,2021-05-09,590,376287,41.1
13135,Gwinnett County,2021-05-10,1353,377640,41.3
13135,Gwinnett County,2021-05-11,1796,379436,41.5
13135,Gwinnett County,2021-05-12,1813,381249,41.7
13135,Gwinnett County,2021-05-13,2154,383403,41.9
13135,Gwinnett County,2021-05-14,2531,385934,42.2
13135,Gwinnett County,2021-05-15,2630,388564,42.5
13135,Gwinnett County,2021-05-16,1467,390031,42.6
13135,Gwinnett County,2021-05-17,2602,392633,42.9
13135,Gwinnett County,2021-05-18,2519,395152,43.2
13135,Gwinnett County,2021-05-19,2556,397708,43.5
13135,Gwinnett County,2021-05-20,1896,399604,43.7
13135,Gwinnett County,2021-05-21,2232,401836,43.9
13135,Gwinnett County,2021-05-22,2420,404256,44.2
13135,Gwinnett County,2021-05-23,1170,405426,44.3
13135,Gwinnett County,2021-05-24,1677,407103,44.5
13135,Gwinnett County,2021-05-25,1572,408675,44.7
13135,Gwinnett County,2021-05-26,1789,410464,44.9
13135,Gwinnett County,2021-05-27,1605,412069,45
13135,Gwinnett County,2021-05-28,1605,413674,45.2
13135,Gwinnett County,2021-05-29,1156,414830,45.3
13135,Gwinnett County,2021-05-30,667,415497,45.4
13135,Gwinnett County,2021-05-31,239,415736,45.4
13135,Gwinnett County,2021-06-01,1500,417236,45.6
13135,Gwinnett County,2021-06-02,1631,418867,45.8
13135,Gwinnett County,2021-06-03,1220,420087,45.9
13135,Gwinnett County,2021-06-04,1469,421556,46.1
13135,Gwinnett County,2021-06-05,1513,423069,46.2
13135,Gwinnett County,2021-06-06,750,423819,46.3
13135,Gwinnett County,2021-06-07,1137,424956,46.4
13135,Gwinnett County,2021-06-08,1153,426109,46.6
13135,Gwinnett County,2021-06-09,1199,427308,46.7
13135,Gwinnett County,2021-06-10,1047,428355,46.8
13135,Gwinnett County,2021-06-11,1101,429456,46.9
13135,Gwinnett County,2021-06-12,930,430386,47
13135,Gwinnett County,2021-06-13,401,430787,47.1
13135,Gwinnett County,2021-06-14,896,431683,47.2
13135,Gwinnett County,2021-06-15,878,432561,47.3
13135,Gwinnett County,2021-06-16,1100,433661,47.4
13135,Gwinnett County,2021-06-17,835,434496,47.5
13135,Gwinnett County,2021-06-18,997,435493,47.6
13135,Gwinnett County,2021-06-19,656,436149,47.7
13135,Gwinnett County,2021-06-20,414,436563,47.7
13135,Gwinnett County,2021-06-21,856,437419,47.8
13135,Gwinnett County,2021-06-22,896,438315,47.9
13135,Gwinnett County,2021-06-23,1058,439373,48
13135,Gwinnett County,2021-06-24,735,440108,48.1
13135,Gwinnett County,2021-06-25,1006,441114,48.2
13135,Gwinnett County,2021-06-26,774,441888,48.3
13135,Gwinnett County,2021-06-27,494,442382,48.3
13135,Gwinnett County,2021-06-28,703,443085,48.4
13135,Gwinnett County,2021-06-29,809,443894,48.5
13135,Gwinnett County,2021-06-30,984,444878,48.6
13135,Gwinnett County,2021-07-01,740,445618,48.7
13135,Gwinnett County,2021-07-02,952,446570,48.8
13135,Gwinnett County,2021-07-03,674,447244,48.9
13135,Gwinnett County,2021-07-04,43,447287,48.9
13135,Gwinnett County,2021-07-05,606,447893,48.9
13135,Gwinnett County,2021-07-06,737,448630,49
13135,Gwinnett County,2021-07-07,810,449440,49.1
13135,Gwinnett County,2021-07-08,733,450173,49.2
13135,Gwinnett County,2021-07-09,811,450984,49.3
13135,Gwinnett County,2021-07-10,740,451724,49.4
13135,Gwinnett County,2021-07-11,433,452157,49.4
13135,Gwinnett County,2021-07-12,784,452941,49.5
13135,Gwinnett County,2021-07-13,707,453648,49.6
13135,Gwinnett County,2021-07-14,866,454514,49.7
13135,Gwinnett County,2021-07-15,838,455352,49.8
13135,Gwinnett County,2021-07-16,925,456277,49.9
13135,Gwinnett County,2021-07-17,826,457103,50
13135,Gwinnett County,2021-07-18,528,457631,50
13135,Gwinnett County,2021-07-19,1062,458693,50.1
13135,Gwinnett County,2021-07-20,1033,459726,50.2
13135,Gwinnett County,2021-07-21,1296,461022,50.4
13135,Gwinnett County,2021-07-22,1082,462104,50.5
13135,Gwinnett County,2021-07-23,1305,463409,50.6
13135,Gwinnett County,2021-07-24,1110,464519,50.8
13135,Gwinnett County,2021-07-25,811,465330,50.9
13135,Gwinnett County,2021-07-26,1183,466513,51
13135,Gwinnett County,2021-07-27,1276,467789,51.1
13135,Gwinnett County,2021-07-28,1495,469284,51.3
13135,Gwinnett County,2021-07-29,1337,470621,51.4
13135,Gwinnett County,2021-07-30,1571,472192,51.6
13135,Gwinnett County,2021-07-31,1150,473342,51.7
13135,Gwinnett County,2021-08-01,870,474212,51.8
13135,Gwinnett County,2021-08-02,1561,475773,52
13135,Gwinnett County,2021-08-03,1533,477306,52.2
13135,Gwinnett County,2021-08-04,1616,478922,52.3
13135,Gwinnett County,2021-08-05,1338,480260,52.5
13135,Gwinnett County,2021-08-06,1699,481959,52.7
13135,Gwinnett County,2021-08-07,1391,483350,52.8
13135,Gwinnett County,2021-08-08,902,484252,52.9
13135,Gwinnett County,2021-08-09,1355,485607,53.1
13135,Gwinnett County,2021-08-10,1409,487016,53.2
13135,Gwinnett County,2021-08-11,1562,488578,53.4
13135,Gwinnett County,2021-08-12,1337,489915,53.5
13135,Gwinnett County,2021-08-13,1518,491433,53.7
13135,Gwinnett County,2021-08-14,1105,492538,53.8
13135,Gwinnett County,2021-08-15,702,493240,53.9
13135,Gwinnett County,2021-08-16,1114,494354,54
13135,Gwinnett County,2021-08-17,1156,495510,54.2
13135,Gwinnett County,2021-08-18,1312,496822,54.3
13135,Gwinnett County,2021-08-19,1181,498003,54.4
13135,Gwinnett County,2021-08-20,1327,499330,54.6
13135,Gwinnett County,2021-08-21,1016,500346,54.7
13135,Gwinnett County,2021-08-22,655,501001,54.8
13135,Gwinnett County,2021-08-23,1040,502041,54.9
13135,Gwinnett County,2021-08-24,1070,503111,55
13135,Gwinnett County,2021-08-25,1235,504346,55.1
13135,Gwinnett County,2021-08-26,1170,505516,55.2
13135,Gwinnett County,2021-08-27,1238,506754,55.4
13135,Gwinnett County,2021-08-28,1113,507867,55.5
13135,Gwinnett County,2021-08-29,552,508419,55.6
13135,Gwinnett County,2021-08-30,979,509398,55.7
13135,Gwinnett County,2021-08-31,1094,510492,55.8
13135,Gwinnett County,2021-09-01,1218,511710,55.9
13135,Gwinnett County,2021-09-02,1024,512734,56
13135,Gwinnett County,2021-09-03,1212,513946,56.2
13135,Gwinnett County,2021-09-04,832,514778,56.3
13135,Gwinnett County,2021-09-05,608,515386,56.3
13135,Gwinnett County,2021-09-06,148,515534,56.3
13135,Gwinnett County,2021-09-07,864,516398,56.4
13135,Gwinnett County,2021-09-08,1002,517400,56.5
13135,Gwinnett County,2021-09-09,886,518286,56.6
13135,Gwinnett County,2021-09-10,1043,519329,56.8
13135,Gwinnett County,2021-09-11,796,520125,56.8
13135,Gwinnett County,2021-09-12,562,520687,56.9
13135,Gwinnett County,2021-09-13,857,521544,57
13135,Gwinnett County,2021-09-14,785,522329,57.1
13135,Gwinnett County,2021-09-15,768,523097,57.2
13135,Gwinnett County,2021-09-16,692,523789,57.2
13135,Gwinnett County,2021-09-17,770,524559,57.3
13135,Gwinnett County,2021-09-18,620,525179,57.4
13135,Gwinnett County,2021-09-19,384,525563,57.4
13135,Gwinnett County,2021-09-20,572,526135,57.5
13135,Gwinnett County,2021-09-21,591,526726,57.6
13135,Gwinnett County,2021-09-22,605,527331,57.6
13135,Gwinnett County,2021-09-23,459,527790,57.7
13135,Gwinnett County,2021-09-24,485,528275,57.7
13135,Gwinnett County,2021-09-25,382,528657,57.8
13135,Gwinnett County,2021-09-26,190,528847,57.8
13135,Gwinnett County,2021-09-27,292,529139,57.8
13135,Gwinnett County,2021-09-28,339,529478,57.9
13135,Gwinnett County,2021-09-29,357,529835,57.9
13135,Gwinnett County,2021-09-30,353,530188,57.9
13135,Gwinnett County,2021-10-01,353,530541,58
13135,Gwinnett County,2021-10-02,242,530783,58
13135,Gwinnett County,2021-10-03,146,530929,58
13135,Gwinnett County,2021-10-04,190,531119,58
13135,Gwinnett County,2021-10-05,212,531331,58.1
13135,Gwinnett County,2021-10-06,259,531590,58.1
13135,Gwinnett County,2021-10-07,145,531735,58.1
13137,Habersham County,2020-12-16,2,2,0
13137,Habersham County,2020-12-17,2,4,0
13137,Habersham County,2020-12-18,9,13,0
13137,Habersham County,2020-12-19,5,18,0
13137,Habersham County,2020-12-20,6,24,0.1
13137,Habersham County,2020-12-21,12,36,0.1
13137,Habersham County,2020-12-22,32,68,0.2
13137,Habersham County,2020-12-23,58,126,0.3
13137,Habersham County,2020-12-24,4,130,0.3
13137,Habersham County,2020-12-26,4,134,0.3
13137,Habersham County,2020-12-27,2,136,0.3
13137,Habersham County,2020-12-28,59,195,0.4
13137,Habersham County,2020-12-29,85,280,0.6
13137,Habersham County,2020-12-30,78,358,0.8
13137,Habersham County,2020-12-31,12,370,0.8
13137,Habersham County,2021-01-01,8,378,0.8
13137,Habersham County,2021-01-02,2,380,0.9
13137,Habersham County,2021-01-03,2,382,0.9
13137,Habersham County,2021-01-04,49,431,1
13137,Habersham County,2021-01-05,64,495,1.1
13137,Habersham County,2021-01-06,51,546,1.2
13137,Habersham County,2021-01-07,36,582,1.3
13137,Habersham County,2021-01-08,31,613,1.4
13137,Habersham County,2021-01-09,5,618,1.4
13137,Habersham County,2021-01-10,16,634,1.4
13137,Habersham County,2021-01-11,118,752,1.7
13137,Habersham County,2021-01-12,166,918,2.1
13137,Habersham County,2021-01-13,247,1165,2.6
13137,Habersham County,2021-01-14,422,1587,3.6
13137,Habersham County,2021-01-15,300,1887,4.2
13137,Habersham County,2021-01-16,99,1986,4.5
13137,Habersham County,2021-01-17,29,2015,4.5
13137,Habersham County,2021-01-18,177,2192,4.9
13137,Habersham County,2021-01-19,227,2419,5.4
13137,Habersham County,2021-01-20,189,2608,5.8
13137,Habersham County,2021-01-21,170,2778,6.2
13137,Habersham County,2021-01-22,150,2928,6.6
13137,Habersham County,2021-01-23,55,2983,6.7
13137,Habersham County,2021-01-24,44,3027,6.8
13137,Habersham County,2021-01-25,129,3156,7.1
13137,Habersham County,2021-01-26,205,3361,7.5
13137,Habersham County,2021-01-27,178,3539,7.9
13137,Habersham County,2021-01-28,134,3673,8.2
13137,Habersham County,2021-01-29,114,3787,8.5
13137,Habersham County,2021-01-30,33,3820,8.6
13137,Habersham County,2021-01-31,11,3831,8.6
13137,Habersham County,2021-02-01,67,3898,8.7
13137,Habersham County,2021-02-02,98,3996,9
13137,Habersham County,2021-02-03,195,4191,9.4
13137,Habersham County,2021-02-04,109,4300,9.6
13137,Habersham County,2021-02-05,95,4395,9.8
13137,Habersham County,2021-02-06,25,4420,9.9
13137,Habersham County,2021-02-07,2,4422,9.9
13137,Habersham County,2021-02-08,90,4512,10.1
13137,Habersham County,2021-02-09,116,4628,10.4
13137,Habersham County,2021-02-10,69,4697,10.5
13137,Habersham County,2021-02-11,33,4730,10.6
13137,Habersham County,2021-02-12,37,4767,10.7
13137,Habersham County,2021-02-13,7,4774,10.7
13137,Habersham County,2021-02-14,12,4786,10.7
13137,Habersham County,2021-02-15,62,4848,10.9
13137,Habersham County,2021-02-16,63,4911,11
13137,Habersham County,2021-02-17,48,4959,11.1
13137,Habersham County,2021-02-18,43,5002,11.2
13137,Habersham County,2021-02-19,61,5063,11.3
13137,Habersham County,2021-02-20,1,5064,11.3
13137,Habersham County,2021-02-21,2,5066,11.4
13137,Habersham County,2021-02-22,156,5222,11.7
13137,Habersham County,2021-02-23,121,5343,12
13137,Habersham County,2021-02-24,130,5473,12.3
13137,Habersham County,2021-02-25,105,5578,12.5
13137,Habersham County,2021-02-26,119,5697,12.8
13137,Habersham County,2021-02-27,22,5719,12.8
13137,Habersham County,2021-02-28,35,5754,12.9
13137,Habersham County,2021-03-01,147,5901,13.2
13137,Habersham County,2021-03-02,164,6065,13.6
13137,Habersham County,2021-03-03,160,6225,13.9
13137,Habersham County,2021-03-04,116,6341,14.2
13137,Habersham County,2021-03-05,102,6443,14.4
13137,Habersham County,2021-03-06,13,6456,14.5
13137,Habersham County,2021-03-07,33,6489,14.5
13137,Habersham County,2021-03-08,150,6639,14.9
13137,Habersham County,2021-03-09,109,6748,15.1
13137,Habersham County,2021-03-10,167,6915,15.5
13137,Habersham County,2021-03-11,345,7260,16.3
13137,Habersham County,2021-03-12,203,7463,16.7
13137,Habersham County,2021-03-13,57,7520,16.9
13137,Habersham County,2021-03-14,42,7562,16.9
13137,Habersham County,2021-03-15,221,7783,17.4
13137,Habersham County,2021-03-16,223,8006,17.9
13137,Habersham County,2021-03-17,217,8223,18.4
13137,Habersham County,2021-03-18,201,8424,18.9
13137,Habersham County,2021-03-19,144,8568,19.2
13137,Habersham County,2021-03-20,42,8610,19.3
13137,Habersham County,2021-03-21,62,8672,19.4
13137,Habersham County,2021-03-22,138,8810,19.7
13137,Habersham County,2021-03-23,150,8960,20.1
13137,Habersham County,2021-03-24,188,9148,20.5
13137,Habersham County,2021-03-25,248,9396,21.1
13137,Habersham County,2021-03-26,164,9560,21.4
13137,Habersham County,2021-03-27,53,9613,21.5
13137,Habersham County,2021-03-28,29,9642,21.6
13137,Habersham County,2021-03-29,209,9851,22.1
13137,Habersham County,2021-03-30,216,10067,22.6
13137,Habersham County,2021-03-31,194,10261,23
13137,Habersham County,2021-04-01,186,10447,23.4
13137,Habersham County,2021-04-02,189,10636,23.8
13137,Habersham County,2021-04-03,46,10682,23.9
13137,Habersham County,2021-04-04,24,10706,24
13137,Habersham County,2021-04-05,155,10861,24.3
13137,Habersham County,2021-04-06,121,10982,24.6
13137,Habersham County,2021-04-07,160,11142,25
13137,Habersham County,2021-04-08,134,11276,25.3
13137,Habersham County,2021-04-09,186,11462,25.7
13137,Habersham County,2021-04-10,45,11507,25.8
13137,Habersham County,2021-04-11,23,11530,25.8
13137,Habersham County,2021-04-12,142,11672,26.2
13137,Habersham County,2021-04-13,80,11752,26.3
13137,Habersham County,2021-04-14,95,11847,26.5
13137,Habersham County,2021-04-15,71,11918,26.7
13137,Habersham County,2021-04-16,114,12032,27
13137,Habersham County,2021-04-17,42,12074,27.1
13137,Habersham County,2021-04-18,18,12092,27.1
13137,Habersham County,2021-04-19,73,12165,27.3
13137,Habersham County,2021-04-20,61,12226,27.4
13137,Habersham County,2021-04-21,234,12460,27.9
13137,Habersham County,2021-04-22,67,12527,28.1
13137,Habersham County,2021-04-23,277,12804,28.7
13137,Habersham County,2021-04-24,25,12829,28.7
13137,Habersham County,2021-04-25,9,12838,28.8
13137,Habersham County,2021-04-26,55,12893,28.9
13137,Habersham County,2021-04-27,63,12956,29
13137,Habersham County,2021-04-28,77,13033,29.2
13137,Habersham County,2021-04-29,63,13096,29.3
13137,Habersham County,2021-04-30,115,13211,29.6
13137,Habersham County,2021-05-01,25,13236,29.7
13137,Habersham County,2021-05-02,9,13245,29.7
13137,Habersham County,2021-05-03,59,13304,29.8
13137,Habersham County,2021-05-04,43,13347,29.9
13137,Habersham County,2021-05-05,59,13406,30
13137,Habersham County,2021-05-06,55,13461,30.2
13137,Habersham County,2021-05-07,53,13514,30.3
13137,Habersham County,2021-05-08,22,13536,30.3
13137,Habersham County,2021-05-09,18,13554,30.4
13137,Habersham County,2021-05-10,27,13581,30.4
13137,Habersham County,2021-05-11,43,13624,30.5
13137,Habersham County,2021-05-12,44,13668,30.6
13137,Habersham County,2021-05-13,60,13728,30.8
13137,Habersham County,2021-05-14,74,13802,30.9
13137,Habersham County,2021-05-15,41,13843,31
13137,Habersham County,2021-05-16,26,13869,31.1
13137,Habersham County,2021-05-17,51,13920,31.2
13137,Habersham County,2021-05-18,71,13991,31.4
13137,Habersham County,2021-05-19,120,14111,31.6
13137,Habersham County,2021-05-20,53,14164,31.7
13137,Habersham County,2021-05-21,79,14243,31.9
13137,Habersham County,2021-05-22,19,14262,32
13137,Habersham County,2021-05-23,19,14281,32
13137,Habersham County,2021-05-24,34,14315,32.1
13137,Habersham County,2021-05-25,41,14356,32.2
13137,Habersham County,2021-05-26,49,14405,32.3
13137,Habersham County,2021-05-27,41,14446,32.4
13137,Habersham County,2021-05-28,51,14497,32.5
13137,Habersham County,2021-05-29,17,14514,32.5
13137,Habersham County,2021-05-30,15,14529,32.6
13137,Habersham County,2021-05-31,9,14538,32.6
13137,Habersham County,2021-06-01,19,14557,32.6
13137,Habersham County,2021-06-02,32,14589,32.7
13137,Habersham County,2021-06-03,31,14620,32.8
13137,Habersham County,2021-06-04,36,14656,32.8
13137,Habersham County,2021-06-05,20,14676,32.9
13137,Habersham County,2021-06-06,8,14684,32.9
13137,Habersham County,2021-06-07,16,14700,32.9
13137,Habersham County,2021-06-08,15,14715,33
13137,Habersham County,2021-06-09,26,14741,33
13137,Habersham County,2021-06-10,19,14760,33.1
13137,Habersham County,2021-06-11,45,14805,33.2
13137,Habersham County,2021-06-12,15,14820,33.2
13137,Habersham County,2021-06-13,5,14825,33.2
13137,Habersham County,2021-06-14,18,14843,33.3
13137,Habersham County,2021-06-15,20,14863,33.3
13137,Habersham County,2021-06-16,21,14884,33.4
13137,Habersham County,2021-06-17,16,14900,33.4
13137,Habersham County,2021-06-18,14,14914,33.4
13137,Habersham County,2021-06-19,11,14925,33.4
13137,Habersham County,2021-06-20,4,14929,33.5
13137,Habersham County,2021-06-21,19,14948,33.5
13137,Habersham County,2021-06-22,43,14991,33.6
13137,Habersham County,2021-06-23,22,15013,33.6
13137,Habersham County,2021-06-24,19,15032,33.7
13137,Habersham County,2021-06-25,40,15072,33.8
13137,Habersham County,2021-06-26,16,15088,33.8
13137,Habersham County,2021-06-27,3,15091,33.8
13137,Habersham County,2021-06-28,21,15112,33.9
13137,Habersham County,2021-06-29,16,15128,33.9
13137,Habersham County,2021-06-30,28,15156,34
13137,Habersham County,2021-07-01,11,15167,34
13137,Habersham County,2021-07-02,27,15194,34
13137,Habersham County,2021-07-03,5,15199,34.1
13137,Habersham County,2021-07-04,2,15201,34.1
13137,Habersham County,2021-07-05,17,15218,34.1
13137,Habersham County,2021-07-06,21,15239,34.1
13137,Habersham County,2021-07-07,19,15258,34.2
13137,Habersham County,2021-07-08,24,15282,34.2
13137,Habersham County,2021-07-09,19,15301,34.3
13137,Habersham County,2021-07-10,14,15315,34.3
13137,Habersham County,2021-07-11,6,15321,34.3
13137,Habersham County,2021-07-12,21,15342,34.4
13137,Habersham County,2021-07-13,14,15356,34.4
13137,Habersham County,2021-07-14,11,15367,34.4
13137,Habersham County,2021-07-15,17,15384,34.5
13137,Habersham County,2021-07-16,28,15412,34.5
13137,Habersham County,2021-07-17,17,15429,34.6
13137,Habersham County,2021-07-18,9,15438,34.6
13137,Habersham County,2021-07-19,16,15454,34.6
13137,Habersham County,2021-07-20,25,15479,34.7
13137,Habersham County,2021-07-21,43,15522,34.8
13137,Habersham County,2021-07-22,23,15545,34.8
13137,Habersham County,2021-07-23,53,15598,35
13137,Habersham County,2021-07-24,27,15625,35
13137,Habersham County,2021-07-25,13,15638,35
13137,Habersham County,2021-07-26,37,15675,35.1
13137,Habersham County,2021-07-27,41,15716,35.2
13137,Habersham County,2021-07-28,58,15774,35.3
13137,Habersham County,2021-07-29,45,15819,35.4
13137,Habersham County,2021-07-30,66,15885,35.6
13137,Habersham County,2021-07-31,28,15913,35.7
13137,Habersham County,2021-08-01,39,15952,35.7
13137,Habersham County,2021-08-02,59,16011,35.9
13137,Habersham County,2021-08-03,63,16074,36
13137,Habersham County,2021-08-04,93,16167,36.2
13137,Habersham County,2021-08-05,58,16225,36.4
13137,Habersham County,2021-08-06,89,16314,36.6
13137,Habersham County,2021-08-07,46,16360,36.7
13137,Habersham County,2021-08-08,20,16380,36.7
13137,Habersham County,2021-08-09,53,16433,36.8
13137,Habersham County,2021-08-10,69,16502,37
13137,Habersham County,2021-08-11,65,16567,37.1
13137,Habersham County,2021-08-12,58,16625,37.3
13137,Habersham County,2021-08-13,94,16719,37.5
13137,Habersham County,2021-08-14,46,16765,37.6
13137,Habersham County,2021-08-15,30,16795,37.6
13137,Habersham County,2021-08-16,76,16871,37.8
13137,Habersham County,2021-08-17,72,16943,38
13137,Habersham County,2021-08-18,85,17028,38.2
13137,Habersham County,2021-08-19,72,17100,38.3
13137,Habersham County,2021-08-20,127,17227,38.6
13137,Habersham County,2021-08-21,64,17291,38.7
13137,Habersham County,2021-08-22,32,17323,38.8
13137,Habersham County,2021-08-23,66,17389,39
13137,Habersham County,2021-08-24,93,17482,39.2
13137,Habersham County,2021-08-25,93,17575,39.4
13137,Habersham County,2021-08-26,102,17677,39.6
13137,Habersham County,2021-08-27,182,17859,40
13137,Habersham County,2021-08-28,68,17927,40.2
13137,Habersham County,2021-08-29,49,17976,40.3
13137,Habersham County,2021-08-30,69,18045,40.4
13137,Habersham County,2021-08-31,85,18130,40.6
13137,Habersham County,2021-09-01,87,18217,40.8
13137,Habersham County,2021-09-02,68,18285,41
13137,Habersham County,2021-09-03,120,18405,41.2
13137,Habersham County,2021-09-04,61,18466,41.4
13137,Habersham County,2021-09-05,23,18489,41.4
13137,Habersham County,2021-09-06,12,18501,41.5
13137,Habersham County,2021-09-07,53,18554,41.6
13137,Habersham County,2021-09-08,74,18628,41.7
13137,Habersham County,2021-09-09,83,18711,41.9
13137,Habersham County,2021-09-10,87,18798,42.1
13137,Habersham County,2021-09-11,37,18835,42.2
13137,Habersham County,2021-09-12,19,18854,42.2
13137,Habersham County,2021-09-13,43,18897,42.3
13137,Habersham County,2021-09-14,34,18931,42.4
13137,Habersham County,2021-09-15,44,18975,42.5
13137,Habersham County,2021-09-16,45,19020,42.6
13137,Habersham County,2021-09-17,47,19067,42.7
13137,Habersham County,2021-09-18,18,19085,42.8
13137,Habersham County,2021-09-19,11,19096,42.8
13137,Habersham County,2021-09-20,25,19121,42.8
13137,Habersham County,2021-09-21,36,19157,42.9
13137,Habersham County,2021-09-22,36,19193,43
13137,Habersham County,2021-09-23,16,19209,43
13137,Habersham County,2021-09-24,30,19239,43.1
13137,Habersham County,2021-09-25,22,19261,43.2
13137,Habersham County,2021-09-26,8,19269,43.2
13137,Habersham County,2021-09-27,17,19286,43.2
13137,Habersham County,2021-09-28,14,19300,43.2
13137,Habersham County,2021-09-29,20,19320,43.3
13137,Habersham County,2021-09-30,18,19338,43.3
13137,Habersham County,2021-10-01,36,19374,43.4
13137,Habersham County,2021-10-02,8,19382,43.4
13137,Habersham County,2021-10-03,4,19386,43.4
13137,Habersham County,2021-10-04,10,19396,43.5
13137,Habersham County,2021-10-05,12,19408,43.5
13137,Habersham County,2021-10-06,9,19417,43.5
13137,Habersham County,2021-10-07,6,19423,43.5
13139,Hall County,2020-12-12,1,1,0
13139,Hall County,2020-12-14,1,2,0
13139,Hall County,2020-12-15,1,3,0
13139,Hall County,2020-12-16,5,8,0
13139,Hall County,2020-12-17,13,21,0
13139,Hall County,2020-12-18,145,166,0.1
13139,Hall County,2020-12-19,60,226,0.1
13139,Hall County,2020-12-20,63,289,0.1
13139,Hall County,2020-12-21,176,465,0.2
13139,Hall County,2020-12-22,233,698,0.4
13139,Hall County,2020-12-23,291,989,0.5
13139,Hall County,2020-12-24,20,1009,0.5
13139,Hall County,2020-12-26,38,1047,0.5
13139,Hall County,2020-12-27,38,1085,0.5
13139,Hall County,2020-12-28,338,1423,0.7
13139,Hall County,2020-12-29,333,1756,0.9
13139,Hall County,2020-12-30,221,1977,1
13139,Hall County,2020-12-31,153,2130,1.1
13139,Hall County,2021-01-01,138,2268,1.1
13139,Hall County,2021-01-02,9,2277,1.1
13139,Hall County,2021-01-03,22,2299,1.2
13139,Hall County,2021-01-04,182,2481,1.2
13139,Hall County,2021-01-05,180,2661,1.3
13139,Hall County,2021-01-06,189,2850,1.4
13139,Hall County,2021-01-07,225,3075,1.5
13139,Hall County,2021-01-08,136,3211,1.6
13139,Hall County,2021-01-09,46,3257,1.6
13139,Hall County,2021-01-10,27,3284,1.7
13139,Hall County,2021-01-11,595,3879,2
13139,Hall County,2021-01-12,323,4202,2.1
13139,Hall County,2021-01-13,445,4647,2.3
13139,Hall County,2021-01-14,765,5412,2.7
13139,Hall County,2021-01-15,539,5951,3
13139,Hall County,2021-01-16,909,6860,3.5
13139,Hall County,2021-01-17,291,7151,3.6
13139,Hall County,2021-01-18,896,8047,4.1
13139,Hall County,2021-01-19,915,8962,4.5
13139,Hall County,2021-01-20,650,9612,4.8
13139,Hall County,2021-01-21,348,9960,5
13139,Hall County,2021-01-22,762,10722,5.4
13139,Hall County,2021-01-23,688,11410,5.7
13139,Hall County,2021-01-24,153,11563,5.8
13139,Hall County,2021-01-25,616,12179,6.1
13139,Hall County,2021-01-26,611,12790,6.4
13139,Hall County,2021-01-27,1132,13922,7
13139,Hall County,2021-01-28,488,14410,7.3
13139,Hall County,2021-01-29,685,15095,7.6
13139,Hall County,2021-01-30,640,15735,7.9
13139,Hall County,2021-01-31,12,15747,7.9
13139,Hall County,2021-02-01,251,15998,8.1
13139,Hall County,2021-02-02,464,16462,8.3
13139,Hall County,2021-02-03,464,16926,8.5
13139,Hall County,2021-02-04,444,17370,8.7
13139,Hall County,2021-02-05,358,17728,8.9
13139,Hall County,2021-02-06,382,18110,9.1
13139,Hall County,2021-02-07,13,18123,9.1
13139,Hall County,2021-02-08,322,18445,9.3
13139,Hall County,2021-02-09,310,18755,9.4
13139,Hall County,2021-02-10,315,19070,9.6
13139,Hall County,2021-02-11,207,19277,9.7
13139,Hall County,2021-02-12,168,19445,9.8
13139,Hall County,2021-02-13,277,19722,9.9
13139,Hall County,2021-02-14,117,19839,10
13139,Hall County,2021-02-15,179,20018,10.1
13139,Hall County,2021-02-16,249,20267,10.2
13139,Hall County,2021-02-17,158,20425,10.3
13139,Hall County,2021-02-18,114,20539,10.3
13139,Hall County,2021-02-19,126,20665,10.4
13139,Hall County,2021-02-20,72,20737,10.4
13139,Hall County,2021-02-21,47,20784,10.5
13139,Hall County,2021-02-22,232,21016,10.6
13139,Hall County,2021-02-23,354,21370,10.8
13139,Hall County,2021-02-24,352,21722,10.9
13139,Hall County,2021-02-25,386,22108,11.1
13139,Hall County,2021-02-26,338,22446,11.3
13139,Hall County,2021-02-27,124,22570,11.4
13139,Hall County,2021-02-28,153,22723,11.4
13139,Hall County,2021-03-01,359,23082,11.6
13139,Hall County,2021-03-02,432,23514,11.8
13139,Hall County,2021-03-03,377,23891,12
13139,Hall County,2021-03-04,475,24366,12.3
13139,Hall County,2021-03-05,482,24848,12.5
13139,Hall County,2021-03-06,306,25154,12.7
13139,Hall County,2021-03-07,323,25477,12.8
13139,Hall County,2021-03-08,478,25955,13.1
13139,Hall County,2021-03-09,760,26715,13.4
13139,Hall County,2021-03-10,936,27651,13.9
13139,Hall County,2021-03-11,1156,28807,14.5
13139,Hall County,2021-03-12,1121,29928,15.1
13139,Hall County,2021-03-13,1071,30999,15.6
13139,Hall County,2021-03-14,96,31095,15.7
13139,Hall County,2021-03-15,783,31878,16
13139,Hall County,2021-03-16,1134,33012,16.6
13139,Hall County,2021-03-17,1062,34074,17.2
13139,Hall County,2021-03-18,892,34966,17.6
13139,Hall County,2021-03-19,583,35549,17.9
13139,Hall County,2021-03-20,606,36155,18.2
13139,Hall County,2021-03-21,527,36682,18.5
13139,Hall County,2021-03-22,553,37235,18.7
13139,Hall County,2021-03-23,851,38086,19.2
13139,Hall County,2021-03-24,1116,39202,19.7
13139,Hall County,2021-03-25,1268,40470,20.4
13139,Hall County,2021-03-26,777,41247,20.8
13139,Hall County,2021-03-27,651,41898,21.1
13139,Hall County,2021-03-28,147,42045,21.2
13139,Hall County,2021-03-29,698,42743,21.5
13139,Hall County,2021-03-30,1381,44124,22.2
13139,Hall County,2021-03-31,1291,45415,22.9
13139,Hall County,2021-04-01,916,46331,23.3
13139,Hall County,2021-04-02,925,47256,23.8
13139,Hall County,2021-04-03,500,47756,24
13139,Hall County,2021-04-04,215,47971,24.1
13139,Hall County,2021-04-05,750,48721,24.5
13139,Hall County,2021-04-06,988,49709,25
13139,Hall County,2021-04-07,1081,50790,25.6
13139,Hall County,2021-04-08,959,51749,26
13139,Hall County,2021-04-09,1197,52946,26.7
13139,Hall County,2021-04-10,498,53444,26.9
13139,Hall County,2021-04-11,259,53703,27
13139,Hall County,2021-04-12,458,54161,27.3
13139,Hall County,2021-04-13,693,54854,27.6
13139,Hall County,2021-04-14,670,55524,27.9
13139,Hall County,2021-04-15,666,56190,28.3
13139,Hall County,2021-04-16,712,56902,28.6
13139,Hall County,2021-04-17,197,57099,28.7
13139,Hall County,2021-04-18,164,57263,28.8
13139,Hall County,2021-04-19,305,57568,29
13139,Hall County,2021-04-20,633,58201,29.3
13139,Hall County,2021-04-21,464,58665,29.5
13139,Hall County,2021-04-22,562,59227,29.8
13139,Hall County,2021-04-23,512,59739,30.1
13139,Hall County,2021-04-24,362,60101,30.3
13139,Hall County,2021-04-25,155,60256,30.3
13139,Hall County,2021-04-26,316,60572,30.5
13139,Hall County,2021-04-27,554,61126,30.8
13139,Hall County,2021-04-28,616,61742,31.1
13139,Hall County,2021-04-29,509,62251,31.3
13139,Hall County,2021-04-30,703,62954,31.7
13139,Hall County,2021-05-01,327,63281,31.9
13139,Hall County,2021-05-02,124,63405,31.9
13139,Hall County,2021-05-03,279,63684,32.1
13139,Hall County,2021-05-04,539,64223,32.3
13139,Hall County,2021-05-05,434,64657,32.5
13139,Hall County,2021-05-06,374,65031,32.7
13139,Hall County,2021-05-07,385,65416,32.9
13139,Hall County,2021-05-08,184,65600,33
13139,Hall County,2021-05-09,64,65664,33.1
13139,Hall County,2021-05-10,158,65822,33.1
13139,Hall County,2021-05-11,295,66117,33.3
13139,Hall County,2021-05-12,254,66371,33.4
13139,Hall County,2021-05-13,348,66719,33.6
13139,Hall County,2021-05-14,412,67131,33.8
13139,Hall County,2021-05-15,360,67491,34
13139,Hall County,2021-05-16,151,67642,34
13139,Hall County,2021-05-17,322,67964,34.2
13139,Hall County,2021-05-18,432,68396,34.4
13139,Hall County,2021-05-19,336,68732,34.6
13139,Hall County,2021-05-20,322,69054,34.8
13139,Hall County,2021-05-21,359,69413,34.9
13139,Hall County,2021-05-22,220,69633,35.1
13139,Hall County,2021-05-23,177,69810,35.1
13139,Hall County,2021-05-24,241,70051,35.3
13139,Hall County,2021-05-25,243,70294,35.4
13139,Hall County,2021-05-26,246,70540,35.5
13139,Hall County,2021-05-27,328,70868,35.7
13139,Hall County,2021-05-28,291,71159,35.8
13139,Hall County,2021-05-29,127,71286,35.9
13139,Hall County,2021-05-30,89,71375,35.9
13139,Hall County,2021-05-31,42,71417,35.9
13139,Hall County,2021-06-01,221,71638,36.1
13139,Hall County,2021-06-02,173,71811,36.1
13139,Hall County,2021-06-03,237,72048,36.3
13139,Hall County,2021-06-04,234,72282,36.4
13139,Hall County,2021-06-05,129,72411,36.4
13139,Hall County,2021-06-06,177,72588,36.5
13139,Hall County,2021-06-07,154,72742,36.6
13139,Hall County,2021-06-08,167,72909,36.7
13139,Hall County,2021-06-09,164,73073,36.8
13139,Hall County,2021-06-10,174,73247,36.9
13139,Hall County,2021-06-11,201,73448,37
13139,Hall County,2021-06-12,93,73541,37
13139,Hall County,2021-06-13,44,73585,37
13139,Hall County,2021-06-14,113,73698,37.1
13139,Hall County,2021-06-15,155,73853,37.2
13139,Hall County,2021-06-16,129,73982,37.2
13139,Hall County,2021-06-17,147,74129,37.3
13139,Hall County,2021-06-18,158,74287,37.4
13139,Hall County,2021-06-19,94,74381,37.4
13139,Hall County,2021-06-20,70,74451,37.5
13139,Hall County,2021-06-21,109,74560,37.5
13139,Hall County,2021-06-22,135,74695,37.6
13139,Hall County,2021-06-23,146,74841,37.7
13139,Hall County,2021-06-24,212,75053,37.8
13139,Hall County,2021-06-25,168,75221,37.9
13139,Hall County,2021-06-26,97,75318,37.9
13139,Hall County,2021-06-27,73,75391,37.9
13139,Hall County,2021-06-28,111,75502,38
13139,Hall County,2021-06-29,128,75630,38.1
13139,Hall County,2021-06-30,138,75768,38.1
13139,Hall County,2021-07-01,119,75887,38.2
13139,Hall County,2021-07-02,200,76087,38.3
13139,Hall County,2021-07-03,69,76156,38.3
13139,Hall County,2021-07-04,15,76171,38.3
13139,Hall County,2021-07-05,77,76248,38.4
13139,Hall County,2021-07-06,91,76339,38.4
13139,Hall County,2021-07-07,117,76456,38.5
13139,Hall County,2021-07-08,121,76577,38.5
13139,Hall County,2021-07-09,134,76711,38.6
13139,Hall County,2021-07-10,96,76807,38.7
13139,Hall County,2021-07-11,78,76885,38.7
13139,Hall County,2021-07-12,100,76985,38.8
13139,Hall County,2021-07-13,112,77097,38.8
13139,Hall County,2021-07-14,140,77237,38.9
13139,Hall County,2021-07-15,140,77377,38.9
13139,Hall County,2021-07-16,159,77536,39
13139,Hall County,2021-07-17,101,77637,39.1
13139,Hall County,2021-07-18,226,77863,39.2
13139,Hall County,2021-07-19,140,78003,39.3
13139,Hall County,2021-07-20,204,78207,39.4
13139,Hall County,2021-07-21,202,78409,39.5
13139,Hall County,2021-07-22,215,78624,39.6
13139,Hall County,2021-07-23,287,78911,39.7
13139,Hall County,2021-07-24,184,79095,39.8
13139,Hall County,2021-07-25,140,79235,39.9
13139,Hall County,2021-07-26,256,79491,40
13139,Hall County,2021-07-27,239,79730,40.1
13139,Hall County,2021-07-28,318,80048,40.3
13139,Hall County,2021-07-29,297,80345,40.4
13139,Hall County,2021-07-30,421,80766,40.7
13139,Hall County,2021-07-31,246,81012,40.8
13139,Hall County,2021-08-01,156,81168,40.9
13139,Hall County,2021-08-02,304,81472,41
13139,Hall County,2021-08-03,364,81836,41.2
13139,Hall County,2021-08-04,354,82190,41.4
13139,Hall County,2021-08-05,374,82564,41.6
13139,Hall County,2021-08-06,382,82946,41.8
13139,Hall County,2021-08-07,334,83280,41.9
13139,Hall County,2021-08-08,228,83508,42
13139,Hall County,2021-08-09,309,83817,42.2
13139,Hall County,2021-08-10,350,84167,42.4
13139,Hall County,2021-08-11,292,84459,42.5
13139,Hall County,2021-08-12,323,84782,42.7
13139,Hall County,2021-08-13,404,85186,42.9
13139,Hall County,2021-08-14,228,85414,43
13139,Hall County,2021-08-15,181,85595,43.1
13139,Hall County,2021-08-16,269,85864,43.2
13139,Hall County,2021-08-17,325,86189,43.4
13139,Hall County,2021-08-18,265,86454,43.5
13139,Hall County,2021-08-19,328,86782,43.7
13139,Hall County,2021-08-20,431,87213,43.9
13139,Hall County,2021-08-21,238,87451,44
13139,Hall County,2021-08-22,148,87599,44.1
13139,Hall County,2021-08-23,290,87889,44.2
13139,Hall County,2021-08-24,316,88205,44.4
13139,Hall County,2021-08-25,330,88535,44.6
13139,Hall County,2021-08-26,433,88968,44.8
13139,Hall County,2021-08-27,401,89369,45
13139,Hall County,2021-08-28,257,89626,45.1
13139,Hall County,2021-08-29,295,89921,45.3
13139,Hall County,2021-08-30,287,90208,45.4
13139,Hall County,2021-08-31,278,90486,45.5
13139,Hall County,2021-09-01,306,90792,45.7
13139,Hall County,2021-09-02,336,91128,45.9
13139,Hall County,2021-09-03,357,91485,46
13139,Hall County,2021-09-04,234,91719,46.2
13139,Hall County,2021-09-05,120,91839,46.2
13139,Hall County,2021-09-06,46,91885,46.3
13139,Hall County,2021-09-07,249,92134,46.4
13139,Hall County,2021-09-08,265,92399,46.5
13139,Hall County,2021-09-09,247,92646,46.6
13139,Hall County,2021-09-10,310,92956,46.8
13139,Hall County,2021-09-11,181,93137,46.9
13139,Hall County,2021-09-12,98,93235,46.9
13139,Hall County,2021-09-13,198,93433,47
13139,Hall County,2021-09-14,182,93615,47.1
13139,Hall County,2021-09-15,161,93776,47.2
13139,Hall County,2021-09-16,195,93971,47.3
13139,Hall County,2021-09-17,224,94195,47.4
13139,Hall County,2021-09-18,140,94335,47.5
13139,Hall County,2021-09-19,97,94432,47.5
13139,Hall County,2021-09-20,196,94628,47.6
13139,Hall County,2021-09-21,129,94757,47.7
13139,Hall County,2021-09-22,130,94887,47.8
13139,Hall County,2021-09-23,103,94990,47.8
13139,Hall County,2021-09-24,162,95152,47.9
13139,Hall County,2021-09-25,79,95231,47.9
13139,Hall County,2021-09-26,48,95279,48
13139,Hall County,2021-09-27,93,95372,48
13139,Hall County,2021-09-28,91,95463,48.1
13139,Hall County,2021-09-29,80,95543,48.1
13139,Hall County,2021-09-30,66,95609,48.1
13139,Hall County,2021-10-01,117,95726,48.2
13139,Hall County,2021-10-02,52,95778,48.2
13139,Hall County,2021-10-03,32,95810,48.2
13139,Hall County,2021-10-04,65,95875,48.3
13139,Hall County,2021-10-05,56,95931,48.3
13139,Hall County,2021-10-06,64,95995,48.3
13139,Hall County,2021-10-07,53,96048,48.3
13141,Hancock County,2020-12-17,2,2,0
13141,Hancock County,2020-12-21,1,3,0
13141,Hancock County,2020-12-22,1,4,0
13141,Hancock County,2020-12-23,6,10,0.1
13141,Hancock County,2020-12-24,1,11,0.1
13141,Hancock County,2020-12-27,1,12,0.1
13141,Hancock County,2020-12-28,34,46,0.5
13141,Hancock County,2020-12-29,3,49,0.6
13141,Hancock County,2020-12-30,5,54,0.6
13141,Hancock County,2020-12-31,1,55,0.6
13141,Hancock County,2021-01-04,14,69,0.8
13141,Hancock County,2021-01-05,8,77,0.9
13141,Hancock County,2021-01-06,7,84,1
13141,Hancock County,2021-01-07,46,130,1.5
13141,Hancock County,2021-01-08,8,138,1.6
13141,Hancock County,2021-01-09,1,139,1.6
13141,Hancock County,2021-01-10,21,160,1.9
13141,Hancock County,2021-01-11,6,166,1.9
13141,Hancock County,2021-01-12,20,186,2.2
13141,Hancock County,2021-01-13,13,199,2.3
13141,Hancock County,2021-01-14,22,221,2.6
13141,Hancock County,2021-01-15,12,233,2.7
13141,Hancock County,2021-01-16,3,236,2.8
13141,Hancock County,2021-01-17,1,237,2.8
13141,Hancock County,2021-01-18,19,256,3
13141,Hancock County,2021-01-19,77,333,3.9
13141,Hancock County,2021-01-20,21,354,4.2
13141,Hancock County,2021-01-21,54,408,4.8
13141,Hancock County,2021-01-22,31,439,5.2
13141,Hancock County,2021-01-23,9,448,5.3
13141,Hancock County,2021-01-24,4,452,5.3
13141,Hancock County,2021-01-25,39,491,5.8
13141,Hancock County,2021-01-26,16,507,6
13141,Hancock County,2021-01-27,27,534,6.3
13141,Hancock County,2021-01-28,67,601,7.1
13141,Hancock County,2021-01-29,47,648,7.6
13141,Hancock County,2021-01-30,2,650,7.6
13141,Hancock County,2021-01-31,7,657,7.7
13141,Hancock County,2021-02-01,44,701,8.2
13141,Hancock County,2021-02-02,48,749,8.8
13141,Hancock County,2021-02-03,39,788,9.3
13141,Hancock County,2021-02-04,39,827,9.7
13141,Hancock County,2021-02-05,98,925,10.9
13141,Hancock County,2021-02-06,1,926,10.9
13141,Hancock County,2021-02-07,1,927,10.9
13141,Hancock County,2021-02-08,21,948,11.1
13141,Hancock County,2021-02-09,39,987,11.6
13141,Hancock County,2021-02-10,22,1009,11.8
13141,Hancock County,2021-02-11,43,1052,12.4
13141,Hancock County,2021-02-12,12,1064,12.5
13141,Hancock County,2021-02-13,3,1067,12.5
13141,Hancock County,2021-02-15,8,1075,12.6
13141,Hancock County,2021-02-16,32,1107,13
13141,Hancock County,2021-02-17,26,1133,13.3
13141,Hancock County,2021-02-18,31,1164,13.7
13141,Hancock County,2021-02-19,4,1168,13.7
13141,Hancock County,2021-02-20,14,1182,13.9
13141,Hancock County,2021-02-22,8,1190,14
13141,Hancock County,2021-02-23,8,1198,14.1
13141,Hancock County,2021-02-24,11,1209,14.2
13141,Hancock County,2021-02-25,29,1238,14.5
13141,Hancock County,2021-02-26,18,1256,14.8
13141,Hancock County,2021-02-27,2,1258,14.8
13141,Hancock County,2021-02-28,5,1263,14.8
13141,Hancock County,2021-03-01,11,1274,15
13141,Hancock County,2021-03-02,38,1312,15.4
13141,Hancock County,2021-03-03,18,1330,15.6
13141,Hancock County,2021-03-04,33,1363,16
13141,Hancock County,2021-03-05,27,1390,16.3
13141,Hancock County,2021-03-06,5,1395,16.4
13141,Hancock County,2021-03-07,3,1398,16.4
13141,Hancock County,2021-03-08,11,1409,16.5
13141,Hancock County,2021-03-09,78,1487,17.5
13141,Hancock County,2021-03-10,18,1505,17.7
13141,Hancock County,2021-03-11,69,1574,18.5
13141,Hancock County,2021-03-12,40,1614,19
13141,Hancock County,2021-03-13,5,1619,19
13141,Hancock County,2021-03-14,2,1621,19
13141,Hancock County,2021-03-15,23,1644,19.3
13141,Hancock County,2021-03-16,133,1777,20.9
13141,Hancock County,2021-03-17,27,1804,21.2
13141,Hancock County,2021-03-18,22,1826,21.4
13141,Hancock County,2021-03-19,106,1932,22.7
13141,Hancock County,2021-03-20,10,1942,22.8
13141,Hancock County,2021-03-21,1,1943,22.8
13141,Hancock County,2021-03-22,11,1954,22.9
13141,Hancock County,2021-03-23,75,2029,23.8
13141,Hancock County,2021-03-24,25,2054,24.1
13141,Hancock County,2021-03-25,73,2127,25
13141,Hancock County,2021-03-26,54,2181,25.6
13141,Hancock County,2021-03-27,15,2196,25.8
13141,Hancock County,2021-03-28,2,2198,25.8
13141,Hancock County,2021-03-29,11,2209,25.9
13141,Hancock County,2021-03-30,97,2306,27.1
13141,Hancock County,2021-03-31,16,2322,27.3
13141,Hancock County,2021-04-01,72,2394,28.1
13141,Hancock County,2021-04-02,91,2485,29.2
13141,Hancock County,2021-04-03,9,2494,29.3
13141,Hancock County,2021-04-04,1,2495,29.3
13141,Hancock County,2021-04-05,12,2507,29.4
13141,Hancock County,2021-04-06,45,2552,30
13141,Hancock County,2021-04-07,16,2568,30.2
13141,Hancock County,2021-04-08,50,2618,30.7
13141,Hancock County,2021-04-09,16,2634,30.9
13141,Hancock County,2021-04-10,7,2641,31
13141,Hancock County,2021-04-11,4,2645,31.1
13141,Hancock County,2021-04-12,9,2654,31.2
13141,Hancock County,2021-04-13,50,2704,31.8
13141,Hancock County,2021-04-14,14,2718,31.9
13141,Hancock County,2021-04-15,13,2731,32.1
13141,Hancock County,2021-04-16,12,2743,32.2
13141,Hancock County,2021-04-17,4,2747,32.3
13141,Hancock County,2021-04-19,6,2753,32.3
13141,Hancock County,2021-04-20,22,2775,32.6
13141,Hancock County,2021-04-21,10,2785,32.7
13141,Hancock County,2021-04-22,31,2816,33.1
13141,Hancock County,2021-04-23,22,2838,33.3
13141,Hancock County,2021-04-24,3,2841,33.4
13141,Hancock County,2021-04-26,8,2849,33.5
13141,Hancock County,2021-04-27,20,2869,33.7
13141,Hancock County,2021-04-28,8,2877,33.8
13141,Hancock County,2021-04-29,19,2896,34
13141,Hancock County,2021-04-30,17,2913,34.2
13141,Hancock County,2021-05-01,11,2924,34.3
13141,Hancock County,2021-05-02,2,2926,34.4
13141,Hancock County,2021-05-03,5,2931,34.4
13141,Hancock County,2021-05-04,20,2951,34.7
13141,Hancock County,2021-05-05,12,2963,34.8
13141,Hancock County,2021-05-06,24,2987,35.1
13141,Hancock County,2021-05-07,8,2995,35.2
13141,Hancock County,2021-05-08,10,3005,35.3
13141,Hancock County,2021-05-09,4,3009,35.3
13141,Hancock County,2021-05-10,3,3012,35.4
13141,Hancock County,2021-05-11,23,3035,35.6
13141,Hancock County,2021-05-12,7,3042,35.7
13141,Hancock County,2021-05-13,10,3052,35.8
13141,Hancock County,2021-05-14,5,3057,35.9
13141,Hancock County,2021-05-15,7,3064,36
13141,Hancock County,2021-05-16,3,3067,36
13141,Hancock County,2021-05-17,10,3077,36.1
13141,Hancock County,2021-05-18,43,3120,36.6
13141,Hancock County,2021-05-19,6,3126,36.7
13141,Hancock County,2021-05-20,8,3134,36.8
13141,Hancock County,2021-05-21,9,3143,36.9
13141,Hancock County,2021-05-22,4,3147,37
13141,Hancock County,2021-05-24,8,3155,37.1
13141,Hancock County,2021-05-25,22,3177,37.3
13141,Hancock County,2021-05-26,9,3186,37.4
13141,Hancock County,2021-05-27,10,3196,37.5
13141,Hancock County,2021-05-28,11,3207,37.7
13141,Hancock County,2021-05-29,3,3210,37.7
13141,Hancock County,2021-05-30,1,3211,37.7
13141,Hancock County,2021-06-01,14,3225,37.9
13141,Hancock County,2021-06-02,14,3239,38
13141,Hancock County,2021-06-03,6,3245,38.1
13141,Hancock County,2021-06-04,9,3254,38.2
13141,Hancock County,2021-06-05,3,3257,38.3
13141,Hancock County,2021-06-06,1,3258,38.3
13141,Hancock County,2021-06-07,5,3263,38.3
13141,Hancock County,2021-06-08,14,3277,38.5
13141,Hancock County,2021-06-09,6,3283,38.6
13141,Hancock County,2021-06-10,6,3289,38.6
13141,Hancock County,2021-06-11,4,3293,38.7
13141,Hancock County,2021-06-12,2,3295,38.7
13141,Hancock County,2021-06-14,5,3300,38.8
13141,Hancock County,2021-06-15,12,3312,38.9
13141,Hancock County,2021-06-16,9,3321,39
13141,Hancock County,2021-06-17,10,3331,39.1
13141,Hancock County,2021-06-18,7,3338,39.2
13141,Hancock County,2021-06-19,14,3352,39.4
13141,Hancock County,2021-06-20,1,3353,39.4
13141,Hancock County,2021-06-21,1,3354,39.4
13141,Hancock County,2021-06-22,7,3361,39.5
13141,Hancock County,2021-06-23,3,3364,39.5
13141,Hancock County,2021-06-24,8,3372,39.6
13141,Hancock County,2021-06-25,6,3378,39.7
13141,Hancock County,2021-06-26,3,3381,39.7
13141,Hancock County,2021-06-27,1,3382,39.7
13141,Hancock County,2021-06-28,1,3383,39.7
13141,Hancock County,2021-06-29,6,3389,39.8
13141,Hancock County,2021-06-30,7,3396,39.9
13141,Hancock County,2021-07-01,4,3400,39.9
13141,Hancock County,2021-07-02,6,3406,40
13141,Hancock County,2021-07-03,2,3408,40
13141,Hancock County,2021-07-05,3,3411,40.1
13141,Hancock County,2021-07-06,12,3423,40.2
13141,Hancock County,2021-07-07,8,3431,40.3
13141,Hancock County,2021-07-08,2,3433,40.3
13141,Hancock County,2021-07-09,5,3438,40.4
13141,Hancock County,2021-07-10,2,3440,40.4
13141,Hancock County,2021-07-13,10,3450,40.5
13141,Hancock County,2021-07-14,1,3451,40.5
13141,Hancock County,2021-07-15,5,3456,40.6
13141,Hancock County,2021-07-16,4,3460,40.6
13141,Hancock County,2021-07-17,2,3462,40.7
13141,Hancock County,2021-07-18,1,3463,40.7
13141,Hancock County,2021-07-19,2,3465,40.7
13141,Hancock County,2021-07-20,15,3480,40.9
13141,Hancock County,2021-07-21,6,3486,40.9
13141,Hancock County,2021-07-22,4,3490,41
13141,Hancock County,2021-07-23,10,3500,41.1
13141,Hancock County,2021-07-24,4,3504,41.2
13141,Hancock County,2021-07-25,2,3506,41.2
13141,Hancock County,2021-07-26,11,3517,41.3
13141,Hancock County,2021-07-27,46,3563,41.8
13141,Hancock County,2021-07-28,15,3578,42
13141,Hancock County,2021-07-29,14,3592,42.2
13141,Hancock County,2021-07-30,42,3634,42.7
13141,Hancock County,2021-07-31,8,3642,42.8
13141,Hancock County,2021-08-01,4,3646,42.8
13141,Hancock County,2021-08-02,6,3652,42.9
13141,Hancock County,2021-08-03,24,3676,43.2
13141,Hancock County,2021-08-04,11,3687,43.3
13141,Hancock County,2021-08-05,8,3695,43.4
13141,Hancock County,2021-08-06,10,3705,43.5
13141,Hancock County,2021-08-07,4,3709,43.6
13141,Hancock County,2021-08-08,2,3711,43.6
13141,Hancock County,2021-08-09,14,3725,43.7
13141,Hancock County,2021-08-10,19,3744,44
13141,Hancock County,2021-08-11,20,3764,44.2
13141,Hancock County,2021-08-12,18,3782,44.4
13141,Hancock County,2021-08-13,10,3792,44.5
13141,Hancock County,2021-08-14,7,3799,44.6
13141,Hancock County,2021-08-15,6,3805,44.7
13141,Hancock County,2021-08-16,11,3816,44.8
13141,Hancock County,2021-08-17,28,3844,45.1
13141,Hancock County,2021-08-18,12,3856,45.3
13141,Hancock County,2021-08-19,12,3868,45.4
13141,Hancock County,2021-08-20,7,3875,45.5
13141,Hancock County,2021-08-21,9,3884,45.6
13141,Hancock County,2021-08-22,4,3888,45.7
13141,Hancock County,2021-08-23,8,3896,45.8
13141,Hancock County,2021-08-24,28,3924,46.1
13141,Hancock County,2021-08-25,12,3936,46.2
13141,Hancock County,2021-08-26,4,3940,46.3
13141,Hancock County,2021-08-27,16,3956,46.5
13141,Hancock County,2021-08-28,1,3957,46.5
13141,Hancock County,2021-08-29,4,3961,46.5
13141,Hancock County,2021-08-30,5,3966,46.6
13141,Hancock County,2021-08-31,30,3996,46.9
13141,Hancock County,2021-09-01,8,4004,47
13141,Hancock County,2021-09-02,3,4007,47.1
13141,Hancock County,2021-09-03,14,4021,47.2
13141,Hancock County,2021-09-04,2,4023,47.2
13141,Hancock County,2021-09-05,3,4026,47.3
13141,Hancock County,2021-09-06,1,4027,47.3
13141,Hancock County,2021-09-07,26,4053,47.6
13141,Hancock County,2021-09-08,4,4057,47.6
13141,Hancock County,2021-09-09,7,4064,47.7
13141,Hancock County,2021-09-10,11,4075,47.9
13141,Hancock County,2021-09-11,1,4076,47.9
13141,Hancock County,2021-09-12,4,4080,47.9
13141,Hancock County,2021-09-13,8,4088,48
13141,Hancock County,2021-09-14,47,4135,48.6
13141,Hancock County,2021-09-15,14,4149,48.7
13141,Hancock County,2021-09-16,6,4155,48.8
13141,Hancock County,2021-09-17,12,4167,48.9
13141,Hancock County,2021-09-18,10,4177,49.1
13141,Hancock County,2021-09-19,4,4181,49.1
13141,Hancock County,2021-09-20,5,4186,49.2
13141,Hancock County,2021-09-21,28,4214,49.5
13141,Hancock County,2021-09-22,9,4223,49.6
13141,Hancock County,2021-09-23,3,4226,49.6
13141,Hancock County,2021-09-24,3,4229,49.7
13141,Hancock County,2021-09-25,2,4231,49.7
13141,Hancock County,2021-09-26,2,4233,49.7
13141,Hancock County,2021-09-27,4,4237,49.8
13141,Hancock County,2021-09-28,16,4253,49.9
13141,Hancock County,2021-09-29,4,4257,50
13141,Hancock County,2021-09-30,6,4263,50.1
13141,Hancock County,2021-10-01,2,4265,50.1
13141,Hancock County,2021-10-04,6,4271,50.2
13141,Hancock County,2021-10-05,4,4275,50.2
13141,Hancock County,2021-10-06,3,4278,50.2
13141,Hancock County,2021-10-07,2,4280,50.3
13143,Haralson County,2020-12-19,2,2,0
13143,Haralson County,2020-12-20,1,3,0
13143,Haralson County,2020-12-21,2,5,0
13143,Haralson County,2020-12-22,21,26,0.1
13143,Haralson County,2020-12-23,40,66,0.2
13143,Haralson County,2020-12-24,5,71,0.2
13143,Haralson County,2020-12-28,20,91,0.3
13143,Haralson County,2020-12-29,24,115,0.4
13143,Haralson County,2020-12-30,40,155,0.5
13143,Haralson County,2020-12-31,19,174,0.6
13143,Haralson County,2021-01-01,2,176,0.6
13143,Haralson County,2021-01-02,4,180,0.6
13143,Haralson County,2021-01-03,7,187,0.6
13143,Haralson County,2021-01-04,46,233,0.8
13143,Haralson County,2021-01-05,35,268,0.9
13143,Haralson County,2021-01-06,87,355,1.2
13143,Haralson County,2021-01-07,91,446,1.5
13143,Haralson County,2021-01-08,72,518,1.8
13143,Haralson County,2021-01-09,1,519,1.8
13143,Haralson County,2021-01-10,61,580,2
13143,Haralson County,2021-01-11,95,675,2.3
13143,Haralson County,2021-01-12,153,828,2.8
13143,Haralson County,2021-01-13,123,951,3.3
13143,Haralson County,2021-01-14,200,1151,3.9
13143,Haralson County,2021-01-15,130,1281,4.4
13143,Haralson County,2021-01-16,22,1303,4.5
13143,Haralson County,2021-01-17,5,1308,4.5
13143,Haralson County,2021-01-18,174,1482,5.1
13143,Haralson County,2021-01-19,139,1621,5.5
13143,Haralson County,2021-01-20,172,1793,6.1
13143,Haralson County,2021-01-21,89,1882,6.4
13143,Haralson County,2021-01-22,17,1899,6.5
13143,Haralson County,2021-01-23,5,1904,6.5
13143,Haralson County,2021-01-24,6,1910,6.5
13143,Haralson County,2021-01-25,58,1968,6.7
13143,Haralson County,2021-01-26,55,2023,6.9
13143,Haralson County,2021-01-27,156,2179,7.5
13143,Haralson County,2021-01-28,162,2341,8
13143,Haralson County,2021-01-29,91,2432,8.3
13143,Haralson County,2021-01-30,2,2434,8.3
13143,Haralson County,2021-01-31,6,2440,8.3
13143,Haralson County,2021-02-01,70,2510,8.6
13143,Haralson County,2021-02-02,32,2542,8.7
13143,Haralson County,2021-02-03,61,2603,8.9
13143,Haralson County,2021-02-04,74,2677,9.2
13143,Haralson County,2021-02-05,15,2692,9.2
13143,Haralson County,2021-02-06,2,2694,9.2
13143,Haralson County,2021-02-07,1,2695,9.2
13143,Haralson County,2021-02-08,12,2707,9.3
13143,Haralson County,2021-02-09,24,2731,9.3
13143,Haralson County,2021-02-10,58,2789,9.5
13143,Haralson County,2021-02-11,21,2810,9.6
13143,Haralson County,2021-02-12,6,2816,9.6
13143,Haralson County,2021-02-13,4,2820,9.6
13143,Haralson County,2021-02-15,22,2842,9.7
13143,Haralson County,2021-02-16,7,2849,9.7
13143,Haralson County,2021-02-17,36,2885,9.9
13143,Haralson County,2021-02-18,31,2916,10
13143,Haralson County,2021-02-19,15,2931,10
13143,Haralson County,2021-02-20,7,2938,10.1
13143,Haralson County,2021-02-21,3,2941,10.1
13143,Haralson County,2021-02-22,6,2947,10.1
13143,Haralson County,2021-02-23,35,2982,10.2
13143,Haralson County,2021-02-24,10,2992,10.2
13143,Haralson County,2021-02-25,9,3001,10.3
13143,Haralson County,2021-02-26,45,3046,10.4
13143,Haralson County,2021-02-27,22,3068,10.5
13143,Haralson County,2021-02-28,16,3084,10.6
13143,Haralson County,2021-03-01,26,3110,10.6
13143,Haralson County,2021-03-02,117,3227,11
13143,Haralson County,2021-03-03,73,3300,11.3
13143,Haralson County,2021-03-04,35,3335,11.4
13143,Haralson County,2021-03-05,76,3411,11.7
13143,Haralson County,2021-03-06,20,3431,11.7
13143,Haralson County,2021-03-07,24,3455,11.8
13143,Haralson County,2021-03-08,75,3530,12.1
13143,Haralson County,2021-03-09,65,3595,12.3
13143,Haralson County,2021-03-10,119,3714,12.7
13143,Haralson County,2021-03-11,52,3766,12.9
13143,Haralson County,2021-03-12,149,3915,13.4
13143,Haralson County,2021-03-13,44,3959,13.5
13143,Haralson County,2021-03-14,23,3982,13.6
13143,Haralson County,2021-03-15,121,4103,14
13143,Haralson County,2021-03-16,184,4287,14.7
13143,Haralson County,2021-03-17,192,4479,15.3
13143,Haralson County,2021-03-18,78,4557,15.6
13143,Haralson County,2021-03-19,104,4661,15.9
13143,Haralson County,2021-03-20,11,4672,16
13143,Haralson County,2021-03-21,10,4682,16
13143,Haralson County,2021-03-22,53,4735,16.2
13143,Haralson County,2021-03-23,81,4816,16.5
13143,Haralson County,2021-03-24,82,4898,16.8
13143,Haralson County,2021-03-25,91,4989,17.1
13143,Haralson County,2021-03-26,69,5058,17.3
13143,Haralson County,2021-03-27,26,5084,17.4
13143,Haralson County,2021-03-28,24,5108,17.5
13143,Haralson County,2021-03-29,68,5176,17.7
13143,Haralson County,2021-03-30,129,5305,18.2
13143,Haralson County,2021-03-31,80,5385,18.4
13143,Haralson County,2021-04-01,137,5522,18.9
13143,Haralson County,2021-04-02,77,5599,19.2
13143,Haralson County,2021-04-03,26,5625,19.2
13143,Haralson County,2021-04-04,19,5644,19.3
13143,Haralson County,2021-04-05,51,5695,19.5
13143,Haralson County,2021-04-06,103,5798,19.8
13143,Haralson County,2021-04-07,64,5862,20.1
13143,Haralson County,2021-04-08,106,5968,20.4
13143,Haralson County,2021-04-09,48,6016,20.6
13143,Haralson County,2021-04-10,23,6039,20.7
13143,Haralson County,2021-04-11,24,6063,20.7
13143,Haralson County,2021-04-12,60,6123,20.9
13143,Haralson County,2021-04-13,79,6202,21.2
13143,Haralson County,2021-04-14,71,6273,21.5
13143,Haralson County,2021-04-15,98,6371,21.8
13143,Haralson County,2021-04-16,35,6406,21.9
13143,Haralson County,2021-04-17,11,6417,22
13143,Haralson County,2021-04-18,7,6424,22
13143,Haralson County,2021-04-19,20,6444,22
13143,Haralson County,2021-04-20,54,6498,22.2
13143,Haralson County,2021-04-21,50,6548,22.4
13143,Haralson County,2021-04-22,53,6601,22.6
13143,Haralson County,2021-04-23,36,6637,22.7
13143,Haralson County,2021-04-24,18,6655,22.8
13143,Haralson County,2021-04-25,7,6662,22.8
13143,Haralson County,2021-04-26,36,6698,22.9
13143,Haralson County,2021-04-27,47,6745,23.1
13143,Haralson County,2021-04-28,36,6781,23.2
13143,Haralson County,2021-04-29,48,6829,23.4
13143,Haralson County,2021-04-30,55,6884,23.6
13143,Haralson County,2021-05-01,17,6901,23.6
13143,Haralson County,2021-05-02,9,6910,23.6
13143,Haralson County,2021-05-03,24,6934,23.7
13143,Haralson County,2021-05-04,24,6958,23.8
13143,Haralson County,2021-05-05,20,6978,23.9
13143,Haralson County,2021-05-06,30,7008,24
13143,Haralson County,2021-05-07,22,7030,24.1
13143,Haralson County,2021-05-08,20,7050,24.1
13143,Haralson County,2021-05-09,5,7055,24.1
13143,Haralson County,2021-05-10,22,7077,24.2
13143,Haralson County,2021-05-11,26,7103,24.3
13143,Haralson County,2021-05-12,22,7125,24.4
13143,Haralson County,2021-05-13,34,7159,24.5
13143,Haralson County,2021-05-14,25,7184,24.6
13143,Haralson County,2021-05-15,33,7217,24.7
13143,Haralson County,2021-05-16,16,7233,24.7
13143,Haralson County,2021-05-17,35,7268,24.9
13143,Haralson County,2021-05-18,32,7300,25
13143,Haralson County,2021-05-19,36,7336,25.1
13143,Haralson County,2021-05-20,26,7362,25.2
13143,Haralson County,2021-05-21,28,7390,25.3
13143,Haralson County,2021-05-22,27,7417,25.4
13143,Haralson County,2021-05-23,12,7429,25.4
13143,Haralson County,2021-05-24,25,7454,25.5
13143,Haralson County,2021-05-25,34,7488,25.6
13143,Haralson County,2021-05-26,22,7510,25.7
13143,Haralson County,2021-05-27,17,7527,25.8
13143,Haralson County,2021-05-28,22,7549,25.8
13143,Haralson County,2021-05-29,6,7555,25.8
13143,Haralson County,2021-05-30,4,7559,25.9
13143,Haralson County,2021-05-31,1,7560,25.9
13143,Haralson County,2021-06-01,19,7579,25.9
13143,Haralson County,2021-06-02,17,7596,26
13143,Haralson County,2021-06-03,14,7610,26
13143,Haralson County,2021-06-04,13,7623,26.1
13143,Haralson County,2021-06-05,10,7633,26.1
13143,Haralson County,2021-06-06,5,7638,26.1
13143,Haralson County,2021-06-07,18,7656,26.2
13143,Haralson County,2021-06-08,15,7671,26.2
13143,Haralson County,2021-06-09,15,7686,26.3
13143,Haralson County,2021-06-10,21,7707,26.4
13143,Haralson County,2021-06-11,28,7735,26.5
13143,Haralson County,2021-06-12,8,7743,26.5
13143,Haralson County,2021-06-13,4,7747,26.5
13143,Haralson County,2021-06-14,10,7757,26.5
13143,Haralson County,2021-06-15,14,7771,26.6
13143,Haralson County,2021-06-16,8,7779,26.6
13143,Haralson County,2021-06-17,12,7791,26.7
13143,Haralson County,2021-06-18,14,7805,26.7
13143,Haralson County,2021-06-19,13,7818,26.7
13143,Haralson County,2021-06-20,4,7822,26.8
13143,Haralson County,2021-06-21,19,7841,26.8
13143,Haralson County,2021-06-22,21,7862,26.9
13143,Haralson County,2021-06-23,18,7880,27
13143,Haralson County,2021-06-24,12,7892,27
13143,Haralson County,2021-06-25,11,7903,27
13143,Haralson County,2021-06-26,10,7913,27.1
13143,Haralson County,2021-06-27,4,7917,27.1
13143,Haralson County,2021-06-28,13,7930,27.1
13143,Haralson County,2021-06-29,9,7939,27.2
13143,Haralson County,2021-06-30,6,7945,27.2
13143,Haralson County,2021-07-01,14,7959,27.2
13143,Haralson County,2021-07-02,8,7967,27.3
13143,Haralson County,2021-07-03,6,7973,27.3
13143,Haralson County,2021-07-05,4,7977,27.3
13143,Haralson County,2021-07-06,11,7988,27.3
13143,Haralson County,2021-07-07,16,8004,27.4
13143,Haralson County,2021-07-08,14,8018,27.4
13143,Haralson County,2021-07-09,12,8030,27.5
13143,Haralson County,2021-07-10,5,8035,27.5
13143,Haralson County,2021-07-12,8,8043,27.5
13143,Haralson County,2021-07-13,16,8059,27.6
13143,Haralson County,2021-07-14,16,8075,27.6
13143,Haralson County,2021-07-15,23,8098,27.7
13143,Haralson County,2021-07-16,21,8119,27.8
13143,Haralson County,2021-07-17,18,8137,27.8
13143,Haralson County,2021-07-18,5,8142,27.9
13143,Haralson County,2021-07-19,13,8155,27.9
13143,Haralson County,2021-07-20,20,8175,28
13143,Haralson County,2021-07-21,26,8201,28.1
13143,Haralson County,2021-07-22,25,8226,28.1
13143,Haralson County,2021-07-23,39,8265,28.3
13143,Haralson County,2021-07-24,32,8297,28.4
13143,Haralson County,2021-07-25,14,8311,28.4
13143,Haralson County,2021-07-26,25,8336,28.5
13143,Haralson County,2021-07-27,36,8372,28.6
13143,Haralson County,2021-07-28,33,8405,28.8
13143,Haralson County,2021-07-29,44,8449,28.9
13143,Haralson County,2021-07-30,45,8494,29.1
13143,Haralson County,2021-07-31,15,8509,29.1
13143,Haralson County,2021-08-01,13,8522,29.2
13143,Haralson County,2021-08-02,26,8548,29.2
13143,Haralson County,2021-08-03,49,8597,29.4
13143,Haralson County,2021-08-04,37,8634,29.5
13143,Haralson County,2021-08-05,44,8678,29.7
13143,Haralson County,2021-08-06,72,8750,29.9
13143,Haralson County,2021-08-07,28,8778,30
13143,Haralson County,2021-08-08,15,8793,30.1
13143,Haralson County,2021-08-09,51,8844,30.3
13143,Haralson County,2021-08-10,53,8897,30.4
13143,Haralson County,2021-08-11,33,8930,30.6
13143,Haralson County,2021-08-12,59,8989,30.8
13143,Haralson County,2021-08-13,49,9038,30.9
13143,Haralson County,2021-08-14,34,9072,31
13143,Haralson County,2021-08-15,7,9079,31.1
13143,Haralson County,2021-08-16,34,9113,31.2
13143,Haralson County,2021-08-17,35,9148,31.3
13143,Haralson County,2021-08-18,48,9196,31.5
13143,Haralson County,2021-08-19,45,9241,31.6
13143,Haralson County,2021-08-20,63,9304,31.8
13143,Haralson County,2021-08-21,37,9341,32
13143,Haralson County,2021-08-22,24,9365,32
13143,Haralson County,2021-08-23,43,9408,32.2
13143,Haralson County,2021-08-24,54,9462,32.4
13143,Haralson County,2021-08-25,51,9513,32.5
13143,Haralson County,2021-08-26,50,9563,32.7
13143,Haralson County,2021-08-27,51,9614,32.9
13143,Haralson County,2021-08-28,34,9648,33
13143,Haralson County,2021-08-29,16,9664,33.1
13143,Haralson County,2021-08-30,55,9719,33.3
13143,Haralson County,2021-08-31,50,9769,33.4
13143,Haralson County,2021-09-01,55,9824,33.6
13143,Haralson County,2021-09-02,42,9866,33.8
13143,Haralson County,2021-09-03,47,9913,33.9
13143,Haralson County,2021-09-04,26,9939,34
13143,Haralson County,2021-09-05,27,9966,34.1
13143,Haralson County,2021-09-06,17,9983,34.2
13143,Haralson County,2021-09-07,28,10011,34.3
13143,Haralson County,2021-09-08,45,10056,34.4
13143,Haralson County,2021-09-09,36,10092,34.5
13143,Haralson County,2021-09-10,45,10137,34.7
13143,Haralson County,2021-09-11,24,10161,34.8
13143,Haralson County,2021-09-12,15,10176,34.8
13143,Haralson County,2021-09-13,36,10212,34.9
13143,Haralson County,2021-09-14,37,10249,35.1
13143,Haralson County,2021-09-15,31,10280,35.2
13143,Haralson County,2021-09-16,33,10313,35.3
13143,Haralson County,2021-09-17,37,10350,35.4
13143,Haralson County,2021-09-18,19,10369,35.5
13143,Haralson County,2021-09-19,13,10382,35.5
13143,Haralson County,2021-09-20,31,10413,35.6
13143,Haralson County,2021-09-21,33,10446,35.7
13143,Haralson County,2021-09-22,13,10459,35.8
13143,Haralson County,2021-09-23,22,10481,35.9
13143,Haralson County,2021-09-24,21,10502,35.9
13143,Haralson County,2021-09-25,10,10512,36
13143,Haralson County,2021-09-26,3,10515,36
13143,Haralson County,2021-09-27,6,10521,36
13143,Haralson County,2021-09-28,11,10532,36
13143,Haralson County,2021-09-29,9,10541,36.1
13143,Haralson County,2021-09-30,5,10546,36.1
13143,Haralson County,2021-10-01,17,10563,36.1
13143,Haralson County,2021-10-02,5,10568,36.2
13143,Haralson County,2021-10-03,3,10571,36.2
13143,Haralson County,2021-10-04,7,10578,36.2
13143,Haralson County,2021-10-05,3,10581,36.2
13143,Haralson County,2021-10-06,8,10589,36.2
13143,Haralson County,2021-10-07,1,10590,36.2
13145,Harris County,2020-12-17,1,1,0
13145,Harris County,2020-12-18,3,4,0
13145,Harris County,2020-12-19,4,8,0
13145,Harris County,2020-12-20,6,14,0
13145,Harris County,2020-12-21,17,31,0.1
13145,Harris County,2020-12-22,18,49,0.1
13145,Harris County,2020-12-23,37,86,0.3
13145,Harris County,2020-12-24,1,87,0.3
13145,Harris County,2020-12-26,9,96,0.3
13145,Harris County,2020-12-27,3,99,0.3
13145,Harris County,2020-12-28,50,149,0.4
13145,Harris County,2020-12-29,74,223,0.7
13145,Harris County,2020-12-30,60,283,0.8
13145,Harris County,2020-12-31,48,331,1
13145,Harris County,2021-01-01,3,334,1
13145,Harris County,2021-01-02,2,336,1
13145,Harris County,2021-01-03,3,339,1
13145,Harris County,2021-01-04,41,380,1.1
13145,Harris County,2021-01-05,81,461,1.4
13145,Harris County,2021-01-06,69,530,1.6
13145,Harris County,2021-01-07,81,611,1.8
13145,Harris County,2021-01-08,46,657,1.9
13145,Harris County,2021-01-09,3,660,1.9
13145,Harris County,2021-01-10,7,667,2
13145,Harris County,2021-01-11,98,765,2.2
13145,Harris County,2021-01-12,122,887,2.6
13145,Harris County,2021-01-13,166,1053,3.1
13145,Harris County,2021-01-14,136,1189,3.5
13145,Harris County,2021-01-15,47,1236,3.6
13145,Harris County,2021-01-16,168,1404,4.1
13145,Harris County,2021-01-17,22,1426,4.2
13145,Harris County,2021-01-18,85,1511,4.4
13145,Harris County,2021-01-19,107,1618,4.7
13145,Harris County,2021-01-20,155,1773,5.2
13145,Harris County,2021-01-21,96,1869,5.5
13145,Harris County,2021-01-22,71,1940,5.7
13145,Harris County,2021-01-23,88,2028,5.9
13145,Harris County,2021-01-24,2,2030,6
13145,Harris County,2021-01-25,46,2076,6.1
13145,Harris County,2021-01-26,94,2170,6.4
13145,Harris County,2021-01-27,77,2247,6.6
13145,Harris County,2021-01-28,130,2377,7
13145,Harris County,2021-01-29,173,2550,7.5
13145,Harris County,2021-01-30,31,2581,7.6
13145,Harris County,2021-01-31,2,2583,7.6
13145,Harris County,2021-02-01,79,2662,7.8
13145,Harris County,2021-02-02,54,2716,8
13145,Harris County,2021-02-03,54,2770,8.1
13145,Harris County,2021-02-04,84,2854,8.4
13145,Harris County,2021-02-05,50,2904,8.5
13145,Harris County,2021-02-07,3,2907,8.5
13145,Harris County,2021-02-08,18,2925,8.6
13145,Harris County,2021-02-09,487,3412,10
13145,Harris County,2021-02-10,37,3449,10.1
13145,Harris County,2021-02-11,67,3516,10.3
13145,Harris County,2021-02-12,83,3599,10.6
13145,Harris County,2021-02-13,28,3627,10.6
13145,Harris County,2021-02-14,9,3636,10.7
13145,Harris County,2021-02-15,41,3677,10.8
13145,Harris County,2021-02-16,64,3741,11
13145,Harris County,2021-02-17,45,3786,11.1
13145,Harris County,2021-02-18,106,3892,11.4
13145,Harris County,2021-02-19,35,3927,11.5
13145,Harris County,2021-02-20,27,3954,11.6
13145,Harris County,2021-02-21,3,3957,11.6
13145,Harris County,2021-02-22,35,3992,11.7
13145,Harris County,2021-02-23,49,4041,11.8
13145,Harris County,2021-02-24,57,4098,12
13145,Harris County,2021-02-25,67,4165,12.2
13145,Harris County,2021-02-26,255,4420,13
13145,Harris County,2021-02-27,30,4450,13
13145,Harris County,2021-02-28,12,4462,13.1
13145,Harris County,2021-03-01,51,4513,13.2
13145,Harris County,2021-03-02,60,4573,13.4
13145,Harris County,2021-03-03,89,4662,13.7
13145,Harris County,2021-03-04,77,4739,13.9
13145,Harris County,2021-03-05,77,4816,14.1
13145,Harris County,2021-03-06,30,4846,14.2
13145,Harris County,2021-03-07,13,4859,14.2
13145,Harris County,2021-03-08,124,4983,14.6
13145,Harris County,2021-03-09,96,5079,14.9
13145,Harris County,2021-03-10,131,5210,15.3
13145,Harris County,2021-03-11,212,5422,15.9
13145,Harris County,2021-03-12,99,5521,16.2
13145,Harris County,2021-03-13,43,5564,16.3
13145,Harris County,2021-03-14,12,5576,16.3
13145,Harris County,2021-03-15,210,5786,17
13145,Harris County,2021-03-16,102,5888,17.3
13145,Harris County,2021-03-17,236,6124,18
13145,Harris County,2021-03-18,147,6271,18.4
13145,Harris County,2021-03-19,192,6463,19
13145,Harris County,2021-03-20,97,6560,19.2
13145,Harris County,2021-03-21,32,6592,19.3
13145,Harris County,2021-03-22,114,6706,19.7
13145,Harris County,2021-03-23,125,6831,20
13145,Harris County,2021-03-24,179,7010,20.6
13145,Harris County,2021-03-25,324,7334,21.5
13145,Harris County,2021-03-26,376,7710,22.6
13145,Harris County,2021-03-27,76,7786,22.8
13145,Harris County,2021-03-28,43,7829,23
13145,Harris County,2021-03-29,164,7993,23.4
13145,Harris County,2021-03-30,230,8223,24.1
13145,Harris County,2021-03-31,168,8391,24.6
13145,Harris County,2021-04-01,160,8551,25.1
13145,Harris County,2021-04-02,187,8738,25.6
13145,Harris County,2021-04-03,35,8773,25.7
13145,Harris County,2021-04-04,25,8798,25.8
13145,Harris County,2021-04-05,97,8895,26.1
13145,Harris County,2021-04-06,131,9026,26.5
13145,Harris County,2021-04-07,179,9205,27
13145,Harris County,2021-04-08,136,9341,27.4
13145,Harris County,2021-04-09,249,9590,28.1
13145,Harris County,2021-04-10,56,9646,28.3
13145,Harris County,2021-04-11,26,9672,28.4
13145,Harris County,2021-04-12,77,9749,28.6
13145,Harris County,2021-04-13,74,9823,28.8
13145,Harris County,2021-04-14,75,9898,29
13145,Harris County,2021-04-15,62,9960,29.2
13145,Harris County,2021-04-16,89,10049,29.5
13145,Harris County,2021-04-17,40,10089,29.6
13145,Harris County,2021-04-18,4,10093,29.6
13145,Harris County,2021-04-19,55,10148,29.8
13145,Harris County,2021-04-20,50,10198,29.9
13145,Harris County,2021-04-21,63,10261,30.1
13145,Harris County,2021-04-22,60,10321,30.3
13145,Harris County,2021-04-23,56,10377,30.4
13145,Harris County,2021-04-24,13,10390,30.5
13145,Harris County,2021-04-25,6,10396,30.5
13145,Harris County,2021-04-26,43,10439,30.6
13145,Harris County,2021-04-27,30,10469,30.7
13145,Harris County,2021-04-28,56,10525,30.9
13145,Harris County,2021-04-29,54,10579,31
13145,Harris County,2021-04-30,67,10646,31.2
13145,Harris County,2021-05-01,20,10666,31.3
13145,Harris County,2021-05-02,14,10680,31.3
13145,Harris County,2021-05-03,37,10717,31.4
13145,Harris County,2021-05-04,56,10773,31.6
13145,Harris County,2021-05-05,49,10822,31.7
13145,Harris County,2021-05-06,42,10864,31.9
13145,Harris County,2021-05-07,53,10917,32
13145,Harris County,2021-05-08,22,10939,32.1
13145,Harris County,2021-05-09,3,10942,32.1
13145,Harris County,2021-05-10,22,10964,32.1
13145,Harris County,2021-05-11,50,11014,32.3
13145,Harris County,2021-05-12,35,11049,32.4
13145,Harris County,2021-05-13,37,11086,32.5
13145,Harris County,2021-05-14,49,11135,32.6
13145,Harris County,2021-05-15,36,11171,32.8
13145,Harris County,2021-05-16,21,11192,32.8
13145,Harris County,2021-05-17,49,11241,33
13145,Harris County,2021-05-18,158,11399,33.4
13145,Harris County,2021-05-19,44,11443,33.6
13145,Harris County,2021-05-20,43,11486,33.7
13145,Harris County,2021-05-21,68,11554,33.9
13145,Harris County,2021-05-22,37,11591,34
13145,Harris County,2021-05-23,28,11619,34.1
13145,Harris County,2021-05-24,41,11660,34.2
13145,Harris County,2021-05-25,38,11698,34.3
13145,Harris County,2021-05-26,37,11735,34.4
13145,Harris County,2021-05-27,27,11762,34.5
13145,Harris County,2021-05-28,64,11826,34.7
13145,Harris County,2021-05-29,44,11870,34.8
13145,Harris County,2021-05-30,9,11879,34.8
13145,Harris County,2021-05-31,6,11885,34.8
13145,Harris County,2021-06-01,46,11931,35
13145,Harris County,2021-06-02,41,11972,35.1
13145,Harris County,2021-06-03,28,12000,35.2
13145,Harris County,2021-06-04,46,12046,35.3
13145,Harris County,2021-06-05,21,12067,35.4
13145,Harris County,2021-06-06,12,12079,35.4
13145,Harris County,2021-06-07,28,12107,35.5
13145,Harris County,2021-06-08,37,12144,35.6
13145,Harris County,2021-06-09,32,12176,35.7
13145,Harris County,2021-06-10,20,12196,35.8
13145,Harris County,2021-06-11,49,12245,35.9
13145,Harris County,2021-06-12,21,12266,36
13145,Harris County,2021-06-13,15,12281,36
13145,Harris County,2021-06-14,39,12320,36.1
13145,Harris County,2021-06-15,32,12352,36.2
13145,Harris County,2021-06-16,22,12374,36.3
13145,Harris County,2021-06-17,59,12433,36.5
13145,Harris County,2021-06-18,53,12486,36.6
13145,Harris County,2021-06-19,15,12501,36.7
13145,Harris County,2021-06-20,8,12509,36.7
13145,Harris County,2021-06-21,20,12529,36.7
13145,Harris County,2021-06-22,35,12564,36.8
13145,Harris County,2021-06-23,32,12596,36.9
13145,Harris County,2021-06-24,29,12625,37
13145,Harris County,2021-06-25,47,12672,37.2
13145,Harris County,2021-06-26,22,12694,37.2
13145,Harris County,2021-06-27,8,12702,37.2
13145,Harris County,2021-06-28,31,12733,37.3
13145,Harris County,2021-06-29,23,12756,37.4
13145,Harris County,2021-06-30,27,12783,37.5
13145,Harris County,2021-07-01,41,12824,37.6
13145,Harris County,2021-07-02,29,12853,37.7
13145,Harris County,2021-07-03,24,12877,37.8
13145,Harris County,2021-07-05,11,12888,37.8
13145,Harris County,2021-07-06,41,12929,37.9
13145,Harris County,2021-07-07,33,12962,38
13145,Harris County,2021-07-08,40,13002,38.1
13145,Harris County,2021-07-09,30,13032,38.2
13145,Harris County,2021-07-10,16,13048,38.3
13145,Harris County,2021-07-11,9,13057,38.3
13145,Harris County,2021-07-12,21,13078,38.3
13145,Harris County,2021-07-13,29,13107,38.4
13145,Harris County,2021-07-14,24,13131,38.5
13145,Harris County,2021-07-15,18,13149,38.6
13145,Harris County,2021-07-16,52,13201,38.7
13145,Harris County,2021-07-17,29,13230,38.8
13145,Harris County,2021-07-18,15,13245,38.8
13145,Harris County,2021-07-19,49,13294,39
13145,Harris County,2021-07-20,38,13332,39.1
13145,Harris County,2021-07-21,40,13372,39.2
13145,Harris County,2021-07-22,51,13423,39.4
13145,Harris County,2021-07-23,93,13516,39.6
13145,Harris County,2021-07-24,53,13569,39.8
13145,Harris County,2021-07-25,29,13598,39.9
13145,Harris County,2021-07-26,81,13679,40.1
13145,Harris County,2021-07-27,42,13721,40.2
13145,Harris County,2021-07-28,44,13765,40.4
13145,Harris County,2021-07-29,47,13812,40.5
13145,Harris County,2021-07-30,75,13887,40.7
13145,Harris County,2021-07-31,25,13912,40.8
13145,Harris County,2021-08-01,25,13937,40.9
13145,Harris County,2021-08-02,53,13990,41
13145,Harris County,2021-08-03,104,14094,41.3
13145,Harris County,2021-08-04,43,14137,41.5
13145,Harris County,2021-08-05,67,14204,41.6
13145,Harris County,2021-08-06,76,14280,41.9
13145,Harris County,2021-08-07,31,14311,42
13145,Harris County,2021-08-08,26,14337,42
13145,Harris County,2021-08-09,41,14378,42.2
13145,Harris County,2021-08-10,47,14425,42.3
13145,Harris County,2021-08-11,43,14468,42.4
13145,Harris County,2021-08-12,50,14518,42.6
13145,Harris County,2021-08-13,75,14593,42.8
13145,Harris County,2021-08-14,37,14630,42.9
13145,Harris County,2021-08-15,17,14647,42.9
13145,Harris County,2021-08-16,44,14691,43.1
13145,Harris County,2021-08-17,63,14754,43.3
13145,Harris County,2021-08-18,48,14802,43.4
13145,Harris County,2021-08-19,44,14846,43.5
13145,Harris County,2021-08-20,77,14923,43.8
13145,Harris County,2021-08-21,20,14943,43.8
13145,Harris County,2021-08-22,20,14963,43.9
13145,Harris County,2021-08-23,47,15010,44
13145,Harris County,2021-08-24,60,15070,44.2
13145,Harris County,2021-08-25,44,15114,44.3
13145,Harris County,2021-08-26,43,15157,44.4
13145,Harris County,2021-08-27,87,15244,44.7
13145,Harris County,2021-08-28,23,15267,44.8
13145,Harris County,2021-08-29,19,15286,44.8
13145,Harris County,2021-08-30,39,15325,44.9
13145,Harris County,2021-08-31,36,15361,45
13145,Harris County,2021-09-01,50,15411,45.2
13145,Harris County,2021-09-02,51,15462,45.3
13145,Harris County,2021-09-03,54,15516,45.5
13145,Harris County,2021-09-04,23,15539,45.6
13145,Harris County,2021-09-05,21,15560,45.6
13145,Harris County,2021-09-06,5,15565,45.6
13145,Harris County,2021-09-07,31,15596,45.7
13145,Harris County,2021-09-08,34,15630,45.8
13145,Harris County,2021-09-09,41,15671,45.9
13145,Harris County,2021-09-10,58,15729,46.1
13145,Harris County,2021-09-11,22,15751,46.2
13145,Harris County,2021-09-12,14,15765,46.2
13145,Harris County,2021-09-13,35,15800,46.3
13145,Harris County,2021-09-14,39,15839,46.4
13145,Harris County,2021-09-15,24,15863,46.5
13145,Harris County,2021-09-16,18,15881,46.6
13145,Harris County,2021-09-17,42,15923,46.7
13145,Harris County,2021-09-18,17,15940,46.7
13145,Harris County,2021-09-19,7,15947,46.8
13145,Harris County,2021-09-20,18,15965,46.8
13145,Harris County,2021-09-21,23,15988,46.9
13145,Harris County,2021-09-22,16,16004,46.9
13145,Harris County,2021-09-23,16,16020,47
13145,Harris County,2021-09-24,10,16030,47
13145,Harris County,2021-09-25,9,16039,47
13145,Harris County,2021-09-26,5,16044,47
13145,Harris County,2021-09-27,8,16052,47.1
13145,Harris County,2021-09-28,14,16066,47.1
13145,Harris County,2021-09-29,14,16080,47.1
13145,Harris County,2021-09-30,13,16093,47.2
13145,Harris County,2021-10-01,22,16115,47.3
13145,Harris County,2021-10-02,4,16119,47.3
13145,Harris County,2021-10-03,1,16120,47.3
13145,Harris County,2021-10-04,9,16129,47.3
13145,Harris County,2021-10-05,4,16133,47.3
13145,Harris County,2021-10-06,8,16141,47.3
13145,Harris County,2021-10-07,10,16151,47.4
13147,Hart County,2020-12-15,1,1,0
13147,Hart County,2020-12-17,1,2,0
13147,Hart County,2020-12-18,5,7,0
13147,Hart County,2020-12-19,1,8,0
13147,Hart County,2020-12-21,8,16,0.1
13147,Hart County,2020-12-22,12,28,0.1
13147,Hart County,2020-12-23,15,43,0.2
13147,Hart County,2020-12-24,22,65,0.3
13147,Hart County,2020-12-28,13,78,0.3
13147,Hart County,2020-12-29,72,150,0.6
13147,Hart County,2020-12-30,36,186,0.7
13147,Hart County,2020-12-31,4,190,0.7
13147,Hart County,2021-01-01,4,194,0.8
13147,Hart County,2021-01-02,2,196,0.8
13147,Hart County,2021-01-03,2,198,0.8
13147,Hart County,2021-01-04,30,228,0.9
13147,Hart County,2021-01-05,38,266,1
13147,Hart County,2021-01-06,53,319,1.2
13147,Hart County,2021-01-07,23,342,1.3
13147,Hart County,2021-01-08,21,363,1.4
13147,Hart County,2021-01-10,6,369,1.4
13147,Hart County,2021-01-11,96,465,1.8
13147,Hart County,2021-01-12,65,530,2.1
13147,Hart County,2021-01-13,72,602,2.3
13147,Hart County,2021-01-14,102,704,2.7
13147,Hart County,2021-01-15,147,851,3.3
13147,Hart County,2021-01-16,33,884,3.4
13147,Hart County,2021-01-17,22,906,3.5
13147,Hart County,2021-01-18,91,997,3.9
13147,Hart County,2021-01-19,130,1127,4.4
13147,Hart County,2021-01-20,164,1291,5
13147,Hart County,2021-01-21,107,1398,5.4
13147,Hart County,2021-01-22,78,1476,5.7
13147,Hart County,2021-01-23,18,1494,5.8
13147,Hart County,2021-01-24,27,1521,5.9
13147,Hart County,2021-01-25,112,1633,6.3
13147,Hart County,2021-01-26,194,1827,7.1
13147,Hart County,2021-01-27,130,1957,7.6
13147,Hart County,2021-01-28,127,2084,8.1
13147,Hart County,2021-01-29,40,2124,8.2
13147,Hart County,2021-01-30,4,2128,8.3
13147,Hart County,2021-01-31,7,2135,8.3
13147,Hart County,2021-02-01,122,2257,8.8
13147,Hart County,2021-02-02,112,2369,9.2
13147,Hart County,2021-02-03,104,2473,9.6
13147,Hart County,2021-02-04,89,2562,9.9
13147,Hart County,2021-02-05,110,2672,10.4
13147,Hart County,2021-02-06,2,2674,10.4
13147,Hart County,2021-02-07,1,2675,10.4
13147,Hart County,2021-02-08,88,2763,10.7
13147,Hart County,2021-02-09,79,2842,11
13147,Hart County,2021-02-10,65,2907,11.3
13147,Hart County,2021-02-11,40,2947,11.4
13147,Hart County,2021-02-12,96,3043,11.8
13147,Hart County,2021-02-13,15,3058,11.9
13147,Hart County,2021-02-14,11,3069,11.9
13147,Hart County,2021-02-15,41,3110,12.1
13147,Hart County,2021-02-16,45,3155,12.2
13147,Hart County,2021-02-17,34,3189,12.4
13147,Hart County,2021-02-18,99,3288,12.8
13147,Hart County,2021-02-19,80,3368,13.1
13147,Hart County,2021-02-20,23,3391,13.2
13147,Hart County,2021-02-22,22,3413,13.2
13147,Hart County,2021-02-23,34,3447,13.4
13147,Hart County,2021-02-24,19,3466,13.4
13147,Hart County,2021-02-25,30,3496,13.6
13147,Hart County,2021-02-26,52,3548,13.8
13147,Hart County,2021-02-27,31,3579,13.9
13147,Hart County,2021-02-28,20,3599,14
13147,Hart County,2021-03-01,57,3656,14.2
13147,Hart County,2021-03-02,38,3694,14.3
13147,Hart County,2021-03-03,65,3759,14.6
13147,Hart County,2021-03-04,54,3813,14.8
13147,Hart County,2021-03-05,183,3996,15.5
13147,Hart County,2021-03-06,21,4017,15.6
13147,Hart County,2021-03-07,17,4034,15.7
13147,Hart County,2021-03-08,44,4078,15.8
13147,Hart County,2021-03-09,76,4154,16.1
13147,Hart County,2021-03-10,91,4245,16.5
13147,Hart County,2021-03-11,92,4337,16.8
13147,Hart County,2021-03-12,55,4392,17
13147,Hart County,2021-03-13,22,4414,17.1
13147,Hart County,2021-03-14,13,4427,17.2
13147,Hart County,2021-03-15,77,4504,17.5
13147,Hart County,2021-03-16,141,4645,18
13147,Hart County,2021-03-17,111,4756,18.5
13147,Hart County,2021-03-18,129,4885,19
13147,Hart County,2021-03-19,198,5083,19.7
13147,Hart County,2021-03-20,13,5096,19.8
13147,Hart County,2021-03-21,20,5116,19.9
13147,Hart County,2021-03-22,72,5188,20.1
13147,Hart County,2021-03-23,99,5287,20.5
13147,Hart County,2021-03-24,107,5394,20.9
13147,Hart County,2021-03-25,121,5515,21.4
13147,Hart County,2021-03-26,98,5613,21.8
13147,Hart County,2021-03-27,13,5626,21.8
13147,Hart County,2021-03-28,10,5636,21.9
13147,Hart County,2021-03-29,70,5706,22.1
13147,Hart County,2021-03-30,115,5821,22.6
13147,Hart County,2021-03-31,102,5923,23
13147,Hart County,2021-04-01,90,6013,23.3
13147,Hart County,2021-04-02,80,6093,23.6
13147,Hart County,2021-04-03,13,6106,23.7
13147,Hart County,2021-04-04,14,6120,23.7
13147,Hart County,2021-04-05,66,6186,24
13147,Hart County,2021-04-06,123,6309,24.5
13147,Hart County,2021-04-07,78,6387,24.8
13147,Hart County,2021-04-08,117,6504,25.2
13147,Hart County,2021-04-09,104,6608,25.6
13147,Hart County,2021-04-10,15,6623,25.7
13147,Hart County,2021-04-11,8,6631,25.7
13147,Hart County,2021-04-12,55,6686,25.9
13147,Hart County,2021-04-13,107,6793,26.4
13147,Hart County,2021-04-14,38,6831,26.5
13147,Hart County,2021-04-15,55,6886,26.7
13147,Hart County,2021-04-16,61,6947,27
13147,Hart County,2021-04-17,36,6983,27.1
13147,Hart County,2021-04-18,5,6988,27.1
13147,Hart County,2021-04-19,22,7010,27.2
13147,Hart County,2021-04-20,28,7038,27.3
13147,Hart County,2021-04-21,40,7078,27.5
13147,Hart County,2021-04-22,61,7139,27.7
13147,Hart County,2021-04-23,78,7217,28
13147,Hart County,2021-04-24,17,7234,28.1
13147,Hart County,2021-04-25,5,7239,28.1
13147,Hart County,2021-04-26,28,7267,28.2
13147,Hart County,2021-04-27,21,7288,28.3
13147,Hart County,2021-04-28,35,7323,28.4
13147,Hart County,2021-04-29,24,7347,28.5
13147,Hart County,2021-04-30,21,7368,28.6
13147,Hart County,2021-05-01,17,7385,28.7
13147,Hart County,2021-05-02,9,7394,28.7
13147,Hart County,2021-05-03,20,7414,28.8
13147,Hart County,2021-05-04,24,7438,28.9
13147,Hart County,2021-05-05,30,7468,29
13147,Hart County,2021-05-06,34,7502,29.1
13147,Hart County,2021-05-07,25,7527,29.2
13147,Hart County,2021-05-08,15,7542,29.3
13147,Hart County,2021-05-09,1,7543,29.3
13147,Hart County,2021-05-10,39,7582,29.4
13147,Hart County,2021-05-11,20,7602,29.5
13147,Hart County,2021-05-12,37,7639,29.6
13147,Hart County,2021-05-13,31,7670,29.8
13147,Hart County,2021-05-14,28,7698,29.9
13147,Hart County,2021-05-15,16,7714,29.9
13147,Hart County,2021-05-16,11,7725,30
13147,Hart County,2021-05-17,24,7749,30.1
13147,Hart County,2021-05-18,31,7780,30.2
13147,Hart County,2021-05-19,37,7817,30.3
13147,Hart County,2021-05-20,31,7848,30.5
13147,Hart County,2021-05-21,31,7879,30.6
13147,Hart County,2021-05-22,8,7887,30.6
13147,Hart County,2021-05-23,4,7891,30.6
13147,Hart County,2021-05-24,18,7909,30.7
13147,Hart County,2021-05-25,19,7928,30.8
13147,Hart County,2021-05-26,19,7947,30.8
13147,Hart County,2021-05-27,32,7979,31
13147,Hart County,2021-05-28,10,7989,31
13147,Hart County,2021-05-29,13,8002,31
13147,Hart County,2021-05-30,4,8006,31.1
13147,Hart County,2021-06-01,7,8013,31.1
13147,Hart County,2021-06-02,8,8021,31.1
13147,Hart County,2021-06-03,13,8034,31.2
13147,Hart County,2021-06-04,26,8060,31.3
13147,Hart County,2021-06-05,8,8068,31.3
13147,Hart County,2021-06-06,7,8075,31.3
13147,Hart County,2021-06-07,14,8089,31.4
13147,Hart County,2021-06-08,13,8102,31.4
13147,Hart County,2021-06-09,27,8129,31.5
13147,Hart County,2021-06-10,8,8137,31.6
13147,Hart County,2021-06-11,18,8155,31.6
13147,Hart County,2021-06-12,13,8168,31.7
13147,Hart County,2021-06-13,2,8170,31.7
13147,Hart County,2021-06-14,10,8180,31.7
13147,Hart County,2021-06-15,18,8198,31.8
13147,Hart County,2021-06-16,11,8209,31.9
13147,Hart County,2021-06-17,3,8212,31.9
13147,Hart County,2021-06-18,35,8247,32
13147,Hart County,2021-06-19,10,8257,32
13147,Hart County,2021-06-20,2,8259,32
13147,Hart County,2021-06-21,12,8271,32.1
13147,Hart County,2021-06-22,17,8288,32.2
13147,Hart County,2021-06-23,13,8301,32.2
13147,Hart County,2021-06-24,4,8305,32.2
13147,Hart County,2021-06-25,6,8311,32.2
13147,Hart County,2021-06-26,5,8316,32.3
13147,Hart County,2021-06-27,2,8318,32.3
13147,Hart County,2021-06-28,10,8328,32.3
13147,Hart County,2021-06-29,16,8344,32.4
13147,Hart County,2021-06-30,10,8354,32.4
13147,Hart County,2021-07-01,11,8365,32.5
13147,Hart County,2021-07-02,10,8375,32.5
13147,Hart County,2021-07-03,4,8379,32.5
13147,Hart County,2021-07-05,6,8385,32.5
13147,Hart County,2021-07-06,2,8387,32.5
13147,Hart County,2021-07-07,11,8398,32.6
13147,Hart County,2021-07-08,10,8408,32.6
13147,Hart County,2021-07-09,7,8415,32.7
13147,Hart County,2021-07-10,3,8418,32.7
13147,Hart County,2021-07-11,2,8420,32.7
13147,Hart County,2021-07-12,6,8426,32.7
13147,Hart County,2021-07-13,9,8435,32.7
13147,Hart County,2021-07-14,22,8457,32.8
13147,Hart County,2021-07-15,10,8467,32.9
13147,Hart County,2021-07-16,27,8494,33
13147,Hart County,2021-07-17,3,8497,33
13147,Hart County,2021-07-18,4,8501,33
13147,Hart County,2021-07-19,17,8518,33.1
13147,Hart County,2021-07-20,11,8529,33.1
13147,Hart County,2021-07-21,40,8569,33.2
13147,Hart County,2021-07-22,18,8587,33.3
13147,Hart County,2021-07-23,28,8615,33.4
13147,Hart County,2021-07-24,15,8630,33.5
13147,Hart County,2021-07-25,12,8642,33.5
13147,Hart County,2021-07-26,21,8663,33.6
13147,Hart County,2021-07-27,28,8691,33.7
13147,Hart County,2021-07-28,31,8722,33.8
13147,Hart County,2021-07-29,30,8752,34
13147,Hart County,2021-07-30,32,8784,34.1
13147,Hart County,2021-07-31,26,8810,34.2
13147,Hart County,2021-08-01,14,8824,34.2
13147,Hart County,2021-08-02,26,8850,34.3
13147,Hart County,2021-08-03,39,8889,34.5
13147,Hart County,2021-08-04,29,8918,34.6
13147,Hart County,2021-08-05,53,8971,34.8
13147,Hart County,2021-08-06,37,9008,35
13147,Hart County,2021-08-07,15,9023,35
13147,Hart County,2021-08-08,9,9032,35
13147,Hart County,2021-08-09,32,9064,35.2
13147,Hart County,2021-08-10,52,9116,35.4
13147,Hart County,2021-08-11,34,9150,35.5
13147,Hart County,2021-08-12,36,9186,35.6
13147,Hart County,2021-08-13,49,9235,35.8
13147,Hart County,2021-08-14,14,9249,35.9
13147,Hart County,2021-08-15,17,9266,36
13147,Hart County,2021-08-16,32,9298,36.1
13147,Hart County,2021-08-17,35,9333,36.2
13147,Hart County,2021-08-18,41,9374,36.4
13147,Hart County,2021-08-19,33,9407,36.5
13147,Hart County,2021-08-20,30,9437,36.6
13147,Hart County,2021-08-21,23,9460,36.7
13147,Hart County,2021-08-22,12,9472,36.8
13147,Hart County,2021-08-23,32,9504,36.9
13147,Hart County,2021-08-24,37,9541,37
13147,Hart County,2021-08-25,34,9575,37.2
13147,Hart County,2021-08-26,54,9629,37.4
13147,Hart County,2021-08-27,59,9688,37.6
13147,Hart County,2021-08-28,30,9718,37.7
13147,Hart County,2021-08-29,14,9732,37.8
13147,Hart County,2021-08-30,40,9772,37.9
13147,Hart County,2021-08-31,31,9803,38
13147,Hart County,2021-09-01,53,9856,38.2
13147,Hart County,2021-09-02,33,9889,38.4
13147,Hart County,2021-09-03,36,9925,38.5
13147,Hart County,2021-09-04,15,9940,38.6
13147,Hart County,2021-09-05,2,9942,38.6
13147,Hart County,2021-09-06,4,9946,38.6
13147,Hart County,2021-09-07,24,9970,38.7
13147,Hart County,2021-09-08,30,10000,38.8
13147,Hart County,2021-09-09,29,10029,38.9
13147,Hart County,2021-09-10,42,10071,39.1
13147,Hart County,2021-09-11,10,10081,39.1
13147,Hart County,2021-09-12,14,10095,39.2
13147,Hart County,2021-09-13,11,10106,39.2
13147,Hart County,2021-09-14,16,10122,39.3
13147,Hart County,2021-09-15,23,10145,39.4
13147,Hart County,2021-09-16,19,10164,39.4
13147,Hart County,2021-09-17,33,10197,39.6
13147,Hart County,2021-09-18,15,10212,39.6
13147,Hart County,2021-09-19,12,10224,39.7
13147,Hart County,2021-09-20,29,10253,39.8
13147,Hart County,2021-09-21,17,10270,39.8
13147,Hart County,2021-09-22,41,10311,40
13147,Hart County,2021-09-23,26,10337,40.1
13147,Hart County,2021-09-24,14,10351,40.2
13147,Hart County,2021-09-25,8,10359,40.2
13147,Hart County,2021-09-26,8,10367,40.2
13147,Hart County,2021-09-27,23,10390,40.3
13147,Hart County,2021-09-28,13,10403,40.4
13147,Hart County,2021-09-29,9,10412,40.4
13147,Hart County,2021-09-30,10,10422,40.4
13147,Hart County,2021-10-01,11,10433,40.5
13147,Hart County,2021-10-02,4,10437,40.5
13147,Hart County,2021-10-03,3,10440,40.5
13147,Hart County,2021-10-04,4,10444,40.5
13147,Hart County,2021-10-05,5,10449,40.5
13147,Hart County,2021-10-06,17,10466,40.6
13147,Hart County,2021-10-07,3,10469,40.6
13149,Heard County,2020-12-21,3,3,0
13149,Heard County,2020-12-22,4,7,0.1
13149,Heard County,2020-12-23,13,20,0.2
13149,Heard County,2020-12-24,2,22,0.2
13149,Heard County,2020-12-26,1,23,0.2
13149,Heard County,2020-12-27,1,24,0.2
13149,Heard County,2020-12-28,10,34,0.3
13149,Heard County,2020-12-29,12,46,0.4
13149,Heard County,2020-12-30,24,70,0.6
13149,Heard County,2020-12-31,10,80,0.7
13149,Heard County,2021-01-01,4,84,0.7
13149,Heard County,2021-01-02,1,85,0.7
13149,Heard County,2021-01-03,2,87,0.7
13149,Heard County,2021-01-04,10,97,0.8
13149,Heard County,2021-01-05,4,101,0.9
13149,Heard County,2021-01-06,21,122,1
13149,Heard County,2021-01-07,4,126,1.1
13149,Heard County,2021-01-08,14,140,1.2
13149,Heard County,2021-01-09,5,145,1.2
13149,Heard County,2021-01-10,18,163,1.4
13149,Heard County,2021-01-11,5,168,1.4
13149,Heard County,2021-01-12,23,191,1.6
13149,Heard County,2021-01-13,11,202,1.7
13149,Heard County,2021-01-14,156,358,3.1
13149,Heard County,2021-01-15,22,380,3.2
13149,Heard County,2021-01-16,6,386,3.3
13149,Heard County,2021-01-17,2,388,3.3
13149,Heard County,2021-01-18,7,395,3.4
13149,Heard County,2021-01-19,20,415,3.5
13149,Heard County,2021-01-20,53,468,4
13149,Heard County,2021-01-21,21,489,4.2
13149,Heard County,2021-01-22,20,509,4.3
13149,Heard County,2021-01-23,14,523,4.5
13149,Heard County,2021-01-25,6,529,4.5
13149,Heard County,2021-01-26,7,536,4.6
13149,Heard County,2021-01-27,22,558,4.8
13149,Heard County,2021-01-28,12,570,4.9
13149,Heard County,2021-01-29,6,576,4.9
13149,Heard County,2021-01-30,1,577,4.9
13149,Heard County,2021-01-31,14,591,5
13149,Heard County,2021-02-01,6,597,5.1
13149,Heard County,2021-02-02,32,629,5.4
13149,Heard County,2021-02-03,10,639,5.4
13149,Heard County,2021-02-04,9,648,5.5
13149,Heard County,2021-02-05,4,652,5.6
13149,Heard County,2021-02-07,1,653,5.6
13149,Heard County,2021-02-08,2,655,5.6
13149,Heard County,2021-02-09,11,666,5.7
13149,Heard County,2021-02-10,3,669,5.7
13149,Heard County,2021-02-11,5,674,5.7
13149,Heard County,2021-02-12,13,687,5.9
13149,Heard County,2021-02-13,2,689,5.9
13149,Heard County,2021-02-14,1,690,5.9
13149,Heard County,2021-02-15,3,693,5.9
13149,Heard County,2021-02-16,33,726,6.2
13149,Heard County,2021-02-17,9,735,6.3
13149,Heard County,2021-02-18,31,766,6.5
13149,Heard County,2021-02-19,6,772,6.6
13149,Heard County,2021-02-22,2,774,6.6
13149,Heard County,2021-02-23,28,802,6.8
13149,Heard County,2021-02-24,26,828,7.1
13149,Heard County,2021-02-25,24,852,7.3
13149,Heard County,2021-02-26,18,870,7.4
13149,Heard County,2021-02-27,3,873,7.4
13149,Heard County,2021-02-28,1,874,7.4
13149,Heard County,2021-03-01,5,879,7.5
13149,Heard County,2021-03-02,26,905,7.7
13149,Heard County,2021-03-03,32,937,8
13149,Heard County,2021-03-04,29,966,8.2
13149,Heard County,2021-03-05,8,974,8.3
13149,Heard County,2021-03-06,1,975,8.3
13149,Heard County,2021-03-07,2,977,8.3
13149,Heard County,2021-03-08,10,987,8.4
13149,Heard County,2021-03-09,9,996,8.5
13149,Heard County,2021-03-10,45,1041,8.9
13149,Heard County,2021-03-11,34,1075,9.2
13149,Heard County,2021-03-12,16,1091,9.3
13149,Heard County,2021-03-13,1,1092,9.3
13149,Heard County,2021-03-14,3,1095,9.3
13149,Heard County,2021-03-15,34,1129,9.6
13149,Heard County,2021-03-16,43,1172,10
13149,Heard County,2021-03-17,32,1204,10.3
13149,Heard County,2021-03-18,17,1221,10.4
13149,Heard County,2021-03-19,98,1319,11.2
13149,Heard County,2021-03-20,6,1325,11.3
13149,Heard County,2021-03-21,9,1334,11.4
13149,Heard County,2021-03-22,26,1360,11.6
13149,Heard County,2021-03-23,18,1378,11.7
13149,Heard County,2021-03-24,25,1403,12
13149,Heard County,2021-03-25,20,1423,12.1
13149,Heard County,2021-03-26,15,1438,12.3
13149,Heard County,2021-03-27,35,1473,12.6
13149,Heard County,2021-03-28,4,1477,12.6
13149,Heard County,2021-03-29,6,1483,12.6
13149,Heard County,2021-03-30,49,1532,13.1
13149,Heard County,2021-03-31,34,1566,13.3
13149,Heard County,2021-04-01,33,1599,13.6
13149,Heard County,2021-04-02,23,1622,13.8
13149,Heard County,2021-04-03,17,1639,14
13149,Heard County,2021-04-04,10,1649,14.1
13149,Heard County,2021-04-05,19,1668,14.2
13149,Heard County,2021-04-06,39,1707,14.5
13149,Heard County,2021-04-07,20,1727,14.7
13149,Heard County,2021-04-08,32,1759,15
13149,Heard County,2021-04-09,23,1782,15.2
13149,Heard County,2021-04-10,21,1803,15.4
13149,Heard County,2021-04-11,11,1814,15.5
13149,Heard County,2021-04-12,9,1823,15.5
13149,Heard County,2021-04-13,40,1863,15.9
13149,Heard County,2021-04-14,22,1885,16.1
13149,Heard County,2021-04-15,12,1897,16.2
13149,Heard County,2021-04-16,12,1909,16.3
13149,Heard County,2021-04-17,3,1912,16.3
13149,Heard County,2021-04-18,4,1916,16.3
13149,Heard County,2021-04-19,13,1929,16.4
13149,Heard County,2021-04-20,38,1967,16.8
13149,Heard County,2021-04-21,13,1980,16.9
13149,Heard County,2021-04-22,19,1999,17
13149,Heard County,2021-04-23,19,2018,17.2
13149,Heard County,2021-04-24,9,2027,17.3
13149,Heard County,2021-04-25,1,2028,17.3
13149,Heard County,2021-04-26,10,2038,17.4
13149,Heard County,2021-04-27,52,2090,17.8
13149,Heard County,2021-04-28,23,2113,18
13149,Heard County,2021-04-29,16,2129,18.1
13149,Heard County,2021-04-30,12,2141,18.2
13149,Heard County,2021-05-01,4,2145,18.3
13149,Heard County,2021-05-02,6,2151,18.3
13149,Heard County,2021-05-03,12,2163,18.4
13149,Heard County,2021-05-04,7,2170,18.5
13149,Heard County,2021-05-05,14,2184,18.6
13149,Heard County,2021-05-06,10,2194,18.7
13149,Heard County,2021-05-07,15,2209,18.8
13149,Heard County,2021-05-08,14,2223,18.9
13149,Heard County,2021-05-09,5,2228,19
13149,Heard County,2021-05-10,12,2240,19.1
13149,Heard County,2021-05-11,7,2247,19.1
13149,Heard County,2021-05-12,18,2265,19.3
13149,Heard County,2021-05-13,34,2299,19.6
13149,Heard County,2021-05-14,8,2307,19.7
13149,Heard County,2021-05-15,16,2323,19.8
13149,Heard County,2021-05-16,6,2329,19.8
13149,Heard County,2021-05-17,20,2349,20
13149,Heard County,2021-05-18,27,2376,20.2
13149,Heard County,2021-05-19,17,2393,20.4
13149,Heard County,2021-05-20,20,2413,20.6
13149,Heard County,2021-05-21,25,2438,20.8
13149,Heard County,2021-05-22,5,2443,20.8
13149,Heard County,2021-05-23,6,2449,20.9
13149,Heard County,2021-05-24,9,2458,20.9
13149,Heard County,2021-05-25,10,2468,21
13149,Heard County,2021-05-26,13,2481,21.1
13149,Heard County,2021-05-27,13,2494,21.3
13149,Heard County,2021-05-28,10,2504,21.3
13149,Heard County,2021-05-29,8,2512,21.4
13149,Heard County,2021-05-30,1,2513,21.4
13149,Heard County,2021-06-01,4,2517,21.4
13149,Heard County,2021-06-02,10,2527,21.5
13149,Heard County,2021-06-03,9,2536,21.6
13149,Heard County,2021-06-04,7,2543,21.7
13149,Heard County,2021-06-06,2,2545,21.7
13149,Heard County,2021-06-07,3,2548,21.7
13149,Heard County,2021-06-08,10,2558,21.8
13149,Heard County,2021-06-09,8,2566,21.9
13149,Heard County,2021-06-10,8,2574,21.9
13149,Heard County,2021-06-11,11,2585,22
13149,Heard County,2021-06-12,5,2590,22.1
13149,Heard County,2021-06-13,1,2591,22.1
13149,Heard County,2021-06-14,2,2593,22.1
13149,Heard County,2021-06-15,9,2602,22.2
13149,Heard County,2021-06-16,5,2607,22.2
13149,Heard County,2021-06-17,2,2609,22.2
13149,Heard County,2021-06-18,13,2622,22.3
13149,Heard County,2021-06-19,3,2625,22.4
13149,Heard County,2021-06-20,2,2627,22.4
13149,Heard County,2021-06-21,4,2631,22.4
13149,Heard County,2021-06-22,4,2635,22.5
13149,Heard County,2021-06-23,3,2638,22.5
13149,Heard County,2021-06-24,1,2639,22.5
13149,Heard County,2021-06-25,8,2647,22.6
13149,Heard County,2021-06-26,2,2649,22.6
13149,Heard County,2021-06-28,5,2654,22.6
13149,Heard County,2021-06-29,9,2663,22.7
13149,Heard County,2021-06-30,1,2664,22.7
13149,Heard County,2021-07-01,5,2669,22.7
13149,Heard County,2021-07-02,11,2680,22.8
13149,Heard County,2021-07-03,4,2684,22.9
13149,Heard County,2021-07-05,2,2686,22.9
13149,Heard County,2021-07-06,2,2688,22.9
13149,Heard County,2021-07-07,5,2693,22.9
13149,Heard County,2021-07-08,5,2698,23
13149,Heard County,2021-07-09,1,2699,23
13149,Heard County,2021-07-10,3,2702,23
13149,Heard County,2021-07-11,2,2704,23
13149,Heard County,2021-07-12,9,2713,23.1
13149,Heard County,2021-07-13,6,2719,23.2
13149,Heard County,2021-07-14,10,2729,23.3
13149,Heard County,2021-07-15,5,2734,23.3
13149,Heard County,2021-07-16,3,2737,23.3
13149,Heard County,2021-07-17,2,2739,23.3
13149,Heard County,2021-07-19,10,2749,23.4
13149,Heard County,2021-07-20,3,2752,23.4
13149,Heard County,2021-07-21,3,2755,23.5
13149,Heard County,2021-07-22,4,2759,23.5
13149,Heard County,2021-07-23,14,2773,23.6
13149,Heard County,2021-07-24,8,2781,23.7
13149,Heard County,2021-07-25,1,2782,23.7
13149,Heard County,2021-07-26,8,2790,23.8
13149,Heard County,2021-07-27,11,2801,23.9
13149,Heard County,2021-07-28,13,2814,24
13149,Heard County,2021-07-29,12,2826,24.1
13149,Heard County,2021-07-30,23,2849,24.3
13149,Heard County,2021-07-31,7,2856,24.3
13149,Heard County,2021-08-01,2,2858,24.4
13149,Heard County,2021-08-02,10,2868,24.4
13149,Heard County,2021-08-03,17,2885,24.6
13149,Heard County,2021-08-04,26,2911,24.8
13149,Heard County,2021-08-05,23,2934,25
13149,Heard County,2021-08-06,16,2950,25.1
13149,Heard County,2021-08-07,14,2964,25.3
13149,Heard County,2021-08-08,6,2970,25.3
13149,Heard County,2021-08-09,9,2979,25.4
13149,Heard County,2021-08-10,17,2996,25.5
13149,Heard County,2021-08-11,18,3014,25.7
13149,Heard County,2021-08-12,16,3030,25.8
13149,Heard County,2021-08-13,13,3043,25.9
13149,Heard County,2021-08-14,8,3051,26
13149,Heard County,2021-08-15,5,3056,26
13149,Heard County,2021-08-16,9,3065,26.1
13149,Heard County,2021-08-17,18,3083,26.3
13149,Heard County,2021-08-18,30,3113,26.5
13149,Heard County,2021-08-19,19,3132,26.7
13149,Heard County,2021-08-20,27,3159,26.9
13149,Heard County,2021-08-21,10,3169,27
13149,Heard County,2021-08-22,3,3172,27
13149,Heard County,2021-08-23,17,3189,27.2
13149,Heard County,2021-08-24,13,3202,27.3
13149,Heard County,2021-08-25,10,3212,27.4
13149,Heard County,2021-08-26,32,3244,27.6
13149,Heard County,2021-08-27,31,3275,27.9
13149,Heard County,2021-08-28,8,3283,28
13149,Heard County,2021-08-29,7,3290,28
13149,Heard County,2021-08-30,18,3308,28.2
13149,Heard County,2021-08-31,18,3326,28.3
13149,Heard County,2021-09-01,18,3344,28.5
13149,Heard County,2021-09-02,23,3367,28.7
13149,Heard County,2021-09-03,19,3386,28.9
13149,Heard County,2021-09-04,13,3399,29
13149,Heard County,2021-09-05,8,3407,29
13149,Heard County,2021-09-06,3,3410,29.1
13149,Heard County,2021-09-07,15,3425,29.2
13149,Heard County,2021-09-08,25,3450,29.4
13149,Heard County,2021-09-09,15,3465,29.5
13149,Heard County,2021-09-10,15,3480,29.7
13149,Heard County,2021-09-11,8,3488,29.7
13149,Heard County,2021-09-12,1,3489,29.7
13149,Heard County,2021-09-13,10,3499,29.8
13149,Heard County,2021-09-14,10,3509,29.9
13149,Heard County,2021-09-15,15,3524,30
13149,Heard County,2021-09-16,14,3538,30.1
13149,Heard County,2021-09-17,14,3552,30.3
13149,Heard County,2021-09-18,11,3563,30.4
13149,Heard County,2021-09-19,4,3567,30.4
13149,Heard County,2021-09-20,5,3572,30.4
13149,Heard County,2021-09-21,11,3583,30.5
13149,Heard County,2021-09-22,8,3591,30.6
13149,Heard County,2021-09-23,11,3602,30.7
13149,Heard County,2021-09-24,14,3616,30.8
13149,Heard County,2021-09-25,2,3618,30.8
13149,Heard County,2021-09-27,4,3622,30.9
13149,Heard County,2021-09-28,4,3626,30.9
13149,Heard County,2021-09-29,7,3633,31
13149,Heard County,2021-09-30,6,3639,31
13149,Heard County,2021-10-01,10,3649,31.1
13149,Heard County,2021-10-02,1,3650,31.1
13149,Heard County,2021-10-03,1,3651,31.1
13149,Heard County,2021-10-04,5,3656,31.2
13149,Heard County,2021-10-05,1,3657,31.2
13149,Heard County,2021-10-06,1,3658,31.2
13149,Heard County,2021-10-07,6,3664,31.2
13151,Henry County,2020-12-16,5,5,0
13151,Henry County,2020-12-17,11,16,0
13151,Henry County,2020-12-18,99,115,0.1
13151,Henry County,2020-12-19,42,157,0.1
13151,Henry County,2020-12-20,35,192,0.1
13151,Henry County,2020-12-21,75,267,0.1
13151,Henry County,2020-12-22,117,384,0.2
13151,Henry County,2020-12-23,132,516,0.2
13151,Henry County,2020-12-24,33,549,0.2
13151,Henry County,2020-12-25,1,550,0.2
13151,Henry County,2020-12-26,13,563,0.2
13151,Henry County,2020-12-27,16,579,0.3
13151,Henry County,2020-12-28,328,907,0.4
13151,Henry County,2020-12-29,432,1339,0.6
13151,Henry County,2020-12-30,272,1611,0.7
13151,Henry County,2020-12-31,157,1768,0.8
13151,Henry County,2021-01-01,48,1816,0.8
13151,Henry County,2021-01-02,26,1842,0.8
13151,Henry County,2021-01-03,36,1878,0.8
13151,Henry County,2021-01-04,151,2029,0.9
13151,Henry County,2021-01-05,248,2277,1
13151,Henry County,2021-01-06,265,2542,1.1
13151,Henry County,2021-01-07,170,2712,1.2
13151,Henry County,2021-01-08,243,2955,1.3
13151,Henry County,2021-01-09,95,3050,1.4
13151,Henry County,2021-01-10,42,3092,1.4
13151,Henry County,2021-01-11,301,3393,1.5
13151,Henry County,2021-01-12,743,4136,1.8
13151,Henry County,2021-01-13,422,4558,2
13151,Henry County,2021-01-14,572,5130,2.3
13151,Henry County,2021-01-15,829,5959,2.6
13151,Henry County,2021-01-16,386,6345,2.8
13151,Henry County,2021-01-17,157,6502,2.9
13151,Henry County,2021-01-18,412,6914,3.1
13151,Henry County,2021-01-19,472,7386,3.3
13151,Henry County,2021-01-20,512,7898,3.5
13151,Henry County,2021-01-21,417,8315,3.7
13151,Henry County,2021-01-22,549,8864,3.9
13151,Henry County,2021-01-23,229,9093,4
13151,Henry County,2021-01-24,57,9150,4.1
13151,Henry County,2021-01-25,391,9541,4.2
13151,Henry County,2021-01-26,310,9851,4.4
13151,Henry County,2021-01-27,393,10244,4.5
13151,Henry County,2021-01-28,605,10849,4.8
13151,Henry County,2021-01-29,480,11329,5
13151,Henry County,2021-01-30,144,11473,5.1
13151,Henry County,2021-01-31,30,11503,5.1
13151,Henry County,2021-02-01,177,11680,5.2
13151,Henry County,2021-02-02,196,11876,5.3
13151,Henry County,2021-02-03,245,12121,5.4
13151,Henry County,2021-02-04,372,12493,5.5
13151,Henry County,2021-02-05,316,12809,5.7
13151,Henry County,2021-02-06,177,12986,5.8
13151,Henry County,2021-02-07,44,13030,5.8
13151,Henry County,2021-02-08,213,13243,5.9
13151,Henry County,2021-02-09,241,13484,6
13151,Henry County,2021-02-10,331,13815,6.1
13151,Henry County,2021-02-11,333,14148,6.3
13151,Henry County,2021-02-12,290,14438,6.4
13151,Henry County,2021-02-13,164,14602,6.5
13151,Henry County,2021-02-14,85,14687,6.5
13151,Henry County,2021-02-15,261,14948,6.6
13151,Henry County,2021-02-16,605,15553,6.9
13151,Henry County,2021-02-17,503,16056,7.1
13151,Henry County,2021-02-18,303,16359,7.3
13151,Henry County,2021-02-19,454,16813,7.5
13151,Henry County,2021-02-20,101,16914,7.5
13151,Henry County,2021-02-21,69,16983,7.5
13151,Henry County,2021-02-22,232,17215,7.6
13151,Henry County,2021-02-23,750,17965,8
13151,Henry County,2021-02-24,591,18556,8.2
13151,Henry County,2021-02-25,650,19206,8.5
13151,Henry County,2021-02-26,569,19775,8.8
13151,Henry County,2021-02-27,193,19968,8.9
13151,Henry County,2021-02-28,173,20141,8.9
13151,Henry County,2021-03-01,427,20568,9.1
13151,Henry County,2021-03-02,785,21353,9.5
13151,Henry County,2021-03-03,664,22017,9.8
13151,Henry County,2021-03-04,822,22839,10.1
13151,Henry County,2021-03-05,922,23761,10.5
13151,Henry County,2021-03-06,213,23974,10.6
13151,Henry County,2021-03-07,228,24202,10.7
13151,Henry County,2021-03-08,760,24962,11.1
13151,Henry County,2021-03-09,1122,26084,11.6
13151,Henry County,2021-03-10,1081,27165,12.1
13151,Henry County,2021-03-11,1172,28337,12.6
13151,Henry County,2021-03-12,1300,29637,13.2
13151,Henry County,2021-03-13,606,30243,13.4
13151,Henry County,2021-03-14,440,30683,13.6
13151,Henry County,2021-03-15,959,31642,14
13151,Henry County,2021-03-16,1170,32812,14.6
13151,Henry County,2021-03-17,1002,33814,15
13151,Henry County,2021-03-18,913,34727,15.4
13151,Henry County,2021-03-19,1339,36066,16
13151,Henry County,2021-03-20,545,36611,16.2
13151,Henry County,2021-03-21,408,37019,16.4
13151,Henry County,2021-03-22,832,37851,16.8
13151,Henry County,2021-03-23,1144,38995,17.3
13151,Henry County,2021-03-24,1234,40229,17.9
13151,Henry County,2021-03-25,1849,42078,18.7
13151,Henry County,2021-03-26,1104,43182,19.2
13151,Henry County,2021-03-27,628,43810,19.4
13151,Henry County,2021-03-28,440,44250,19.6
13151,Henry County,2021-03-29,1008,45258,20.1
13151,Henry County,2021-03-30,1386,46644,20.7
13151,Henry County,2021-03-31,1347,47991,21.3
13151,Henry County,2021-04-01,1561,49552,22
13151,Henry County,2021-04-02,1024,50576,22.4
13151,Henry County,2021-04-03,469,51045,22.7
13151,Henry County,2021-04-04,260,51305,22.8
13151,Henry County,2021-04-05,858,52163,23.1
13151,Henry County,2021-04-06,1586,53749,23.9
13151,Henry County,2021-04-07,1325,55074,24.4
13151,Henry County,2021-04-08,1078,56152,24.9
13151,Henry County,2021-04-09,1573,57725,25.6
13151,Henry County,2021-04-10,861,58586,26
13151,Henry County,2021-04-11,352,58938,26.2
13151,Henry County,2021-04-12,741,59679,26.5
13151,Henry County,2021-04-13,958,60637,26.9
13151,Henry County,2021-04-14,818,61455,27.3
13151,Henry County,2021-04-15,794,62249,27.6
13151,Henry County,2021-04-16,882,63131,28
13151,Henry County,2021-04-17,222,63353,28.1
13151,Henry County,2021-04-18,223,63576,28.2
13151,Henry County,2021-04-19,490,64066,28.4
13151,Henry County,2021-04-20,699,64765,28.7
13151,Henry County,2021-04-21,553,65318,29
13151,Henry County,2021-04-22,598,65916,29.2
13151,Henry County,2021-04-23,712,66628,29.6
13151,Henry County,2021-04-24,307,66935,29.7
13151,Henry County,2021-04-25,206,67141,29.8
13151,Henry County,2021-04-26,457,67598,30
13151,Henry County,2021-04-27,498,68096,30.2
13151,Henry County,2021-04-28,520,68616,30.4
13151,Henry County,2021-04-29,484,69100,30.7
13151,Henry County,2021-04-30,607,69707,30.9
13151,Henry County,2021-05-01,315,70022,31.1
13151,Henry County,2021-05-02,215,70237,31.2
13151,Henry County,2021-05-03,298,70535,31.3
13151,Henry County,2021-05-04,470,71005,31.5
13151,Henry County,2021-05-05,430,71435,31.7
13151,Henry County,2021-05-06,342,71777,31.9
13151,Henry County,2021-05-07,381,72158,32
13151,Henry County,2021-05-08,211,72369,32.1
13151,Henry County,2021-05-09,106,72475,32.2
13151,Henry County,2021-05-10,241,72716,32.3
13151,Henry County,2021-05-11,439,73155,32.5
13151,Henry County,2021-05-12,319,73474,32.6
13151,Henry County,2021-05-13,406,73880,32.8
13151,Henry County,2021-05-14,503,74383,33
13151,Henry County,2021-05-15,451,74834,33.2
13151,Henry County,2021-05-16,278,75112,33.3
13151,Henry County,2021-05-17,431,75543,33.5
13151,Henry County,2021-05-18,511,76054,33.7
13151,Henry County,2021-05-19,429,76483,33.9
13151,Henry County,2021-05-20,378,76861,34.1
13151,Henry County,2021-05-21,384,77245,34.3
13151,Henry County,2021-05-22,344,77589,34.4
13151,Henry County,2021-05-23,180,77769,34.5
13151,Henry County,2021-05-24,288,78057,34.6
13151,Henry County,2021-05-25,295,78352,34.8
13151,Henry County,2021-05-26,327,78679,34.9
13151,Henry County,2021-05-27,337,79016,35.1
13151,Henry County,2021-05-28,316,79332,35.2
13151,Henry County,2021-05-29,201,79533,35.3
13151,Henry County,2021-05-30,157,79690,35.4
13151,Henry County,2021-05-31,26,79716,35.4
13151,Henry County,2021-06-01,308,80024,35.5
13151,Henry County,2021-06-02,298,80322,35.6
13151,Henry County,2021-06-03,239,80561,35.7
13151,Henry County,2021-06-04,298,80859,35.9
13151,Henry County,2021-06-05,150,81009,35.9
13151,Henry County,2021-06-06,124,81133,36
13151,Henry County,2021-06-07,246,81379,36.1
13151,Henry County,2021-06-08,214,81593,36.2
13151,Henry County,2021-06-09,213,81806,36.3
13151,Henry County,2021-06-10,198,82004,36.4
13151,Henry County,2021-06-11,203,82207,36.5
13151,Henry County,2021-06-12,123,82330,36.5
13151,Henry County,2021-06-13,61,82391,36.6
13151,Henry County,2021-06-14,208,82599,36.7
13151,Henry County,2021-06-15,173,82772,36.7
13151,Henry County,2021-06-16,144,82916,36.8
13151,Henry County,2021-06-17,178,83094,36.9
13151,Henry County,2021-06-18,185,83279,37
13151,Henry County,2021-06-19,120,83399,37
13151,Henry County,2021-06-20,94,83493,37
13151,Henry County,2021-06-21,187,83680,37.1
13151,Henry County,2021-06-22,163,83843,37.2
13151,Henry County,2021-06-23,158,84001,37.3
13151,Henry County,2021-06-24,152,84153,37.3
13151,Henry County,2021-06-25,199,84352,37.4
13151,Henry County,2021-06-26,132,84484,37.5
13151,Henry County,2021-06-27,88,84572,37.5
13151,Henry County,2021-06-28,156,84728,37.6
13151,Henry County,2021-06-29,142,84870,37.7
13151,Henry County,2021-06-30,148,85018,37.7
13151,Henry County,2021-07-01,170,85188,37.8
13151,Henry County,2021-07-02,171,85359,37.9
13151,Henry County,2021-07-03,113,85472,37.9
13151,Henry County,2021-07-04,16,85488,37.9
13151,Henry County,2021-07-05,130,85618,38
13151,Henry County,2021-07-06,148,85766,38.1
13151,Henry County,2021-07-07,136,85902,38.1
13151,Henry County,2021-07-08,160,86062,38.2
13151,Henry County,2021-07-09,184,86246,38.3
13151,Henry County,2021-07-10,157,86403,38.3
13151,Henry County,2021-07-11,113,86516,38.4
13151,Henry County,2021-07-12,173,86689,38.5
13151,Henry County,2021-07-13,169,86858,38.5
13151,Henry County,2021-07-14,162,87020,38.6
13151,Henry County,2021-07-15,159,87179,38.7
13151,Henry County,2021-07-16,204,87383,38.8
13151,Henry County,2021-07-17,151,87534,38.8
13151,Henry County,2021-07-18,122,87656,38.9
13151,Henry County,2021-07-19,213,87869,39
13151,Henry County,2021-07-20,231,88100,39.1
13151,Henry County,2021-07-21,248,88348,39.2
13151,Henry County,2021-07-22,294,88642,39.3
13151,Henry County,2021-07-23,314,88956,39.5
13151,Henry County,2021-07-24,197,89153,39.6
13151,Henry County,2021-07-25,166,89319,39.6
13151,Henry County,2021-07-26,297,89616,39.8
13151,Henry County,2021-07-27,320,89936,39.9
13151,Henry County,2021-07-28,327,90263,40.1
13151,Henry County,2021-07-29,332,90595,40.2
13151,Henry County,2021-07-30,392,90987,40.4
13151,Henry County,2021-07-31,295,91282,40.5
13151,Henry County,2021-08-01,228,91510,40.6
13151,Henry County,2021-08-02,396,91906,40.8
13151,Henry County,2021-08-03,409,92315,41
13151,Henry County,2021-08-04,380,92695,41.1
13151,Henry County,2021-08-05,431,93126,41.3
13151,Henry County,2021-08-06,489,93615,41.5
13151,Henry County,2021-08-07,344,93959,41.7
13151,Henry County,2021-08-08,240,94199,41.8
13151,Henry County,2021-08-09,398,94597,42
13151,Henry County,2021-08-10,418,95015,42.2
13151,Henry County,2021-08-11,410,95425,42.3
13151,Henry County,2021-08-12,363,95788,42.5
13151,Henry County,2021-08-13,455,96243,42.7
13151,Henry County,2021-08-14,312,96555,42.8
13151,Henry County,2021-08-15,193,96748,42.9
13151,Henry County,2021-08-16,322,97070,43.1
13151,Henry County,2021-08-17,292,97362,43.2
13151,Henry County,2021-08-18,341,97703,43.4
13151,Henry County,2021-08-19,312,98015,43.5
13151,Henry County,2021-08-20,345,98360,43.6
13151,Henry County,2021-08-21,244,98604,43.8
13151,Henry County,2021-08-22,162,98766,43.8
13151,Henry County,2021-08-23,293,99059,44
13151,Henry County,2021-08-24,285,99344,44.1
13151,Henry County,2021-08-25,305,99649,44.2
13151,Henry County,2021-08-26,344,99993,44.4
13151,Henry County,2021-08-27,370,100363,44.5
13151,Henry County,2021-08-28,323,100686,44.7
13151,Henry County,2021-08-29,150,100836,44.7
13151,Henry County,2021-08-30,302,101138,44.9
13151,Henry County,2021-08-31,302,101440,45
13151,Henry County,2021-09-01,348,101788,45.2
13151,Henry County,2021-09-02,284,102072,45.3
13151,Henry County,2021-09-03,401,102473,45.5
13151,Henry County,2021-09-04,202,102675,45.6
13151,Henry County,2021-09-05,203,102878,45.7
13151,Henry County,2021-09-06,55,102933,45.7
13151,Henry County,2021-09-07,267,103200,45.8
13151,Henry County,2021-09-08,316,103516,45.9
13151,Henry County,2021-09-09,311,103827,46.1
13151,Henry County,2021-09-10,283,104110,46.2
13151,Henry County,2021-09-11,217,104327,46.3
13151,Henry County,2021-09-12,130,104457,46.4
13151,Henry County,2021-09-13,259,104716,46.5
13151,Henry County,2021-09-14,222,104938,46.6
13151,Henry County,2021-09-15,230,105168,46.7
13151,Henry County,2021-09-16,190,105358,46.8
13151,Henry County,2021-09-17,239,105597,46.9
13151,Henry County,2021-09-18,188,105785,46.9
13151,Henry County,2021-09-19,127,105912,47
13151,Henry County,2021-09-20,203,106115,47.1
13151,Henry County,2021-09-21,199,106314,47.2
13151,Henry County,2021-09-22,172,106486,47.3
13151,Henry County,2021-09-23,192,106678,47.3
13151,Henry County,2021-09-24,131,106809,47.4
13151,Henry County,2021-09-25,89,106898,47.4
13151,Henry County,2021-09-26,55,106953,47.5
13151,Henry County,2021-09-27,87,107040,47.5
13151,Henry County,2021-09-28,86,107126,47.5
13151,Henry County,2021-09-29,78,107204,47.6
13151,Henry County,2021-09-30,98,107302,47.6
13151,Henry County,2021-10-01,100,107402,47.7
13151,Henry County,2021-10-02,59,107461,47.7
13151,Henry County,2021-10-03,44,107505,47.7
13151,Henry County,2021-10-04,35,107540,47.7
13151,Henry County,2021-10-05,41,107581,47.7
13151,Henry County,2021-10-06,63,107644,47.8
13151,Henry County,2021-10-07,33,107677,47.8
13153,Houston County,2020-12-16,3,3,0
13153,Houston County,2020-12-17,6,9,0
13153,Houston County,2020-12-18,10,19,0
13153,Houston County,2020-12-19,4,23,0
13153,Houston County,2020-12-20,5,28,0
13153,Houston County,2020-12-21,12,40,0
13153,Houston County,2020-12-22,63,103,0.1
13153,Houston County,2020-12-23,213,316,0.2
13153,Houston County,2020-12-24,148,464,0.3
13153,Houston County,2020-12-25,13,477,0.3
13153,Houston County,2020-12-26,74,551,0.4
13153,Houston County,2020-12-27,26,577,0.4
13153,Houston County,2020-12-28,203,780,0.5
13153,Houston County,2020-12-29,346,1126,0.7
13153,Houston County,2020-12-30,213,1339,0.9
13153,Houston County,2020-12-31,104,1443,0.9
13153,Houston County,2021-01-01,21,1464,1
13153,Houston County,2021-01-02,36,1500,1
13153,Houston County,2021-01-03,28,1528,1
13153,Houston County,2021-01-04,129,1657,1.1
13153,Houston County,2021-01-05,336,1993,1.3
13153,Houston County,2021-01-06,208,2201,1.4
13153,Houston County,2021-01-07,307,2508,1.6
13153,Houston County,2021-01-08,123,2631,1.7
13153,Houston County,2021-01-09,38,2669,1.7
13153,Houston County,2021-01-10,11,2680,1.7
13153,Houston County,2021-01-11,200,2880,1.9
13153,Houston County,2021-01-12,421,3301,2.2
13153,Houston County,2021-01-13,467,3768,2.5
13153,Houston County,2021-01-14,502,4270,2.8
13153,Houston County,2021-01-15,384,4654,3
13153,Houston County,2021-01-16,272,4926,3.2
13153,Houston County,2021-01-17,79,5005,3.3
13153,Houston County,2021-01-18,465,5470,3.6
13153,Houston County,2021-01-19,236,5706,3.7
13153,Houston County,2021-01-20,707,6413,4.2
13153,Houston County,2021-01-21,303,6716,4.4
13153,Houston County,2021-01-22,723,7439,4.8
13153,Houston County,2021-01-23,102,7541,4.9
13153,Houston County,2021-01-24,31,7572,4.9
13153,Houston County,2021-01-25,515,8087,5.3
13153,Houston County,2021-01-26,338,8425,5.5
13153,Houston County,2021-01-27,889,9314,6.1
13153,Houston County,2021-01-28,558,9872,6.4
13153,Houston County,2021-01-29,835,10707,7
13153,Houston County,2021-01-30,53,10760,7
13153,Houston County,2021-01-31,5,10765,7
13153,Houston County,2021-02-01,363,11128,7.2
13153,Houston County,2021-02-02,131,11259,7.3
13153,Houston County,2021-02-03,379,11638,7.6
13153,Houston County,2021-02-04,177,11815,7.7
13153,Houston County,2021-02-05,329,12144,7.9
13153,Houston County,2021-02-06,37,12181,7.9
13153,Houston County,2021-02-07,7,12188,7.9
13153,Houston County,2021-02-08,384,12572,8.2
13153,Houston County,2021-02-09,255,12827,8.4
13153,Houston County,2021-02-10,387,13214,8.6
13153,Houston County,2021-02-11,275,13489,8.8
13153,Houston County,2021-02-12,376,13865,9
13153,Houston County,2021-02-13,69,13934,9.1
13153,Houston County,2021-02-14,18,13952,9.1
13153,Houston County,2021-02-15,267,14219,9.3
13153,Houston County,2021-02-16,158,14377,9.4
13153,Houston County,2021-02-17,159,14536,9.5
13153,Houston County,2021-02-18,142,14678,9.6
13153,Houston County,2021-02-19,71,14749,9.6
13153,Houston County,2021-02-20,40,14789,9.6
13153,Houston County,2021-02-21,3,14792,9.6
13153,Houston County,2021-02-22,123,14915,9.7
13153,Houston County,2021-02-23,174,15089,9.8
13153,Houston County,2021-02-24,224,15313,10
13153,Houston County,2021-02-25,295,15608,10.2
13153,Houston County,2021-02-26,372,15980,10.4
13153,Houston County,2021-02-27,46,16026,10.4
13153,Houston County,2021-02-28,94,16120,10.5
13153,Houston County,2021-03-01,643,16763,10.9
13153,Houston County,2021-03-02,335,17098,11.1
13153,Houston County,2021-03-03,544,17642,11.5
13153,Houston County,2021-03-04,443,18085,11.8
13153,Houston County,2021-03-05,484,18569,12.1
13153,Houston County,2021-03-06,87,18656,12.2
13153,Houston County,2021-03-07,119,18775,12.2
13153,Houston County,2021-03-08,854,19629,12.8
13153,Houston County,2021-03-09,765,20394,13.3
13153,Houston County,2021-03-10,1101,21495,14
13153,Houston County,2021-03-11,568,22063,14.4
13153,Houston County,2021-03-12,953,23016,15
13153,Houston County,2021-03-13,177,23193,15.1
13153,Houston County,2021-03-14,150,23343,15.2
13153,Houston County,2021-03-15,1556,24899,16.2
13153,Houston County,2021-03-16,1031,25930,16.9
13153,Houston County,2021-03-17,1209,27139,17.7
13153,Houston County,2021-03-18,716,27855,18.1
13153,Houston County,2021-03-19,1372,29227,19
13153,Houston County,2021-03-20,192,29419,19.2
13153,Houston County,2021-03-21,150,29569,19.3
13153,Houston County,2021-03-22,892,30461,19.8
13153,Houston County,2021-03-23,612,31073,20.2
13153,Houston County,2021-03-24,740,31813,20.7
13153,Houston County,2021-03-25,912,32725,21.3
13153,Houston County,2021-03-26,1097,33822,22
13153,Houston County,2021-03-27,282,34104,22.2
13153,Houston County,2021-03-28,141,34245,22.3
13153,Houston County,2021-03-29,841,35086,22.9
13153,Houston County,2021-03-30,605,35691,23.3
13153,Houston County,2021-03-31,924,36615,23.9
13153,Houston County,2021-04-01,861,37476,24.4
13153,Houston County,2021-04-02,645,38121,24.8
13153,Houston County,2021-04-03,257,38378,25
13153,Houston County,2021-04-04,127,38505,25.1
13153,Houston County,2021-04-05,684,39189,25.5
13153,Houston County,2021-04-06,586,39775,25.9
13153,Houston County,2021-04-07,781,40556,26.4
13153,Houston County,2021-04-08,597,41153,26.8
13153,Houston County,2021-04-09,727,41880,27.3
13153,Houston County,2021-04-10,294,42174,27.5
13153,Houston County,2021-04-11,145,42319,27.6
13153,Houston County,2021-04-12,395,42714,27.8
13153,Houston County,2021-04-13,330,43044,28
13153,Houston County,2021-04-14,365,43409,28.3
13153,Houston County,2021-04-15,351,43760,28.5
13153,Houston County,2021-04-16,345,44105,28.7
13153,Houston County,2021-04-17,119,44224,28.8
13153,Houston County,2021-04-18,64,44288,28.9
13153,Houston County,2021-04-19,278,44566,29
13153,Houston County,2021-04-20,319,44885,29.2
13153,Houston County,2021-04-21,294,45179,29.4
13153,Houston County,2021-04-22,295,45474,29.6
13153,Houston County,2021-04-23,365,45839,29.9
13153,Houston County,2021-04-24,101,45940,29.9
13153,Houston County,2021-04-25,43,45983,30
13153,Houston County,2021-04-26,270,46253,30.1
13153,Houston County,2021-04-27,242,46495,30.3
13153,Houston County,2021-04-28,259,46754,30.5
13153,Houston County,2021-04-29,199,46953,30.6
13153,Houston County,2021-04-30,264,47217,30.8
13153,Houston County,2021-05-01,119,47336,30.8
13153,Houston County,2021-05-02,67,47403,30.9
13153,Houston County,2021-05-03,156,47559,31
13153,Houston County,2021-05-04,242,47801,31.1
13153,Houston County,2021-05-05,220,48021,31.3
13153,Houston County,2021-05-06,164,48185,31.4
13153,Houston County,2021-05-07,248,48433,31.6
13153,Houston County,2021-05-08,105,48538,31.6
13153,Houston County,2021-05-09,40,48578,31.6
13153,Houston County,2021-05-10,135,48713,31.7
13153,Houston County,2021-05-11,201,48914,31.9
13153,Houston County,2021-05-12,197,49111,32
13153,Houston County,2021-05-13,186,49297,32.1
13153,Houston County,2021-05-14,288,49585,32.3
13153,Houston County,2021-05-15,170,49755,32.4
13153,Houston County,2021-05-16,147,49902,32.5
13153,Houston County,2021-05-17,358,50260,32.7
13153,Houston County,2021-05-18,351,50611,33
13153,Houston County,2021-05-19,395,51006,33.2
13153,Houston County,2021-05-20,337,51343,33.4
13153,Houston County,2021-05-21,347,51690,33.7
13153,Houston County,2021-05-22,160,51850,33.8
13153,Houston County,2021-05-23,82,51932,33.8
13153,Houston County,2021-05-24,187,52119,34
13153,Houston County,2021-05-25,148,52267,34
13153,Houston County,2021-05-26,175,52442,34.2
13153,Houston County,2021-05-27,134,52576,34.2
13153,Houston County,2021-05-28,148,52724,34.3
13153,Houston County,2021-05-29,74,52798,34.4
13153,Houston County,2021-05-30,58,52856,34.4
13153,Houston County,2021-05-31,29,52885,34.5
13153,Houston County,2021-06-01,154,53039,34.6
13153,Houston County,2021-06-02,179,53218,34.7
13153,Houston County,2021-06-03,110,53328,34.7
13153,Houston County,2021-06-04,138,53466,34.8
13153,Houston County,2021-06-05,92,53558,34.9
13153,Houston County,2021-06-06,68,53626,34.9
13153,Houston County,2021-06-07,146,53772,35
13153,Houston County,2021-06-08,119,53891,35.1
13153,Houston County,2021-06-09,112,54003,35.2
13153,Houston County,2021-06-10,120,54123,35.3
13153,Houston County,2021-06-11,122,54245,35.3
13153,Houston County,2021-06-12,75,54320,35.4
13153,Houston County,2021-06-13,24,54344,35.4
13153,Houston County,2021-06-14,114,54458,35.5
13153,Houston County,2021-06-15,80,54538,35.5
13153,Houston County,2021-06-16,103,54641,35.6
13153,Houston County,2021-06-17,102,54743,35.7
13153,Houston County,2021-06-18,97,54840,35.7
13153,Houston County,2021-06-19,52,54892,35.8
13153,Houston County,2021-06-20,19,54911,35.8
13153,Houston County,2021-06-21,107,55018,35.8
13153,Houston County,2021-06-22,86,55104,35.9
13153,Houston County,2021-06-23,117,55221,36
13153,Houston County,2021-06-24,88,55309,36
13153,Houston County,2021-06-25,118,55427,36.1
13153,Houston County,2021-06-26,66,55493,36.2
13153,Houston County,2021-06-27,36,55529,36.2
13153,Houston County,2021-06-28,103,55632,36.2
13153,Houston County,2021-06-29,86,55718,36.3
13153,Houston County,2021-06-30,103,55821,36.4
13153,Houston County,2021-07-01,79,55900,36.4
13153,Houston County,2021-07-02,87,55987,36.5
13153,Houston County,2021-07-03,57,56044,36.5
13153,Houston County,2021-07-04,9,56053,36.5
13153,Houston County,2021-07-05,60,56113,36.6
13153,Houston County,2021-07-06,93,56206,36.6
13153,Houston County,2021-07-07,83,56289,36.7
13153,Houston County,2021-07-08,77,56366,36.7
13153,Houston County,2021-07-09,86,56452,36.8
13153,Houston County,2021-07-10,51,56503,36.8
13153,Houston County,2021-07-11,41,56544,36.8
13153,Houston County,2021-07-12,87,56631,36.9
13153,Houston County,2021-07-13,71,56702,36.9
13153,Houston County,2021-07-14,112,56814,37
13153,Houston County,2021-07-15,101,56915,37.1
13153,Houston County,2021-07-16,125,57040,37.2
13153,Houston County,2021-07-17,101,57141,37.2
13153,Houston County,2021-07-18,37,57178,37.2
13153,Houston County,2021-07-19,142,57320,37.3
13153,Houston County,2021-07-20,133,57453,37.4
13153,Houston County,2021-07-21,186,57639,37.5
13153,Houston County,2021-07-22,188,57827,37.7
13153,Houston County,2021-07-23,254,58081,37.8
13153,Houston County,2021-07-24,189,58270,38
13153,Houston County,2021-07-25,106,58376,38
13153,Houston County,2021-07-26,234,58610,38.2
13153,Houston County,2021-07-27,208,58818,38.3
13153,Houston County,2021-07-28,265,59083,38.5
13153,Houston County,2021-07-29,266,59349,38.7
13153,Houston County,2021-07-30,365,59714,38.9
13153,Houston County,2021-07-31,203,59917,39
13153,Houston County,2021-08-01,145,60062,39.1
13153,Houston County,2021-08-02,196,60258,39.3
13153,Houston County,2021-08-03,238,60496,39.4
13153,Houston County,2021-08-04,251,60747,39.6
13153,Houston County,2021-08-05,238,60985,39.7
13153,Houston County,2021-08-06,323,61308,39.9
13153,Houston County,2021-08-07,200,61508,40.1
13153,Houston County,2021-08-08,180,61688,40.2
13153,Houston County,2021-08-09,286,61974,40.4
13153,Houston County,2021-08-10,290,62264,40.6
13153,Houston County,2021-08-11,282,62546,40.7
13153,Houston County,2021-08-12,282,62828,40.9
13153,Houston County,2021-08-13,376,63204,41.2
13153,Houston County,2021-08-14,207,63411,41.3
13153,Houston County,2021-08-15,124,63535,41.4
13153,Houston County,2021-08-16,266,63801,41.6
13153,Houston County,2021-08-17,249,64050,41.7
13153,Houston County,2021-08-18,264,64314,41.9
13153,Houston County,2021-08-19,270,64584,42.1
13153,Houston County,2021-08-20,335,64919,42.3
13153,Houston County,2021-08-21,191,65110,42.4
13153,Houston County,2021-08-22,140,65250,42.5
13153,Houston County,2021-08-23,277,65527,42.7
13153,Houston County,2021-08-24,302,65829,42.9
13153,Houston County,2021-08-25,261,66090,43.1
13153,Houston County,2021-08-26,290,66380,43.2
13153,Houston County,2021-08-27,340,66720,43.5
13153,Houston County,2021-08-28,191,66911,43.6
13153,Houston County,2021-08-29,136,67047,43.7
13153,Houston County,2021-08-30,243,67290,43.8
13153,Houston County,2021-08-31,238,67528,44
13153,Houston County,2021-09-01,246,67774,44.2
13153,Houston County,2021-09-02,229,68003,44.3
13153,Houston County,2021-09-03,317,68320,44.5
13153,Houston County,2021-09-04,157,68477,44.6
13153,Houston County,2021-09-05,92,68569,44.7
13153,Houston County,2021-09-06,49,68618,44.7
13153,Houston County,2021-09-07,216,68834,44.8
13153,Houston County,2021-09-08,246,69080,45
13153,Houston County,2021-09-09,218,69298,45.1
13153,Houston County,2021-09-10,299,69597,45.3
13153,Houston County,2021-09-11,145,69742,45.4
13153,Houston County,2021-09-12,93,69835,45.5
13153,Houston County,2021-09-13,186,70021,45.6
13153,Houston County,2021-09-14,182,70203,45.7
13153,Houston County,2021-09-15,156,70359,45.8
13153,Houston County,2021-09-16,158,70517,45.9
13153,Houston County,2021-09-17,175,70692,46.1
13153,Houston County,2021-09-18,103,70795,46.1
13153,Houston County,2021-09-19,58,70853,46.2
13153,Houston County,2021-09-20,133,70986,46.2
13153,Houston County,2021-09-21,132,71118,46.3
13153,Houston County,2021-09-22,108,71226,46.4
13153,Houston County,2021-09-23,104,71330,46.5
13153,Houston County,2021-09-24,111,71441,46.5
13153,Houston County,2021-09-25,44,71485,46.6
13153,Houston County,2021-09-26,37,71522,46.6
13153,Houston County,2021-09-27,54,71576,46.6
13153,Houston County,2021-09-28,55,71631,46.7
13153,Houston County,2021-09-29,79,71710,46.7
13153,Houston County,2021-09-30,42,71752,46.7
13153,Houston County,2021-10-01,75,71827,46.8
13153,Houston County,2021-10-02,33,71860,46.8
13153,Houston County,2021-10-03,16,71876,46.8
13153,Houston County,2021-10-04,36,71912,46.8
13153,Houston County,2021-10-05,39,71951,46.9
13153,Houston County,2021-10-06,51,72002,46.9
13153,Houston County,2021-10-07,30,72032,46.9
13155,Irwin County,2020-12-18,1,1,0
13155,Irwin County,2020-12-19,1,2,0
13155,Irwin County,2020-12-21,1,3,0
13155,Irwin County,2020-12-22,6,9,0.1
13155,Irwin County,2020-12-23,12,21,0.2
13155,Irwin County,2020-12-24,1,22,0.2
13155,Irwin County,2020-12-26,1,23,0.2
13155,Irwin County,2020-12-28,38,61,0.7
13155,Irwin County,2020-12-29,21,82,0.9
13155,Irwin County,2020-12-30,15,97,1
13155,Irwin County,2020-12-31,13,110,1.2
13155,Irwin County,2021-01-03,1,111,1.2
13155,Irwin County,2021-01-04,32,143,1.5
13155,Irwin County,2021-01-05,21,164,1.8
13155,Irwin County,2021-01-06,26,190,2
13155,Irwin County,2021-01-07,19,209,2.2
13155,Irwin County,2021-01-08,22,231,2.5
13155,Irwin County,2021-01-09,1,232,2.5
13155,Irwin County,2021-01-10,4,236,2.5
13155,Irwin County,2021-01-11,42,278,3
13155,Irwin County,2021-01-12,59,337,3.6
13155,Irwin County,2021-01-13,72,409,4.4
13155,Irwin County,2021-01-14,85,494,5.3
13155,Irwin County,2021-01-15,49,543,5.8
13155,Irwin County,2021-01-16,3,546,5.9
13155,Irwin County,2021-01-18,41,587,6.3
13155,Irwin County,2021-01-19,47,634,6.8
13155,Irwin County,2021-01-20,36,670,7.2
13155,Irwin County,2021-01-21,38,708,7.6
13155,Irwin County,2021-01-22,46,754,8.1
13155,Irwin County,2021-01-24,1,755,8.1
13155,Irwin County,2021-01-25,18,773,8.3
13155,Irwin County,2021-01-26,67,840,9
13155,Irwin County,2021-01-27,55,895,9.6
13155,Irwin County,2021-01-28,54,949,10.2
13155,Irwin County,2021-01-29,20,969,10.4
13155,Irwin County,2021-01-30,1,970,10.4
13155,Irwin County,2021-02-01,15,985,10.6
13155,Irwin County,2021-02-02,10,995,10.7
13155,Irwin County,2021-02-03,28,1023,11
13155,Irwin County,2021-02-04,9,1032,11.1
13155,Irwin County,2021-02-05,6,1038,11.1
13155,Irwin County,2021-02-06,1,1039,11.1
13155,Irwin County,2021-02-08,15,1054,11.3
13155,Irwin County,2021-02-09,20,1074,11.5
13155,Irwin County,2021-02-10,32,1106,11.9
13155,Irwin County,2021-02-11,32,1138,12.2
13155,Irwin County,2021-02-12,9,1147,12.3
13155,Irwin County,2021-02-14,1,1148,12.3
13155,Irwin County,2021-02-15,34,1182,12.7
13155,Irwin County,2021-02-16,26,1208,13
13155,Irwin County,2021-02-17,21,1229,13.2
13155,Irwin County,2021-02-18,17,1246,13.4
13155,Irwin County,2021-02-19,16,1262,13.5
13155,Irwin County,2021-02-22,9,1271,13.6
13155,Irwin County,2021-02-23,20,1291,13.9
13155,Irwin County,2021-02-24,25,1316,14.1
13155,Irwin County,2021-02-25,15,1331,14.3
13155,Irwin County,2021-02-26,10,1341,14.4
13155,Irwin County,2021-02-27,3,1344,14.4
13155,Irwin County,2021-03-01,9,1353,14.5
13155,Irwin County,2021-03-02,4,1357,14.6
13155,Irwin County,2021-03-03,17,1374,14.7
13155,Irwin County,2021-03-04,11,1385,14.9
13155,Irwin County,2021-03-05,9,1394,15
13155,Irwin County,2021-03-06,1,1395,15
13155,Irwin County,2021-03-07,1,1396,15
13155,Irwin County,2021-03-08,25,1421,15.2
13155,Irwin County,2021-03-09,22,1443,15.5
13155,Irwin County,2021-03-10,33,1476,15.8
13155,Irwin County,2021-03-11,68,1544,16.6
13155,Irwin County,2021-03-12,29,1573,16.9
13155,Irwin County,2021-03-13,1,1574,16.9
13155,Irwin County,2021-03-15,27,1601,17.2
13155,Irwin County,2021-03-16,24,1625,17.4
13155,Irwin County,2021-03-17,48,1673,18
13155,Irwin County,2021-03-18,51,1724,18.5
13155,Irwin County,2021-03-19,42,1766,18.9
13155,Irwin County,2021-03-20,3,1769,19
13155,Irwin County,2021-03-22,24,1793,19.2
13155,Irwin County,2021-03-23,49,1842,19.8
13155,Irwin County,2021-03-24,34,1876,20.1
13155,Irwin County,2021-03-25,39,1915,20.5
13155,Irwin County,2021-03-26,49,1964,21.1
13155,Irwin County,2021-03-27,4,1968,21.1
13155,Irwin County,2021-03-29,32,2000,21.5
13155,Irwin County,2021-03-30,29,2029,21.8
13155,Irwin County,2021-03-31,30,2059,22.1
13155,Irwin County,2021-04-01,14,2073,22.2
13155,Irwin County,2021-04-02,27,2100,22.5
13155,Irwin County,2021-04-03,3,2103,22.6
13155,Irwin County,2021-04-04,1,2104,22.6
13155,Irwin County,2021-04-05,26,2130,22.9
13155,Irwin County,2021-04-06,33,2163,23.2
13155,Irwin County,2021-04-07,31,2194,23.5
13155,Irwin County,2021-04-08,19,2213,23.7
13155,Irwin County,2021-04-09,40,2253,24.2
13155,Irwin County,2021-04-10,1,2254,24.2
13155,Irwin County,2021-04-12,11,2265,24.3
13155,Irwin County,2021-04-13,17,2282,24.5
13155,Irwin County,2021-04-14,19,2301,24.7
13155,Irwin County,2021-04-15,6,2307,24.8
13155,Irwin County,2021-04-16,10,2317,24.9
13155,Irwin County,2021-04-17,8,2325,24.9
13155,Irwin County,2021-04-18,1,2326,25
13155,Irwin County,2021-04-19,13,2339,25.1
13155,Irwin County,2021-04-20,5,2344,25.2
13155,Irwin County,2021-04-21,6,2350,25.2
13155,Irwin County,2021-04-22,12,2362,25.3
13155,Irwin County,2021-04-23,13,2375,25.5
13155,Irwin County,2021-04-24,4,2379,25.5
13155,Irwin County,2021-04-26,6,2385,25.6
13155,Irwin County,2021-04-27,6,2391,25.7
13155,Irwin County,2021-04-28,10,2401,25.8
13155,Irwin County,2021-04-29,7,2408,25.8
13155,Irwin County,2021-04-30,8,2416,25.9
13155,Irwin County,2021-05-01,3,2419,26
13155,Irwin County,2021-05-02,1,2420,26
13155,Irwin County,2021-05-03,20,2440,26.2
13155,Irwin County,2021-05-04,5,2445,26.2
13155,Irwin County,2021-05-05,13,2458,26.4
13155,Irwin County,2021-05-06,6,2464,26.4
13155,Irwin County,2021-05-07,12,2476,26.6
13155,Irwin County,2021-05-08,3,2479,26.6
13155,Irwin County,2021-05-10,4,2483,26.6
13155,Irwin County,2021-05-11,7,2490,26.7
13155,Irwin County,2021-05-12,10,2500,26.8
13155,Irwin County,2021-05-13,3,2503,26.9
13155,Irwin County,2021-05-14,11,2514,27
13155,Irwin County,2021-05-15,1,2515,27
13155,Irwin County,2021-05-16,2,2517,27
13155,Irwin County,2021-05-17,13,2530,27.1
13155,Irwin County,2021-05-18,16,2546,27.3
13155,Irwin County,2021-05-19,9,2555,27.4
13155,Irwin County,2021-05-20,6,2561,27.5
13155,Irwin County,2021-05-21,7,2568,27.6
13155,Irwin County,2021-05-22,2,2570,27.6
13155,Irwin County,2021-05-23,1,2571,27.6
13155,Irwin County,2021-05-24,13,2584,27.7
13155,Irwin County,2021-05-25,5,2589,27.8
13155,Irwin County,2021-05-26,15,2604,27.9
13155,Irwin County,2021-05-27,8,2612,28
13155,Irwin County,2021-05-28,5,2617,28.1
13155,Irwin County,2021-06-01,3,2620,28.1
13155,Irwin County,2021-06-02,5,2625,28.2
13155,Irwin County,2021-06-03,6,2631,28.2
13155,Irwin County,2021-06-04,13,2644,28.4
13155,Irwin County,2021-06-07,7,2651,28.4
13155,Irwin County,2021-06-08,3,2654,28.5
13155,Irwin County,2021-06-09,7,2661,28.6
13155,Irwin County,2021-06-10,2,2663,28.6
13155,Irwin County,2021-06-11,4,2667,28.6
13155,Irwin County,2021-06-12,4,2671,28.7
13155,Irwin County,2021-06-14,4,2675,28.7
13155,Irwin County,2021-06-15,2,2677,28.7
13155,Irwin County,2021-06-16,3,2680,28.8
13155,Irwin County,2021-06-18,3,2683,28.8
13155,Irwin County,2021-06-19,4,2687,28.8
13155,Irwin County,2021-06-20,2,2689,28.9
13155,Irwin County,2021-06-21,11,2700,29
13155,Irwin County,2021-06-22,6,2706,29
13155,Irwin County,2021-06-23,9,2715,29.1
13155,Irwin County,2021-06-24,6,2721,29.2
13155,Irwin County,2021-06-25,8,2729,29.3
13155,Irwin County,2021-06-26,7,2736,29.4
13155,Irwin County,2021-06-28,3,2739,29.4
13155,Irwin County,2021-06-29,1,2740,29.4
13155,Irwin County,2021-06-30,1,2741,29.4
13155,Irwin County,2021-07-01,2,2743,29.4
13155,Irwin County,2021-07-02,5,2748,29.5
13155,Irwin County,2021-07-05,2,2750,29.5
13155,Irwin County,2021-07-06,8,2758,29.6
13155,Irwin County,2021-07-07,1,2759,29.6
13155,Irwin County,2021-07-08,1,2760,29.6
13155,Irwin County,2021-07-09,6,2766,29.7
13155,Irwin County,2021-07-10,1,2767,29.7
13155,Irwin County,2021-07-12,8,2775,29.8
13155,Irwin County,2021-07-13,2,2777,29.8
13155,Irwin County,2021-07-14,4,2781,29.8
13155,Irwin County,2021-07-15,6,2787,29.9
13155,Irwin County,2021-07-16,2,2789,29.9
13155,Irwin County,2021-07-17,4,2793,30
13155,Irwin County,2021-07-18,3,2796,30
13155,Irwin County,2021-07-19,7,2803,30.1
13155,Irwin County,2021-07-20,4,2807,30.1
13155,Irwin County,2021-07-21,9,2816,30.2
13155,Irwin County,2021-07-22,6,2822,30.3
13155,Irwin County,2021-07-23,22,2844,30.5
13155,Irwin County,2021-07-24,25,2869,30.8
13155,Irwin County,2021-07-25,1,2870,30.8
13155,Irwin County,2021-07-26,15,2885,31
13155,Irwin County,2021-07-27,24,2909,31.2
13155,Irwin County,2021-07-28,18,2927,31.4
13155,Irwin County,2021-07-29,9,2936,31.5
13155,Irwin County,2021-07-30,33,2969,31.9
13155,Irwin County,2021-07-31,7,2976,31.9
13155,Irwin County,2021-08-01,6,2982,32
13155,Irwin County,2021-08-02,23,3005,32.2
13155,Irwin County,2021-08-03,17,3022,32.4
13155,Irwin County,2021-08-04,32,3054,32.8
13155,Irwin County,2021-08-05,30,3084,33.1
13155,Irwin County,2021-08-06,32,3116,33.4
13155,Irwin County,2021-08-07,23,3139,33.7
13155,Irwin County,2021-08-08,3,3142,33.7
13155,Irwin County,2021-08-09,24,3166,34
13155,Irwin County,2021-08-10,19,3185,34.2
13155,Irwin County,2021-08-11,23,3208,34.4
13155,Irwin County,2021-08-12,21,3229,34.6
13155,Irwin County,2021-08-13,30,3259,35
13155,Irwin County,2021-08-14,16,3275,35.1
13155,Irwin County,2021-08-15,5,3280,35.2
13155,Irwin County,2021-08-16,21,3301,35.4
13155,Irwin County,2021-08-17,35,3336,35.8
13155,Irwin County,2021-08-18,35,3371,36.2
13155,Irwin County,2021-08-19,12,3383,36.3
13155,Irwin County,2021-08-20,42,3425,36.7
13155,Irwin County,2021-08-21,18,3443,36.9
13155,Irwin County,2021-08-22,9,3452,37
13155,Irwin County,2021-08-23,15,3467,37.2
13155,Irwin County,2021-08-24,27,3494,37.5
13155,Irwin County,2021-08-25,23,3517,37.7
13155,Irwin County,2021-08-26,16,3533,37.9
13155,Irwin County,2021-08-27,24,3557,38.2
13155,Irwin County,2021-08-28,6,3563,38.2
13155,Irwin County,2021-08-29,5,3568,38.3
13155,Irwin County,2021-08-30,15,3583,38.4
13155,Irwin County,2021-08-31,12,3595,38.6
13155,Irwin County,2021-09-01,12,3607,38.7
13155,Irwin County,2021-09-02,6,3613,38.8
13155,Irwin County,2021-09-03,7,3620,38.8
13155,Irwin County,2021-09-04,3,3623,38.9
13155,Irwin County,2021-09-05,2,3625,38.9
13155,Irwin County,2021-09-06,1,3626,38.9
13155,Irwin County,2021-09-07,12,3638,39
13155,Irwin County,2021-09-08,13,3651,39.2
13155,Irwin County,2021-09-09,8,3659,39.3
13155,Irwin County,2021-09-10,12,3671,39.4
13155,Irwin County,2021-09-11,4,3675,39.4
13155,Irwin County,2021-09-12,6,3681,39.5
13155,Irwin County,2021-09-13,6,3687,39.6
13155,Irwin County,2021-09-14,7,3694,39.6
13155,Irwin County,2021-09-15,9,3703,39.7
13155,Irwin County,2021-09-16,3,3706,39.8
13155,Irwin County,2021-09-17,9,3715,39.9
13155,Irwin County,2021-09-18,2,3717,39.9
13155,Irwin County,2021-09-19,3,3720,39.9
13155,Irwin County,2021-09-20,5,3725,40
13155,Irwin County,2021-09-21,5,3730,40
13155,Irwin County,2021-09-22,4,3734,40.1
13155,Irwin County,2021-09-23,4,3738,40.1
13155,Irwin County,2021-09-24,7,3745,40.2
13155,Irwin County,2021-09-27,1,3746,40.2
13155,Irwin County,2021-09-28,1,3747,40.2
13155,Irwin County,2021-09-29,5,3752,40.3
13155,Irwin County,2021-09-30,3,3755,40.3
13155,Irwin County,2021-10-01,1,3756,40.3
13155,Irwin County,2021-10-02,2,3758,40.3
13155,Irwin County,2021-10-05,1,3759,40.3
13155,Irwin County,2021-10-06,2,3761,40.4
13157,Jackson County,2020-12-16,2,2,0
13157,Jackson County,2020-12-17,1,3,0
13157,Jackson County,2020-12-18,29,32,0
13157,Jackson County,2020-12-19,26,58,0.1
13157,Jackson County,2020-12-20,11,69,0.1
13157,Jackson County,2020-12-21,46,115,0.2
13157,Jackson County,2020-12-22,60,175,0.3
13157,Jackson County,2020-12-23,94,269,0.4
13157,Jackson County,2020-12-24,14,283,0.4
13157,Jackson County,2020-12-25,1,284,0.4
13157,Jackson County,2020-12-26,9,293,0.4
13157,Jackson County,2020-12-27,7,300,0.4
13157,Jackson County,2020-12-28,123,423,0.6
13157,Jackson County,2020-12-29,105,528,0.8
13157,Jackson County,2020-12-30,80,608,0.9
13157,Jackson County,2020-12-31,61,669,1
13157,Jackson County,2021-01-01,10,679,1
13157,Jackson County,2021-01-02,20,699,1
13157,Jackson County,2021-01-03,10,709,1
13157,Jackson County,2021-01-04,83,792,1.2
13157,Jackson County,2021-01-05,66,858,1.3
13157,Jackson County,2021-01-06,111,969,1.4
13157,Jackson County,2021-01-07,52,1021,1.5
13157,Jackson County,2021-01-08,49,1070,1.6
13157,Jackson County,2021-01-09,31,1101,1.6
13157,Jackson County,2021-01-10,22,1123,1.7
13157,Jackson County,2021-01-11,95,1218,1.8
13157,Jackson County,2021-01-12,136,1354,2
13157,Jackson County,2021-01-13,121,1475,2.2
13157,Jackson County,2021-01-14,292,1767,2.6
13157,Jackson County,2021-01-15,148,1915,2.8
13157,Jackson County,2021-01-16,133,2048,3
13157,Jackson County,2021-01-17,67,2115,3.1
13157,Jackson County,2021-01-18,162,2277,3.4
13157,Jackson County,2021-01-19,223,2500,3.7
13157,Jackson County,2021-01-20,275,2775,4.1
13157,Jackson County,2021-01-21,213,2988,4.4
13157,Jackson County,2021-01-22,179,3167,4.7
13157,Jackson County,2021-01-23,156,3323,4.9
13157,Jackson County,2021-01-24,36,3359,4.9
13157,Jackson County,2021-01-25,114,3473,5.1
13157,Jackson County,2021-01-26,249,3722,5.5
13157,Jackson County,2021-01-27,367,4089,6
13157,Jackson County,2021-01-28,257,4346,6.4
13157,Jackson County,2021-01-29,342,4688,6.9
13157,Jackson County,2021-01-30,76,4764,7
13157,Jackson County,2021-01-31,16,4780,7
13157,Jackson County,2021-02-01,84,4864,7.2
13157,Jackson County,2021-02-02,113,4977,7.3
13157,Jackson County,2021-02-03,285,5262,7.8
13157,Jackson County,2021-02-04,205,5467,8.1
13157,Jackson County,2021-02-05,120,5587,8.2
13157,Jackson County,2021-02-06,49,5636,8.3
13157,Jackson County,2021-02-07,4,5640,8.3
13157,Jackson County,2021-02-08,76,5716,8.4
13157,Jackson County,2021-02-09,85,5801,8.5
13157,Jackson County,2021-02-10,255,6056,8.9
13157,Jackson County,2021-02-11,157,6213,9.2
13157,Jackson County,2021-02-12,82,6295,9.3
13157,Jackson County,2021-02-13,48,6343,9.3
13157,Jackson County,2021-02-14,26,6369,9.4
13157,Jackson County,2021-02-15,53,6422,9.5
13157,Jackson County,2021-02-16,59,6481,9.5
13157,Jackson County,2021-02-17,451,6932,10.2
13157,Jackson County,2021-02-18,36,6968,10.3
13157,Jackson County,2021-02-19,72,7040,10.4
13157,Jackson County,2021-02-20,17,7057,10.4
13157,Jackson County,2021-02-21,6,7063,10.4
13157,Jackson County,2021-02-22,56,7119,10.5
13157,Jackson County,2021-02-23,78,7197,10.6
13157,Jackson County,2021-02-24,504,7701,11.3
13157,Jackson County,2021-02-25,65,7766,11.4
13157,Jackson County,2021-02-26,78,7844,11.6
13157,Jackson County,2021-02-27,57,7901,11.6
13157,Jackson County,2021-02-28,51,7952,11.7
13157,Jackson County,2021-03-01,98,8050,11.9
13157,Jackson County,2021-03-02,139,8189,12.1
13157,Jackson County,2021-03-03,268,8457,12.5
13157,Jackson County,2021-03-04,194,8651,12.7
13157,Jackson County,2021-03-05,109,8760,12.9
13157,Jackson County,2021-03-06,62,8822,13
13157,Jackson County,2021-03-07,76,8898,13.1
13157,Jackson County,2021-03-08,214,9112,13.4
13157,Jackson County,2021-03-09,211,9323,13.7
13157,Jackson County,2021-03-10,321,9644,14.2
13157,Jackson County,2021-03-11,417,10061,14.8
13157,Jackson County,2021-03-12,253,10314,15.2
13157,Jackson County,2021-03-13,409,10723,15.8
13157,Jackson County,2021-03-14,42,10765,15.9
13157,Jackson County,2021-03-15,299,11064,16.3
13157,Jackson County,2021-03-16,321,11385,16.8
13157,Jackson County,2021-03-17,333,11718,17.3
13157,Jackson County,2021-03-18,372,12090,17.8
13157,Jackson County,2021-03-19,212,12302,18.1
13157,Jackson County,2021-03-20,114,12416,18.3
13157,Jackson County,2021-03-21,84,12500,18.4
13157,Jackson County,2021-03-22,241,12741,18.8
13157,Jackson County,2021-03-23,371,13112,19.3
13157,Jackson County,2021-03-24,428,13540,19.9
13157,Jackson County,2021-03-25,495,14035,20.7
13157,Jackson County,2021-03-26,287,14322,21.1
13157,Jackson County,2021-03-27,136,14458,21.3
13157,Jackson County,2021-03-28,65,14523,21.4
13157,Jackson County,2021-03-29,312,14835,21.9
13157,Jackson County,2021-03-30,422,15257,22.5
13157,Jackson County,2021-03-31,439,15696,23.1
13157,Jackson County,2021-04-01,376,16072,23.7
13157,Jackson County,2021-04-02,323,16395,24.2
13157,Jackson County,2021-04-03,99,16494,24.3
13157,Jackson County,2021-04-04,87,16581,24.4
13157,Jackson County,2021-04-05,278,16859,24.8
13157,Jackson County,2021-04-06,296,17155,25.3
13157,Jackson County,2021-04-07,329,17484,25.8
13157,Jackson County,2021-04-08,310,17794,26.2
13157,Jackson County,2021-04-09,279,18073,26.6
13157,Jackson County,2021-04-10,175,18248,26.9
13157,Jackson County,2021-04-11,84,18332,27
13157,Jackson County,2021-04-12,203,18535,27.3
13157,Jackson County,2021-04-13,189,18724,27.6
13157,Jackson County,2021-04-14,210,18934,27.9
13157,Jackson County,2021-04-15,156,19090,28.1
13157,Jackson County,2021-04-16,181,19271,28.4
13157,Jackson County,2021-04-17,67,19338,28.5
13157,Jackson County,2021-04-18,36,19374,28.5
13157,Jackson County,2021-04-19,107,19481,28.7
13157,Jackson County,2021-04-20,172,19653,29
13157,Jackson County,2021-04-21,163,19816,29.2
13157,Jackson County,2021-04-22,182,19998,29.5
13157,Jackson County,2021-04-23,154,20152,29.7
13157,Jackson County,2021-04-24,45,20197,29.8
13157,Jackson County,2021-04-25,43,20240,29.8
13157,Jackson County,2021-04-26,110,20350,30
13157,Jackson County,2021-04-27,177,20527,30.2
13157,Jackson County,2021-04-28,191,20718,30.5
13157,Jackson County,2021-04-29,150,20868,30.7
13157,Jackson County,2021-04-30,160,21028,31
13157,Jackson County,2021-05-01,60,21088,31.1
13157,Jackson County,2021-05-02,24,21112,31.1
13157,Jackson County,2021-05-03,104,21216,31.3
13157,Jackson County,2021-05-04,152,21368,31.5
13157,Jackson County,2021-05-05,130,21498,31.7
13157,Jackson County,2021-05-06,132,21630,31.9
13157,Jackson County,2021-05-07,111,21741,32
13157,Jackson County,2021-05-08,66,21807,32.1
13157,Jackson County,2021-05-09,21,21828,32.2
13157,Jackson County,2021-05-10,80,21908,32.3
13157,Jackson County,2021-05-11,111,22019,32.4
13157,Jackson County,2021-05-12,87,22106,32.6
13157,Jackson County,2021-05-13,121,22227,32.7
13157,Jackson County,2021-05-14,140,22367,32.9
13157,Jackson County,2021-05-15,93,22460,33.1
13157,Jackson County,2021-05-16,81,22541,33.2
13157,Jackson County,2021-05-17,125,22666,33.4
13157,Jackson County,2021-05-18,129,22795,33.6
13157,Jackson County,2021-05-19,103,22898,33.7
13157,Jackson County,2021-05-20,108,23006,33.9
13157,Jackson County,2021-05-21,94,23100,34
13157,Jackson County,2021-05-22,73,23173,34.1
13157,Jackson County,2021-05-23,43,23216,34.2
13157,Jackson County,2021-05-24,109,23325,34.4
13157,Jackson County,2021-05-25,70,23395,34.5
13157,Jackson County,2021-05-26,60,23455,34.6
13157,Jackson County,2021-05-27,73,23528,34.7
13157,Jackson County,2021-05-28,87,23615,34.8
13157,Jackson County,2021-05-29,42,23657,34.8
13157,Jackson County,2021-05-30,25,23682,34.9
13157,Jackson County,2021-05-31,11,23693,34.9
13157,Jackson County,2021-06-01,68,23761,35
13157,Jackson County,2021-06-02,62,23823,35.1
13157,Jackson County,2021-06-03,64,23887,35.2
13157,Jackson County,2021-06-04,72,23959,35.3
13157,Jackson County,2021-06-05,51,24010,35.4
13157,Jackson County,2021-06-06,33,24043,35.4
13157,Jackson County,2021-06-07,67,24110,35.5
13157,Jackson County,2021-06-08,64,24174,35.6
13157,Jackson County,2021-06-09,48,24222,35.7
13157,Jackson County,2021-06-10,38,24260,35.7
13157,Jackson County,2021-06-11,60,24320,35.8
13157,Jackson County,2021-06-12,23,24343,35.9
13157,Jackson County,2021-06-13,14,24357,35.9
13157,Jackson County,2021-06-14,41,24398,35.9
13157,Jackson County,2021-06-15,65,24463,36
13157,Jackson County,2021-06-16,34,24497,36.1
13157,Jackson County,2021-06-17,72,24569,36.2
13157,Jackson County,2021-06-18,58,24627,36.3
13157,Jackson County,2021-06-19,26,24653,36.3
13157,Jackson County,2021-06-20,24,24677,36.4
13157,Jackson County,2021-06-21,37,24714,36.4
13157,Jackson County,2021-06-22,46,24760,36.5
13157,Jackson County,2021-06-23,43,24803,36.5
13157,Jackson County,2021-06-24,43,24846,36.6
13157,Jackson County,2021-06-25,56,24902,36.7
13157,Jackson County,2021-06-26,26,24928,36.7
13157,Jackson County,2021-06-27,13,24941,36.7
13157,Jackson County,2021-06-28,37,24978,36.8
13157,Jackson County,2021-06-29,34,25012,36.8
13157,Jackson County,2021-06-30,36,25048,36.9
13157,Jackson County,2021-07-01,38,25086,37
13157,Jackson County,2021-07-02,32,25118,37
13157,Jackson County,2021-07-03,26,25144,37
13157,Jackson County,2021-07-04,3,25147,37
13157,Jackson County,2021-07-05,27,25174,37.1
13157,Jackson County,2021-07-06,23,25197,37.1
13157,Jackson County,2021-07-07,24,25221,37.2
13157,Jackson County,2021-07-08,59,25280,37.2
13157,Jackson County,2021-07-09,44,25324,37.3
13157,Jackson County,2021-07-10,38,25362,37.4
13157,Jackson County,2021-07-11,13,25375,37.4
13157,Jackson County,2021-07-12,42,25417,37.4
13157,Jackson County,2021-07-13,29,25446,37.5
13157,Jackson County,2021-07-14,37,25483,37.5
13157,Jackson County,2021-07-15,41,25524,37.6
13157,Jackson County,2021-07-16,48,25572,37.7
13157,Jackson County,2021-07-17,33,25605,37.7
13157,Jackson County,2021-07-18,29,25634,37.8
13157,Jackson County,2021-07-19,61,25695,37.9
13157,Jackson County,2021-07-20,54,25749,37.9
13157,Jackson County,2021-07-21,49,25798,38
13157,Jackson County,2021-07-22,70,25868,38.1
13157,Jackson County,2021-07-23,63,25931,38.2
13157,Jackson County,2021-07-24,66,25997,38.3
13157,Jackson County,2021-07-25,49,26046,38.4
13157,Jackson County,2021-07-26,81,26127,38.5
13157,Jackson County,2021-07-27,73,26200,38.6
13157,Jackson County,2021-07-28,67,26267,38.7
13157,Jackson County,2021-07-29,96,26363,38.8
13157,Jackson County,2021-07-30,115,26478,39
13157,Jackson County,2021-07-31,76,26554,39.1
13157,Jackson County,2021-08-01,52,26606,39.2
13157,Jackson County,2021-08-02,71,26677,39.3
13157,Jackson County,2021-08-03,93,26770,39.4
13157,Jackson County,2021-08-04,107,26877,39.6
13157,Jackson County,2021-08-05,112,26989,39.8
13157,Jackson County,2021-08-06,143,27132,40
13157,Jackson County,2021-08-07,92,27224,40.1
13157,Jackson County,2021-08-08,68,27292,40.2
13157,Jackson County,2021-08-09,107,27399,40.4
13157,Jackson County,2021-08-10,115,27514,40.5
13157,Jackson County,2021-08-11,130,27644,40.7
13157,Jackson County,2021-08-12,122,27766,40.9
13157,Jackson County,2021-08-13,125,27891,41.1
13157,Jackson County,2021-08-14,80,27971,41.2
13157,Jackson County,2021-08-15,55,28026,41.3
13157,Jackson County,2021-08-16,105,28131,41.4
13157,Jackson County,2021-08-17,110,28241,41.6
13157,Jackson County,2021-08-18,99,28340,41.7
13157,Jackson County,2021-08-19,90,28430,41.9
13157,Jackson County,2021-08-20,133,28563,42.1
13157,Jackson County,2021-08-21,82,28645,42.2
13157,Jackson County,2021-08-22,53,28698,42.3
13157,Jackson County,2021-08-23,114,28812,42.4
13157,Jackson County,2021-08-24,109,28921,42.6
13157,Jackson County,2021-08-25,141,29062,42.8
13157,Jackson County,2021-08-26,135,29197,43
13157,Jackson County,2021-08-27,172,29369,43.3
13157,Jackson County,2021-08-28,103,29472,43.4
13157,Jackson County,2021-08-29,51,29523,43.5
13157,Jackson County,2021-08-30,99,29622,43.6
13157,Jackson County,2021-08-31,150,29772,43.9
13157,Jackson County,2021-09-01,123,29895,44
13157,Jackson County,2021-09-02,121,30016,44.2
13157,Jackson County,2021-09-03,136,30152,44.4
13157,Jackson County,2021-09-04,86,30238,44.5
13157,Jackson County,2021-09-05,59,30297,44.6
13157,Jackson County,2021-09-06,14,30311,44.7
13157,Jackson County,2021-09-07,81,30392,44.8
13157,Jackson County,2021-09-08,102,30494,44.9
13157,Jackson County,2021-09-09,116,30610,45.1
13157,Jackson County,2021-09-10,129,30739,45.3
13157,Jackson County,2021-09-11,74,30813,45.4
13157,Jackson County,2021-09-12,35,30848,45.4
13157,Jackson County,2021-09-13,87,30935,45.6
13157,Jackson County,2021-09-14,74,31009,45.7
13157,Jackson County,2021-09-15,90,31099,45.8
13157,Jackson County,2021-09-16,65,31164,45.9
13157,Jackson County,2021-09-17,92,31256,46
13157,Jackson County,2021-09-18,46,31302,46.1
13157,Jackson County,2021-09-19,25,31327,46.1
13157,Jackson County,2021-09-20,67,31394,46.2
13157,Jackson County,2021-09-21,55,31449,46.3
13157,Jackson County,2021-09-22,43,31492,46.4
13157,Jackson County,2021-09-23,50,31542,46.5
13157,Jackson County,2021-09-24,43,31585,46.5
13157,Jackson County,2021-09-25,23,31608,46.6
13157,Jackson County,2021-09-26,9,31617,46.6
13157,Jackson County,2021-09-27,20,31637,46.6
13157,Jackson County,2021-09-28,18,31655,46.6
13157,Jackson County,2021-09-29,37,31692,46.7
13157,Jackson County,2021-09-30,18,31710,46.7
13157,Jackson County,2021-10-01,23,31733,46.7
13157,Jackson County,2021-10-02,9,31742,46.8
13157,Jackson County,2021-10-03,11,31753,46.8
13157,Jackson County,2021-10-04,20,31773,46.8
13157,Jackson County,2021-10-05,12,31785,46.8
13157,Jackson County,2021-10-06,23,31808,46.9
13157,Jackson County,2021-10-07,19,31827,46.9
13159,Jasper County,2020-12-16,1,1,0
13159,Jasper County,2020-12-17,5,6,0
13159,Jasper County,2020-12-19,1,7,0.1
13159,Jasper County,2020-12-21,1,8,0.1
13159,Jasper County,2020-12-22,5,13,0.1
13159,Jasper County,2020-12-23,12,25,0.2
13159,Jasper County,2020-12-24,1,26,0.2
13159,Jasper County,2020-12-26,4,30,0.2
13159,Jasper County,2020-12-27,1,31,0.2
13159,Jasper County,2020-12-28,16,47,0.3
13159,Jasper County,2020-12-29,27,74,0.5
13159,Jasper County,2020-12-30,10,84,0.6
13159,Jasper County,2020-12-31,15,99,0.7
13159,Jasper County,2021-01-01,1,100,0.7
13159,Jasper County,2021-01-03,1,101,0.7
13159,Jasper County,2021-01-04,19,120,0.9
13159,Jasper County,2021-01-05,13,133,1
13159,Jasper County,2021-01-06,20,153,1.1
13159,Jasper County,2021-01-07,11,164,1.2
13159,Jasper County,2021-01-08,16,180,1.3
13159,Jasper County,2021-01-09,5,185,1.3
13159,Jasper County,2021-01-10,1,186,1.3
13159,Jasper County,2021-01-11,35,221,1.6
13159,Jasper County,2021-01-12,27,248,1.8
13159,Jasper County,2021-01-13,41,289,2.1
13159,Jasper County,2021-01-14,37,326,2.3
13159,Jasper County,2021-01-15,68,394,2.8
13159,Jasper County,2021-01-16,24,418,3
13159,Jasper County,2021-01-17,4,422,3
13159,Jasper County,2021-01-18,53,475,3.4
13159,Jasper County,2021-01-19,15,490,3.5
13159,Jasper County,2021-01-20,48,538,3.9
13159,Jasper County,2021-01-21,16,554,4
13159,Jasper County,2021-01-22,24,578,4.2
13159,Jasper County,2021-01-23,5,583,4.2
13159,Jasper County,2021-01-24,2,585,4.2
13159,Jasper County,2021-01-25,26,611,4.4
13159,Jasper County,2021-01-26,13,624,4.5
13159,Jasper County,2021-01-27,45,669,4.8
13159,Jasper County,2021-01-28,17,686,4.9
13159,Jasper County,2021-01-29,32,718,5.2
13159,Jasper County,2021-01-30,12,730,5.2
13159,Jasper County,2021-02-01,31,761,5.5
13159,Jasper County,2021-02-02,6,767,5.5
13159,Jasper County,2021-02-03,79,846,6.1
13159,Jasper County,2021-02-04,18,864,6.2
13159,Jasper County,2021-02-05,11,875,6.3
13159,Jasper County,2021-02-06,5,880,6.3
13159,Jasper County,2021-02-08,37,917,6.6
13159,Jasper County,2021-02-09,56,973,7
13159,Jasper County,2021-02-10,28,1001,7.2
13159,Jasper County,2021-02-11,30,1031,7.4
13159,Jasper County,2021-02-12,26,1057,7.6
13159,Jasper County,2021-02-13,3,1060,7.6
13159,Jasper County,2021-02-15,22,1082,7.8
13159,Jasper County,2021-02-16,29,1111,8
13159,Jasper County,2021-02-17,59,1170,8.4
13159,Jasper County,2021-02-18,24,1194,8.6
13159,Jasper County,2021-02-19,22,1216,8.7
13159,Jasper County,2021-02-20,8,1224,8.8
13159,Jasper County,2021-02-22,15,1239,8.9
13159,Jasper County,2021-02-23,15,1254,9
13159,Jasper County,2021-02-24,44,1298,9.3
13159,Jasper County,2021-02-25,26,1324,9.5
13159,Jasper County,2021-02-26,35,1359,9.8
13159,Jasper County,2021-02-27,8,1367,9.8
13159,Jasper County,2021-02-28,4,1371,9.9
13159,Jasper County,2021-03-01,18,1389,10
13159,Jasper County,2021-03-02,29,1418,10.2
13159,Jasper County,2021-03-03,19,1437,10.3
13159,Jasper County,2021-03-04,21,1458,10.5
13159,Jasper County,2021-03-05,35,1493,10.7
13159,Jasper County,2021-03-06,2,1495,10.7
13159,Jasper County,2021-03-07,2,1497,10.8
13159,Jasper County,2021-03-08,54,1551,11.1
13159,Jasper County,2021-03-09,26,1577,11.3
13159,Jasper County,2021-03-10,77,1654,11.9
13159,Jasper County,2021-03-11,47,1701,12.2
13159,Jasper County,2021-03-12,55,1756,12.6
13159,Jasper County,2021-03-13,5,1761,12.7
13159,Jasper County,2021-03-15,37,1798,12.9
13159,Jasper County,2021-03-16,136,1934,13.9
13159,Jasper County,2021-03-17,72,2006,14.4
13159,Jasper County,2021-03-18,25,2031,14.6
13159,Jasper County,2021-03-19,170,2201,15.8
13159,Jasper County,2021-03-20,21,2222,16
13159,Jasper County,2021-03-21,3,2225,16
13159,Jasper County,2021-03-22,62,2287,16.4
13159,Jasper County,2021-03-23,80,2367,17
13159,Jasper County,2021-03-24,69,2436,17.5
13159,Jasper County,2021-03-25,48,2484,17.8
13159,Jasper County,2021-03-26,47,2531,18.2
13159,Jasper County,2021-03-27,8,2539,18.2
13159,Jasper County,2021-03-28,3,2542,18.3
13159,Jasper County,2021-03-29,68,2610,18.8
13159,Jasper County,2021-03-30,86,2696,19.4
13159,Jasper County,2021-03-31,53,2749,19.8
13159,Jasper County,2021-04-01,47,2796,20.1
13159,Jasper County,2021-04-02,41,2837,20.4
13159,Jasper County,2021-04-03,3,2840,20.4
13159,Jasper County,2021-04-04,7,2847,20.5
13159,Jasper County,2021-04-05,52,2899,20.8
13159,Jasper County,2021-04-06,38,2937,21.1
13159,Jasper County,2021-04-07,56,2993,21.5
13159,Jasper County,2021-04-08,35,3028,21.8
13159,Jasper County,2021-04-09,38,3066,22
13159,Jasper County,2021-04-10,12,3078,22.1
13159,Jasper County,2021-04-11,5,3083,22.2
13159,Jasper County,2021-04-12,22,3105,22.3
13159,Jasper County,2021-04-13,31,3136,22.5
13159,Jasper County,2021-04-14,33,3169,22.8
13159,Jasper County,2021-04-15,30,3199,23
13159,Jasper County,2021-04-16,23,3222,23.2
13159,Jasper County,2021-04-17,8,3230,23.2
13159,Jasper County,2021-04-18,3,3233,23.2
13159,Jasper County,2021-04-19,12,3245,23.3
13159,Jasper County,2021-04-20,11,3256,23.4
13159,Jasper County,2021-04-21,36,3292,23.7
13159,Jasper County,2021-04-22,17,3309,23.8
13159,Jasper County,2021-04-23,18,3327,23.9
13159,Jasper County,2021-04-24,10,3337,24
13159,Jasper County,2021-04-25,3,3340,24
13159,Jasper County,2021-04-26,14,3354,24.1
13159,Jasper County,2021-04-27,17,3371,24.2
13159,Jasper County,2021-04-28,28,3399,24.4
13159,Jasper County,2021-04-29,15,3414,24.5
13159,Jasper County,2021-04-30,18,3432,24.7
13159,Jasper County,2021-05-01,6,3438,24.7
13159,Jasper County,2021-05-02,4,3442,24.7
13159,Jasper County,2021-05-03,21,3463,24.9
13159,Jasper County,2021-05-04,12,3475,25
13159,Jasper County,2021-05-05,11,3486,25.1
13159,Jasper County,2021-05-06,24,3510,25.2
13159,Jasper County,2021-05-07,22,3532,25.4
13159,Jasper County,2021-05-08,7,3539,25.4
13159,Jasper County,2021-05-09,1,3540,25.4
13159,Jasper County,2021-05-10,16,3556,25.6
13159,Jasper County,2021-05-11,11,3567,25.6
13159,Jasper County,2021-05-12,9,3576,25.7
13159,Jasper County,2021-05-13,12,3588,25.8
13159,Jasper County,2021-05-14,19,3607,25.9
13159,Jasper County,2021-05-15,7,3614,26
13159,Jasper County,2021-05-16,6,3620,26
13159,Jasper County,2021-05-17,14,3634,26.1
13159,Jasper County,2021-05-18,13,3647,26.2
13159,Jasper County,2021-05-19,16,3663,26.3
13159,Jasper County,2021-05-20,21,3684,26.5
13159,Jasper County,2021-05-21,17,3701,26.6
13159,Jasper County,2021-05-22,8,3709,26.7
13159,Jasper County,2021-05-23,2,3711,26.7
13159,Jasper County,2021-05-24,10,3721,26.7
13159,Jasper County,2021-05-25,9,3730,26.8
13159,Jasper County,2021-05-26,10,3740,26.9
13159,Jasper County,2021-05-27,5,3745,26.9
13159,Jasper County,2021-05-28,15,3760,27
13159,Jasper County,2021-05-29,6,3766,27.1
13159,Jasper County,2021-05-30,2,3768,27.1
13159,Jasper County,2021-05-31,2,3770,27.1
13159,Jasper County,2021-06-01,8,3778,27.1
13159,Jasper County,2021-06-02,11,3789,27.2
13159,Jasper County,2021-06-03,13,3802,27.3
13159,Jasper County,2021-06-04,13,3815,27.4
13159,Jasper County,2021-06-05,11,3826,27.5
13159,Jasper County,2021-06-06,3,3829,27.5
13159,Jasper County,2021-06-07,9,3838,27.6
13159,Jasper County,2021-06-08,9,3847,27.6
13159,Jasper County,2021-06-09,5,3852,27.7
13159,Jasper County,2021-06-10,4,3856,27.7
13159,Jasper County,2021-06-11,13,3869,27.8
13159,Jasper County,2021-06-12,7,3876,27.9
13159,Jasper County,2021-06-13,1,3877,27.9
13159,Jasper County,2021-06-14,6,3883,27.9
13159,Jasper County,2021-06-15,6,3889,27.9
13159,Jasper County,2021-06-16,6,3895,28
13159,Jasper County,2021-06-17,7,3902,28
13159,Jasper County,2021-06-18,10,3912,28.1
13159,Jasper County,2021-06-19,6,3918,28.2
13159,Jasper County,2021-06-21,3,3921,28.2
13159,Jasper County,2021-06-22,5,3926,28.2
13159,Jasper County,2021-06-23,9,3935,28.3
13159,Jasper County,2021-06-24,3,3938,28.3
13159,Jasper County,2021-06-25,7,3945,28.3
13159,Jasper County,2021-06-26,2,3947,28.4
13159,Jasper County,2021-06-27,2,3949,28.4
13159,Jasper County,2021-06-28,5,3954,28.4
13159,Jasper County,2021-06-29,6,3960,28.5
13159,Jasper County,2021-06-30,8,3968,28.5
13159,Jasper County,2021-07-01,2,3970,28.5
13159,Jasper County,2021-07-02,9,3979,28.6
13159,Jasper County,2021-07-03,3,3982,28.6
13159,Jasper County,2021-07-05,3,3985,28.6
13159,Jasper County,2021-07-06,1,3986,28.6
13159,Jasper County,2021-07-07,11,3997,28.7
13159,Jasper County,2021-07-08,1,3998,28.7
13159,Jasper County,2021-07-09,7,4005,28.8
13159,Jasper County,2021-07-12,6,4011,28.8
13159,Jasper County,2021-07-13,6,4017,28.9
13159,Jasper County,2021-07-14,7,4024,28.9
13159,Jasper County,2021-07-15,5,4029,29
13159,Jasper County,2021-07-16,6,4035,29
13159,Jasper County,2021-07-17,10,4045,29.1
13159,Jasper County,2021-07-18,2,4047,29.1
13159,Jasper County,2021-07-19,6,4053,29.1
13159,Jasper County,2021-07-20,1,4054,29.1
13159,Jasper County,2021-07-21,15,4069,29.2
13159,Jasper County,2021-07-22,7,4076,29.3
13159,Jasper County,2021-07-23,24,4100,29.5
13159,Jasper County,2021-07-24,4,4104,29.5
13159,Jasper County,2021-07-25,6,4110,29.5
13159,Jasper County,2021-07-26,13,4123,29.6
13159,Jasper County,2021-07-27,16,4139,29.7
13159,Jasper County,2021-07-28,12,4151,29.8
13159,Jasper County,2021-07-29,11,4162,29.9
13159,Jasper County,2021-07-30,24,4186,30.1
13159,Jasper County,2021-07-31,6,4192,30.1
13159,Jasper County,2021-08-01,10,4202,30.2
13159,Jasper County,2021-08-02,16,4218,30.3
13159,Jasper County,2021-08-03,9,4227,30.4
13159,Jasper County,2021-08-04,26,4253,30.6
13159,Jasper County,2021-08-05,8,4261,30.6
13159,Jasper County,2021-08-06,23,4284,30.8
13159,Jasper County,2021-08-07,22,4306,30.9
13159,Jasper County,2021-08-08,8,4314,31
13159,Jasper County,2021-08-09,24,4338,31.2
13159,Jasper County,2021-08-10,18,4356,31.3
13159,Jasper County,2021-08-11,39,4395,31.6
13159,Jasper County,2021-08-12,16,4411,31.7
13159,Jasper County,2021-08-13,35,4446,31.9
13159,Jasper County,2021-08-14,21,4467,32.1
13159,Jasper County,2021-08-15,8,4475,32.2
13159,Jasper County,2021-08-16,26,4501,32.3
13159,Jasper County,2021-08-17,8,4509,32.4
13159,Jasper County,2021-08-18,25,4534,32.6
13159,Jasper County,2021-08-19,28,4562,32.8
13159,Jasper County,2021-08-20,45,4607,33.1
13159,Jasper County,2021-08-21,16,4623,33.2
13159,Jasper County,2021-08-22,4,4627,33.2
13159,Jasper County,2021-08-23,26,4653,33.4
13159,Jasper County,2021-08-24,17,4670,33.6
13159,Jasper County,2021-08-25,21,4691,33.7
13159,Jasper County,2021-08-26,33,4724,33.9
13159,Jasper County,2021-08-27,48,4772,34.3
13159,Jasper County,2021-08-28,16,4788,34.4
13159,Jasper County,2021-08-29,9,4797,34.5
13159,Jasper County,2021-08-30,27,4824,34.7
13159,Jasper County,2021-08-31,24,4848,34.8
13159,Jasper County,2021-09-01,41,4889,35.1
13159,Jasper County,2021-09-02,22,4911,35.3
13159,Jasper County,2021-09-03,23,4934,35.5
13159,Jasper County,2021-09-04,10,4944,35.5
13159,Jasper County,2021-09-05,8,4952,35.6
13159,Jasper County,2021-09-06,6,4958,35.6
13159,Jasper County,2021-09-07,14,4972,35.7
13159,Jasper County,2021-09-08,28,5000,35.9
13159,Jasper County,2021-09-09,11,5011,36
13159,Jasper County,2021-09-10,24,5035,36.2
13159,Jasper County,2021-09-11,21,5056,36.3
13159,Jasper County,2021-09-12,4,5060,36.4
13159,Jasper County,2021-09-13,18,5078,36.5
13159,Jasper County,2021-09-14,12,5090,36.6
13159,Jasper County,2021-09-15,19,5109,36.7
13159,Jasper County,2021-09-16,13,5122,36.8
13159,Jasper County,2021-09-17,8,5130,36.9
13159,Jasper County,2021-09-18,11,5141,36.9
13159,Jasper County,2021-09-19,4,5145,37
13159,Jasper County,2021-09-20,10,5155,37
13159,Jasper County,2021-09-21,7,5162,37.1
13159,Jasper County,2021-09-22,16,5178,37.2
13159,Jasper County,2021-09-23,7,5185,37.3
13159,Jasper County,2021-09-24,5,5190,37.3
13159,Jasper County,2021-09-25,3,5193,37.3
13159,Jasper County,2021-09-26,3,5196,37.3
13159,Jasper County,2021-09-27,3,5199,37.4
13159,Jasper County,2021-09-28,4,5203,37.4
13159,Jasper County,2021-09-29,9,5212,37.5
13159,Jasper County,2021-09-30,5,5217,37.5
13159,Jasper County,2021-10-01,10,5227,37.6
13159,Jasper County,2021-10-02,4,5231,37.6
13159,Jasper County,2021-10-03,1,5232,37.6
13159,Jasper County,2021-10-04,3,5235,37.6
13159,Jasper County,2021-10-05,3,5238,37.6
13159,Jasper County,2021-10-06,6,5244,37.7
13159,Jasper County,2021-10-07,3,5247,37.7
13161,Jeff Davis County,2020-12-17,1,1,0
13161,Jeff Davis County,2020-12-18,2,3,0
13161,Jeff Davis County,2020-12-19,1,4,0
13161,Jeff Davis County,2020-12-21,1,5,0
13161,Jeff Davis County,2020-12-22,4,9,0.1
13161,Jeff Davis County,2020-12-23,6,15,0.1
13161,Jeff Davis County,2020-12-24,11,26,0.2
13161,Jeff Davis County,2020-12-26,1,27,0.2
13161,Jeff Davis County,2020-12-28,19,46,0.3
13161,Jeff Davis County,2020-12-29,9,55,0.4
13161,Jeff Davis County,2020-12-30,27,82,0.5
13161,Jeff Davis County,2020-12-31,4,86,0.6
13161,Jeff Davis County,2021-01-01,1,87,0.6
13161,Jeff Davis County,2021-01-02,1,88,0.6
13161,Jeff Davis County,2021-01-03,2,90,0.6
13161,Jeff Davis County,2021-01-04,24,114,0.8
13161,Jeff Davis County,2021-01-05,8,122,0.8
13161,Jeff Davis County,2021-01-06,37,159,1.1
13161,Jeff Davis County,2021-01-07,10,169,1.1
13161,Jeff Davis County,2021-01-08,7,176,1.2
13161,Jeff Davis County,2021-01-10,4,180,1.2
13161,Jeff Davis County,2021-01-11,49,229,1.5
13161,Jeff Davis County,2021-01-12,7,236,1.6
13161,Jeff Davis County,2021-01-13,101,337,2.2
13161,Jeff Davis County,2021-01-14,61,398,2.6
13161,Jeff Davis County,2021-01-15,23,421,2.8
13161,Jeff Davis County,2021-01-16,4,425,2.8
13161,Jeff Davis County,2021-01-17,1,426,2.8
13161,Jeff Davis County,2021-01-18,117,543,3.6
13161,Jeff Davis County,2021-01-19,46,589,3.9
13161,Jeff Davis County,2021-01-20,54,643,4.3
13161,Jeff Davis County,2021-01-21,72,715,4.8
13161,Jeff Davis County,2021-01-22,17,732,4.9
13161,Jeff Davis County,2021-01-23,12,744,4.9
13161,Jeff Davis County,2021-01-24,1,745,5
13161,Jeff Davis County,2021-01-25,110,855,5.7
13161,Jeff Davis County,2021-01-26,25,880,5.9
13161,Jeff Davis County,2021-01-27,42,922,6.1
13161,Jeff Davis County,2021-01-28,51,973,6.5
13161,Jeff Davis County,2021-01-29,12,985,6.6
13161,Jeff Davis County,2021-01-30,1,986,6.6
13161,Jeff Davis County,2021-01-31,1,987,6.6
13161,Jeff Davis County,2021-02-01,64,1051,7
13161,Jeff Davis County,2021-02-02,46,1097,7.3
13161,Jeff Davis County,2021-02-03,32,1129,7.5
13161,Jeff Davis County,2021-02-04,8,1137,7.6
13161,Jeff Davis County,2021-02-05,2,1139,7.6
13161,Jeff Davis County,2021-02-06,11,1150,7.6
13161,Jeff Davis County,2021-02-07,1,1151,7.7
13161,Jeff Davis County,2021-02-08,27,1178,7.8
13161,Jeff Davis County,2021-02-09,46,1224,8.1
13161,Jeff Davis County,2021-02-10,54,1278,8.5
13161,Jeff Davis County,2021-02-11,36,1314,8.7
13161,Jeff Davis County,2021-02-12,23,1337,8.9
13161,Jeff Davis County,2021-02-13,14,1351,9
13161,Jeff Davis County,2021-02-14,9,1360,9
13161,Jeff Davis County,2021-02-15,44,1404,9.3
13161,Jeff Davis County,2021-02-16,55,1459,9.7
13161,Jeff Davis County,2021-02-17,18,1477,9.8
13161,Jeff Davis County,2021-02-18,8,1485,9.9
13161,Jeff Davis County,2021-02-19,25,1510,10
13161,Jeff Davis County,2021-02-20,13,1523,10.1
13161,Jeff Davis County,2021-02-21,2,1525,10.1
13161,Jeff Davis County,2021-02-22,28,1553,10.3
13161,Jeff Davis County,2021-02-23,40,1593,10.6
13161,Jeff Davis County,2021-02-24,14,1607,10.7
13161,Jeff Davis County,2021-02-25,33,1640,10.9
13161,Jeff Davis County,2021-02-26,10,1650,11
13161,Jeff Davis County,2021-02-27,9,1659,11
13161,Jeff Davis County,2021-02-28,1,1660,11
13161,Jeff Davis County,2021-03-01,31,1691,11.2
13161,Jeff Davis County,2021-03-02,26,1717,11.4
13161,Jeff Davis County,2021-03-03,15,1732,11.5
13161,Jeff Davis County,2021-03-04,28,1760,11.7
13161,Jeff Davis County,2021-03-05,10,1770,11.8
13161,Jeff Davis County,2021-03-06,2,1772,11.8
13161,Jeff Davis County,2021-03-07,8,1780,11.8
13161,Jeff Davis County,2021-03-08,24,1804,12
13161,Jeff Davis County,2021-03-09,16,1820,12.1
13161,Jeff Davis County,2021-03-10,23,1843,12.3
13161,Jeff Davis County,2021-03-11,36,1879,12.5
13161,Jeff Davis County,2021-03-12,20,1899,12.6
13161,Jeff Davis County,2021-03-13,4,1903,12.7
13161,Jeff Davis County,2021-03-14,2,1905,12.7
13161,Jeff Davis County,2021-03-15,42,1947,12.9
13161,Jeff Davis County,2021-03-16,36,1983,13.2
13161,Jeff Davis County,2021-03-17,100,2083,13.9
13161,Jeff Davis County,2021-03-18,58,2141,14.2
13161,Jeff Davis County,2021-03-19,30,2171,14.4
13161,Jeff Davis County,2021-03-20,9,2180,14.5
13161,Jeff Davis County,2021-03-21,6,2186,14.5
13161,Jeff Davis County,2021-03-22,37,2223,14.8
13161,Jeff Davis County,2021-03-23,36,2259,15
13161,Jeff Davis County,2021-03-24,22,2281,15.2
13161,Jeff Davis County,2021-03-25,55,2336,15.5
13161,Jeff Davis County,2021-03-26,12,2348,15.6
13161,Jeff Davis County,2021-03-27,16,2364,15.7
13161,Jeff Davis County,2021-03-28,5,2369,15.8
13161,Jeff Davis County,2021-03-29,48,2417,16.1
13161,Jeff Davis County,2021-03-30,23,2440,16.2
13161,Jeff Davis County,2021-03-31,15,2455,16.3
13161,Jeff Davis County,2021-04-01,26,2481,16.5
13161,Jeff Davis County,2021-04-02,19,2500,16.6
13161,Jeff Davis County,2021-04-03,9,2509,16.7
13161,Jeff Davis County,2021-04-04,4,2513,16.7
13161,Jeff Davis County,2021-04-05,31,2544,16.9
13161,Jeff Davis County,2021-04-06,102,2646,17.6
13161,Jeff Davis County,2021-04-07,19,2665,17.7
13161,Jeff Davis County,2021-04-08,43,2708,18
13161,Jeff Davis County,2021-04-09,25,2733,18.2
13161,Jeff Davis County,2021-04-10,7,2740,18.2
13161,Jeff Davis County,2021-04-11,2,2742,18.2
13161,Jeff Davis County,2021-04-12,22,2764,18.4
13161,Jeff Davis County,2021-04-13,21,2785,18.5
13161,Jeff Davis County,2021-04-14,17,2802,18.6
13161,Jeff Davis County,2021-04-15,19,2821,18.8
13161,Jeff Davis County,2021-04-16,17,2838,18.9
13161,Jeff Davis County,2021-04-17,5,2843,18.9
13161,Jeff Davis County,2021-04-18,4,2847,18.9
13161,Jeff Davis County,2021-04-19,22,2869,19.1
13161,Jeff Davis County,2021-04-20,22,2891,19.2
13161,Jeff Davis County,2021-04-21,18,2909,19.3
13161,Jeff Davis County,2021-04-22,10,2919,19.4
13161,Jeff Davis County,2021-04-23,5,2924,19.4
13161,Jeff Davis County,2021-04-24,6,2930,19.5
13161,Jeff Davis County,2021-04-25,3,2933,19.5
13161,Jeff Davis County,2021-04-26,12,2945,19.6
13161,Jeff Davis County,2021-04-27,7,2952,19.6
13161,Jeff Davis County,2021-04-28,13,2965,19.7
13161,Jeff Davis County,2021-04-29,21,2986,19.9
13161,Jeff Davis County,2021-04-30,15,3001,20
13161,Jeff Davis County,2021-05-01,1,3002,20
13161,Jeff Davis County,2021-05-02,3,3005,20
13161,Jeff Davis County,2021-05-03,19,3024,20.1
13161,Jeff Davis County,2021-05-04,16,3040,20.2
13161,Jeff Davis County,2021-05-05,14,3054,20.3
13161,Jeff Davis County,2021-05-06,11,3065,20.4
13161,Jeff Davis County,2021-05-07,9,3074,20.4
13161,Jeff Davis County,2021-05-08,7,3081,20.5
13161,Jeff Davis County,2021-05-09,1,3082,20.5
13161,Jeff Davis County,2021-05-10,17,3099,20.6
13161,Jeff Davis County,2021-05-11,10,3109,20.7
13161,Jeff Davis County,2021-05-12,10,3119,20.7
13161,Jeff Davis County,2021-05-13,12,3131,20.8
13161,Jeff Davis County,2021-05-14,14,3145,20.9
13161,Jeff Davis County,2021-05-15,7,3152,21
13161,Jeff Davis County,2021-05-16,2,3154,21
13161,Jeff Davis County,2021-05-17,21,3175,21.1
13161,Jeff Davis County,2021-05-18,17,3192,21.2
13161,Jeff Davis County,2021-05-19,15,3207,21.3
13161,Jeff Davis County,2021-05-20,8,3215,21.4
13161,Jeff Davis County,2021-05-21,3,3218,21.4
13161,Jeff Davis County,2021-05-22,9,3227,21.5
13161,Jeff Davis County,2021-05-23,5,3232,21.5
13161,Jeff Davis County,2021-05-24,9,3241,21.6
13161,Jeff Davis County,2021-05-25,12,3253,21.6
13161,Jeff Davis County,2021-05-26,12,3265,21.7
13161,Jeff Davis County,2021-05-27,11,3276,21.8
13161,Jeff Davis County,2021-05-28,4,3280,21.8
13161,Jeff Davis County,2021-05-29,4,3284,21.8
13161,Jeff Davis County,2021-05-30,3,3287,21.9
13161,Jeff Davis County,2021-05-31,2,3289,21.9
13161,Jeff Davis County,2021-06-01,6,3295,21.9
13161,Jeff Davis County,2021-06-02,8,3303,22
13161,Jeff Davis County,2021-06-03,20,3323,22.1
13161,Jeff Davis County,2021-06-04,8,3331,22.2
13161,Jeff Davis County,2021-06-05,6,3337,22.2
13161,Jeff Davis County,2021-06-06,2,3339,22.2
13161,Jeff Davis County,2021-06-07,12,3351,22.3
13161,Jeff Davis County,2021-06-08,3,3354,22.3
13161,Jeff Davis County,2021-06-09,6,3360,22.3
13161,Jeff Davis County,2021-06-10,6,3366,22.4
13161,Jeff Davis County,2021-06-11,1,3367,22.4
13161,Jeff Davis County,2021-06-12,4,3371,22.4
13161,Jeff Davis County,2021-06-14,2,3373,22.4
13161,Jeff Davis County,2021-06-15,5,3378,22.5
13161,Jeff Davis County,2021-06-17,7,3385,22.5
13161,Jeff Davis County,2021-06-18,3,3388,22.5
13161,Jeff Davis County,2021-06-19,7,3395,22.6
13161,Jeff Davis County,2021-06-20,4,3399,22.6
13161,Jeff Davis County,2021-06-21,8,3407,22.7
13161,Jeff Davis County,2021-06-22,2,3409,22.7
13161,Jeff Davis County,2021-06-23,4,3413,22.7
13161,Jeff Davis County,2021-06-24,7,3420,22.7
13161,Jeff Davis County,2021-06-25,4,3424,22.8
13161,Jeff Davis County,2021-06-26,6,3430,22.8
13161,Jeff Davis County,2021-06-27,3,3433,22.8
13161,Jeff Davis County,2021-06-28,6,3439,22.9
13161,Jeff Davis County,2021-06-29,4,3443,22.9
13161,Jeff Davis County,2021-06-30,8,3451,23
13161,Jeff Davis County,2021-07-01,6,3457,23
13161,Jeff Davis County,2021-07-03,1,3458,23
13161,Jeff Davis County,2021-07-05,7,3465,23
13161,Jeff Davis County,2021-07-06,5,3470,23.1
13161,Jeff Davis County,2021-07-07,5,3475,23.1
13161,Jeff Davis County,2021-07-08,7,3482,23.2
13161,Jeff Davis County,2021-07-09,3,3485,23.2
13161,Jeff Davis County,2021-07-10,8,3493,23.2
13161,Jeff Davis County,2021-07-11,2,3495,23.2
13161,Jeff Davis County,2021-07-12,11,3506,23.3
13161,Jeff Davis County,2021-07-13,4,3510,23.3
13161,Jeff Davis County,2021-07-14,13,3523,23.4
13161,Jeff Davis County,2021-07-15,9,3532,23.5
13161,Jeff Davis County,2021-07-16,6,3538,23.5
13161,Jeff Davis County,2021-07-17,3,3541,23.6
13161,Jeff Davis County,2021-07-18,3,3544,23.6
13161,Jeff Davis County,2021-07-19,21,3565,23.7
13161,Jeff Davis County,2021-07-20,11,3576,23.8
13161,Jeff Davis County,2021-07-21,18,3594,23.9
13161,Jeff Davis County,2021-07-22,8,3602,24
13161,Jeff Davis County,2021-07-23,13,3615,24
13161,Jeff Davis County,2021-07-24,15,3630,24.1
13161,Jeff Davis County,2021-07-25,3,3633,24.2
13161,Jeff Davis County,2021-07-26,19,3652,24.3
13161,Jeff Davis County,2021-07-27,37,3689,24.5
13161,Jeff Davis County,2021-07-28,28,3717,24.7
13161,Jeff Davis County,2021-07-29,27,3744,24.9
13161,Jeff Davis County,2021-07-30,63,3807,25.3
13161,Jeff Davis County,2021-07-31,14,3821,25.4
13161,Jeff Davis County,2021-08-01,7,3828,25.5
13161,Jeff Davis County,2021-08-02,47,3875,25.8
13161,Jeff Davis County,2021-08-03,29,3904,26
13161,Jeff Davis County,2021-08-04,34,3938,26.2
13161,Jeff Davis County,2021-08-05,45,3983,26.5
13161,Jeff Davis County,2021-08-06,45,4028,26.8
13161,Jeff Davis County,2021-08-07,19,4047,26.9
13161,Jeff Davis County,2021-08-08,14,4061,27
13161,Jeff Davis County,2021-08-09,32,4093,27.2
13161,Jeff Davis County,2021-08-10,36,4129,27.5
13161,Jeff Davis County,2021-08-11,41,4170,27.7
13161,Jeff Davis County,2021-08-12,31,4201,27.9
13161,Jeff Davis County,2021-08-13,52,4253,28.3
13161,Jeff Davis County,2021-08-14,13,4266,28.4
13161,Jeff Davis County,2021-08-15,9,4275,28.4
13161,Jeff Davis County,2021-08-16,37,4312,28.7
13161,Jeff Davis County,2021-08-17,37,4349,28.9
13161,Jeff Davis County,2021-08-18,33,4382,29.1
13161,Jeff Davis County,2021-08-19,36,4418,29.4
13161,Jeff Davis County,2021-08-20,30,4448,29.6
13161,Jeff Davis County,2021-08-21,15,4463,29.7
13161,Jeff Davis County,2021-08-22,15,4478,29.8
13161,Jeff Davis County,2021-08-23,15,4493,29.9
13161,Jeff Davis County,2021-08-24,35,4528,30.1
13161,Jeff Davis County,2021-08-25,25,4553,30.3
13161,Jeff Davis County,2021-08-26,43,4596,30.6
13161,Jeff Davis County,2021-08-27,18,4614,30.7
13161,Jeff Davis County,2021-08-28,15,4629,30.8
13161,Jeff Davis County,2021-08-29,10,4639,30.9
13161,Jeff Davis County,2021-08-30,16,4655,31
13161,Jeff Davis County,2021-08-31,19,4674,31.1
13161,Jeff Davis County,2021-09-01,20,4694,31.2
13161,Jeff Davis County,2021-09-02,23,4717,31.4
13161,Jeff Davis County,2021-09-03,32,4749,31.6
13161,Jeff Davis County,2021-09-04,11,4760,31.7
13161,Jeff Davis County,2021-09-05,8,4768,31.7
13161,Jeff Davis County,2021-09-06,4,4772,31.7
13161,Jeff Davis County,2021-09-07,15,4787,31.8
13161,Jeff Davis County,2021-09-08,20,4807,32
13161,Jeff Davis County,2021-09-09,19,4826,32.1
13161,Jeff Davis County,2021-09-10,28,4854,32.3
13161,Jeff Davis County,2021-09-11,10,4864,32.3
13161,Jeff Davis County,2021-09-12,8,4872,32.4
13161,Jeff Davis County,2021-09-13,10,4882,32.5
13161,Jeff Davis County,2021-09-14,10,4892,32.5
13161,Jeff Davis County,2021-09-15,11,4903,32.6
13161,Jeff Davis County,2021-09-16,9,4912,32.7
13161,Jeff Davis County,2021-09-17,19,4931,32.8
13161,Jeff Davis County,2021-09-18,3,4934,32.8
13161,Jeff Davis County,2021-09-19,4,4938,32.8
13161,Jeff Davis County,2021-09-20,11,4949,32.9
13161,Jeff Davis County,2021-09-21,10,4959,33
13161,Jeff Davis County,2021-09-22,5,4964,33
13161,Jeff Davis County,2021-09-23,3,4967,33
13161,Jeff Davis County,2021-09-24,18,4985,33.2
13161,Jeff Davis County,2021-09-25,5,4990,33.2
13161,Jeff Davis County,2021-09-26,4,4994,33.2
13161,Jeff Davis County,2021-09-27,8,5002,33.3
13161,Jeff Davis County,2021-09-28,5,5007,33.3
13161,Jeff Davis County,2021-09-29,4,5011,33.3
13161,Jeff Davis County,2021-09-30,3,5014,33.3
13161,Jeff Davis County,2021-10-01,6,5020,33.4
13161,Jeff Davis County,2021-10-02,3,5023,33.4
13161,Jeff Davis County,2021-10-03,1,5024,33.4
13161,Jeff Davis County,2021-10-04,3,5027,33.4
13161,Jeff Davis County,2021-10-05,1,5028,33.4
13161,Jeff Davis County,2021-10-06,1,5029,33.4
13161,Jeff Davis County,2021-10-07,4,5033,33.5
13163,Jefferson County,2020-12-17,3,3,0
13163,Jefferson County,2020-12-18,4,7,0
13163,Jefferson County,2020-12-19,3,10,0.1
13163,Jefferson County,2020-12-22,14,24,0.2
13163,Jefferson County,2020-12-23,15,39,0.2
13163,Jefferson County,2020-12-24,3,42,0.3
13163,Jefferson County,2020-12-28,8,50,0.3
13163,Jefferson County,2020-12-29,30,80,0.5
13163,Jefferson County,2020-12-30,13,93,0.6
13163,Jefferson County,2020-12-31,14,107,0.7
13163,Jefferson County,2021-01-01,2,109,0.7
13163,Jefferson County,2021-01-02,4,113,0.7
13163,Jefferson County,2021-01-03,1,114,0.7
13163,Jefferson County,2021-01-04,9,123,0.8
13163,Jefferson County,2021-01-05,15,138,0.9
13163,Jefferson County,2021-01-06,29,167,1.1
13163,Jefferson County,2021-01-07,133,300,1.9
13163,Jefferson County,2021-01-08,26,326,2.1
13163,Jefferson County,2021-01-09,6,332,2.1
13163,Jefferson County,2021-01-11,33,365,2.3
13163,Jefferson County,2021-01-12,55,420,2.7
13163,Jefferson County,2021-01-13,169,589,3.8
13163,Jefferson County,2021-01-14,77,666,4.3
13163,Jefferson County,2021-01-15,30,696,4.5
13163,Jefferson County,2021-01-16,6,702,4.5
13163,Jefferson County,2021-01-17,1,703,4.5
13163,Jefferson County,2021-01-18,15,718,4.6
13163,Jefferson County,2021-01-19,52,770,4.9
13163,Jefferson County,2021-01-20,200,970,6.2
13163,Jefferson County,2021-01-21,219,1189,7.6
13163,Jefferson County,2021-01-22,8,1197,7.7
13163,Jefferson County,2021-01-23,5,1202,7.7
13163,Jefferson County,2021-01-24,2,1204,7.7
13163,Jefferson County,2021-01-25,30,1234,7.9
13163,Jefferson County,2021-01-26,43,1277,8.2
13163,Jefferson County,2021-01-27,114,1391,8.9
13163,Jefferson County,2021-01-28,56,1447,9.3
13163,Jefferson County,2021-01-29,14,1461,9.4
13163,Jefferson County,2021-01-30,7,1468,9.4
13163,Jefferson County,2021-01-31,1,1469,9.4
13163,Jefferson County,2021-02-01,41,1510,9.7
13163,Jefferson County,2021-02-02,63,1573,10.1
13163,Jefferson County,2021-02-03,167,1740,11.1
13163,Jefferson County,2021-02-04,127,1867,12
13163,Jefferson County,2021-02-05,16,1883,12.1
13163,Jefferson County,2021-02-06,6,1889,12.1
13163,Jefferson County,2021-02-07,1,1890,12.1
13163,Jefferson County,2021-02-08,10,1900,12.2
13163,Jefferson County,2021-02-09,38,1938,12.4
13163,Jefferson County,2021-02-10,51,1989,12.7
13163,Jefferson County,2021-02-11,60,2049,13.1
13163,Jefferson County,2021-02-12,10,2059,13.2
13163,Jefferson County,2021-02-13,6,2065,13.2
13163,Jefferson County,2021-02-14,2,2067,13.2
13163,Jefferson County,2021-02-15,14,2081,13.3
13163,Jefferson County,2021-02-16,14,2095,13.4
13163,Jefferson County,2021-02-17,83,2178,13.9
13163,Jefferson County,2021-02-18,36,2214,14.2
13163,Jefferson County,2021-02-19,9,2223,14.2
13163,Jefferson County,2021-02-20,1,2224,14.2
13163,Jefferson County,2021-02-22,6,2230,14.3
13163,Jefferson County,2021-02-23,9,2239,14.3
13163,Jefferson County,2021-02-24,9,2248,14.4
13163,Jefferson County,2021-02-25,24,2272,14.5
13163,Jefferson County,2021-02-26,22,2294,14.7
13163,Jefferson County,2021-02-27,5,2299,14.7
13163,Jefferson County,2021-03-01,18,2317,14.8
13163,Jefferson County,2021-03-02,8,2325,14.9
13163,Jefferson County,2021-03-03,81,2406,15.4
13163,Jefferson County,2021-03-04,95,2501,16
13163,Jefferson County,2021-03-05,9,2510,16.1
13163,Jefferson County,2021-03-06,8,2518,16.1
13163,Jefferson County,2021-03-07,4,2522,16.1
13163,Jefferson County,2021-03-08,38,2560,16.4
13163,Jefferson County,2021-03-09,14,2574,16.5
13163,Jefferson County,2021-03-10,150,2724,17.4
13163,Jefferson County,2021-03-11,74,2798,17.9
13163,Jefferson County,2021-03-12,60,2858,18.3
13163,Jefferson County,2021-03-13,12,2870,18.4
13163,Jefferson County,2021-03-14,7,2877,18.4
13163,Jefferson County,2021-03-15,52,2929,18.8
13163,Jefferson County,2021-03-16,39,2968,19
13163,Jefferson County,2021-03-17,138,3106,19.9
13163,Jefferson County,2021-03-18,146,3252,20.8
13163,Jefferson County,2021-03-19,111,3363,21.5
13163,Jefferson County,2021-03-20,14,3377,21.6
13163,Jefferson County,2021-03-21,7,3384,21.7
13163,Jefferson County,2021-03-22,87,3471,22.2
13163,Jefferson County,2021-03-23,45,3516,22.5
13163,Jefferson County,2021-03-24,141,3657,23.4
13163,Jefferson County,2021-03-25,154,3811,24.4
13163,Jefferson County,2021-03-26,30,3841,24.6
13163,Jefferson County,2021-03-27,22,3863,24.7
13163,Jefferson County,2021-03-28,14,3877,24.8
13163,Jefferson County,2021-03-29,49,3926,25.1
13163,Jefferson County,2021-03-30,77,4003,25.6
13163,Jefferson County,2021-03-31,115,4118,26.4
13163,Jefferson County,2021-04-01,85,4203,26.9
13163,Jefferson County,2021-04-02,22,4225,27.1
13163,Jefferson County,2021-04-03,71,4296,27.5
13163,Jefferson County,2021-04-04,11,4307,27.6
13163,Jefferson County,2021-04-05,45,4352,27.9
13163,Jefferson County,2021-04-06,92,4444,28.5
13163,Jefferson County,2021-04-07,107,4551,29.1
13163,Jefferson County,2021-04-08,43,4594,29.4
13163,Jefferson County,2021-04-09,56,4650,29.8
13163,Jefferson County,2021-04-10,15,4665,29.9
13163,Jefferson County,2021-04-11,6,4671,29.9
13163,Jefferson County,2021-04-12,61,4732,30.3
13163,Jefferson County,2021-04-13,38,4770,30.5
13163,Jefferson County,2021-04-14,58,4828,30.9
13163,Jefferson County,2021-04-15,44,4872,31.2
13163,Jefferson County,2021-04-16,45,4917,31.5
13163,Jefferson County,2021-04-17,6,4923,31.5
13163,Jefferson County,2021-04-18,2,4925,31.5
13163,Jefferson County,2021-04-19,20,4945,31.7
13163,Jefferson County,2021-04-20,37,4982,31.9
13163,Jefferson County,2021-04-21,112,5094,32.6
13163,Jefferson County,2021-04-22,33,5127,32.8
13163,Jefferson County,2021-04-23,16,5143,32.9
13163,Jefferson County,2021-04-24,4,5147,33
13163,Jefferson County,2021-04-25,5,5152,33
13163,Jefferson County,2021-04-26,22,5174,33.1
13163,Jefferson County,2021-04-27,20,5194,33.3
13163,Jefferson County,2021-04-28,50,5244,33.6
13163,Jefferson County,2021-04-29,39,5283,33.8
13163,Jefferson County,2021-04-30,49,5332,34.1
13163,Jefferson County,2021-05-01,11,5343,34.2
13163,Jefferson County,2021-05-02,3,5346,34.2
13163,Jefferson County,2021-05-03,24,5370,34.4
13163,Jefferson County,2021-05-04,7,5377,34.4
13163,Jefferson County,2021-05-05,40,5417,34.7
13163,Jefferson County,2021-05-06,28,5445,34.9
13163,Jefferson County,2021-05-07,19,5464,35
13163,Jefferson County,2021-05-08,45,5509,35.3
13163,Jefferson County,2021-05-10,33,5542,35.5
13163,Jefferson County,2021-05-11,19,5561,35.6
13163,Jefferson County,2021-05-12,41,5602,35.9
13163,Jefferson County,2021-05-13,38,5640,36.1
13163,Jefferson County,2021-05-14,17,5657,36.2
13163,Jefferson County,2021-05-15,19,5676,36.3
13163,Jefferson County,2021-05-16,3,5679,36.4
13163,Jefferson County,2021-05-17,35,5714,36.6
13163,Jefferson County,2021-05-18,17,5731,36.7
13163,Jefferson County,2021-05-19,37,5768,36.9
13163,Jefferson County,2021-05-20,35,5803,37.2
13163,Jefferson County,2021-05-21,23,5826,37.3
13163,Jefferson County,2021-05-22,3,5829,37.3
13163,Jefferson County,2021-05-23,7,5836,37.4
13163,Jefferson County,2021-05-24,17,5853,37.5
13163,Jefferson County,2021-05-25,15,5868,37.6
13163,Jefferson County,2021-05-26,24,5892,37.7
13163,Jefferson County,2021-05-27,28,5920,37.9
13163,Jefferson County,2021-05-28,8,5928,38
13163,Jefferson County,2021-05-29,7,5935,38
13163,Jefferson County,2021-05-30,4,5939,38
13163,Jefferson County,2021-06-01,18,5957,38.1
13163,Jefferson County,2021-06-02,16,5973,38.2
13163,Jefferson County,2021-06-03,42,6015,38.5
13163,Jefferson County,2021-06-04,9,6024,38.6
13163,Jefferson County,2021-06-05,19,6043,38.7
13163,Jefferson County,2021-06-06,3,6046,38.7
13163,Jefferson County,2021-06-07,10,6056,38.8
13163,Jefferson County,2021-06-08,9,6065,38.8
13163,Jefferson County,2021-06-09,37,6102,39.1
13163,Jefferson County,2021-06-10,14,6116,39.2
13163,Jefferson County,2021-06-11,14,6130,39.2
13163,Jefferson County,2021-06-12,8,6138,39.3
13163,Jefferson County,2021-06-13,2,6140,39.3
13163,Jefferson County,2021-06-14,24,6164,39.5
13163,Jefferson County,2021-06-15,5,6169,39.5
13163,Jefferson County,2021-06-16,15,6184,39.6
13163,Jefferson County,2021-06-17,12,6196,39.7
13163,Jefferson County,2021-06-18,7,6203,39.7
13163,Jefferson County,2021-06-19,1,6204,39.7
13163,Jefferson County,2021-06-20,1,6205,39.7
13163,Jefferson County,2021-06-21,7,6212,39.8
13163,Jefferson County,2021-06-22,4,6216,39.8
13163,Jefferson County,2021-06-23,12,6228,39.9
13163,Jefferson County,2021-06-24,9,6237,39.9
13163,Jefferson County,2021-06-25,3,6240,40
13163,Jefferson County,2021-06-26,20,6260,40.1
13163,Jefferson County,2021-06-27,2,6262,40.1
13163,Jefferson County,2021-06-28,9,6271,40.2
13163,Jefferson County,2021-06-29,14,6285,40.2
13163,Jefferson County,2021-06-30,13,6298,40.3
13163,Jefferson County,2021-07-01,7,6305,40.4
13163,Jefferson County,2021-07-02,6,6311,40.4
13163,Jefferson County,2021-07-03,4,6315,40.4
13163,Jefferson County,2021-07-05,8,6323,40.5
13163,Jefferson County,2021-07-06,5,6328,40.5
13163,Jefferson County,2021-07-07,17,6345,40.6
13163,Jefferson County,2021-07-08,9,6354,40.7
13163,Jefferson County,2021-07-09,10,6364,40.7
13163,Jefferson County,2021-07-10,14,6378,40.8
13163,Jefferson County,2021-07-11,1,6379,40.8
13163,Jefferson County,2021-07-12,14,6393,40.9
13163,Jefferson County,2021-07-13,6,6399,41
13163,Jefferson County,2021-07-14,7,6406,41
13163,Jefferson County,2021-07-15,24,6430,41.2
13163,Jefferson County,2021-07-16,6,6436,41.2
13163,Jefferson County,2021-07-17,4,6440,41.2
13163,Jefferson County,2021-07-18,1,6441,41.2
13163,Jefferson County,2021-07-19,19,6460,41.4
13163,Jefferson County,2021-07-20,10,6470,41.4
13163,Jefferson County,2021-07-21,32,6502,41.6
13163,Jefferson County,2021-07-22,29,6531,41.8
13163,Jefferson County,2021-07-23,17,6548,41.9
13163,Jefferson County,2021-07-24,7,6555,42
13163,Jefferson County,2021-07-25,5,6560,42
13163,Jefferson County,2021-07-26,29,6589,42.2
13163,Jefferson County,2021-07-27,36,6625,42.4
13163,Jefferson County,2021-07-28,41,6666,42.7
13163,Jefferson County,2021-07-29,64,6730,43.1
13163,Jefferson County,2021-07-30,52,6782,43.4
13163,Jefferson County,2021-07-31,20,6802,43.6
13163,Jefferson County,2021-08-01,3,6805,43.6
13163,Jefferson County,2021-08-02,53,6858,43.9
13163,Jefferson County,2021-08-03,24,6882,44.1
13163,Jefferson County,2021-08-04,51,6933,44.4
13163,Jefferson County,2021-08-05,71,7004,44.8
13163,Jefferson County,2021-08-06,41,7045,45.1
13163,Jefferson County,2021-08-07,37,7082,45.3
13163,Jefferson County,2021-08-08,4,7086,45.4
13163,Jefferson County,2021-08-09,49,7135,45.7
13163,Jefferson County,2021-08-10,33,7168,45.9
13163,Jefferson County,2021-08-11,44,7212,46.2
13163,Jefferson County,2021-08-12,76,7288,46.7
13163,Jefferson County,2021-08-13,53,7341,47
13163,Jefferson County,2021-08-14,13,7354,47.1
13163,Jefferson County,2021-08-15,10,7364,47.2
13163,Jefferson County,2021-08-16,48,7412,47.5
13163,Jefferson County,2021-08-17,36,7448,47.7
13163,Jefferson County,2021-08-18,53,7501,48
13163,Jefferson County,2021-08-19,55,7556,48.4
13163,Jefferson County,2021-08-20,46,7602,48.7
13163,Jefferson County,2021-08-21,13,7615,48.8
13163,Jefferson County,2021-08-22,8,7623,48.8
13163,Jefferson County,2021-08-23,52,7675,49.1
13163,Jefferson County,2021-08-24,34,7709,49.4
13163,Jefferson County,2021-08-25,53,7762,49.7
13163,Jefferson County,2021-08-26,65,7827,50.1
13163,Jefferson County,2021-08-27,49,7876,50.4
13163,Jefferson County,2021-08-28,10,7886,50.5
13163,Jefferson County,2021-08-29,8,7894,50.5
13163,Jefferson County,2021-08-30,49,7943,50.9
13163,Jefferson County,2021-08-31,49,7992,51.2
13163,Jefferson County,2021-09-01,39,8031,51.4
13163,Jefferson County,2021-09-02,35,8066,51.6
13163,Jefferson County,2021-09-03,50,8116,52
13163,Jefferson County,2021-09-04,5,8121,52
13163,Jefferson County,2021-09-05,4,8125,52
13163,Jefferson County,2021-09-06,1,8126,52
13163,Jefferson County,2021-09-07,22,8148,52.2
13163,Jefferson County,2021-09-08,31,8179,52.4
13163,Jefferson County,2021-09-09,29,8208,52.6
13163,Jefferson County,2021-09-10,32,8240,52.8
13163,Jefferson County,2021-09-11,17,8257,52.9
13163,Jefferson County,2021-09-12,5,8262,52.9
13163,Jefferson County,2021-09-13,29,8291,53.1
13163,Jefferson County,2021-09-14,16,8307,53.2
13163,Jefferson County,2021-09-15,31,8338,53.4
13163,Jefferson County,2021-09-16,18,8356,53.5
13163,Jefferson County,2021-09-17,31,8387,53.7
13163,Jefferson County,2021-09-18,8,8395,53.8
13163,Jefferson County,2021-09-19,2,8397,53.8
13163,Jefferson County,2021-09-20,20,8417,53.9
13163,Jefferson County,2021-09-21,15,8432,54
13163,Jefferson County,2021-09-22,25,8457,54.1
13163,Jefferson County,2021-09-23,22,8479,54.3
13163,Jefferson County,2021-09-24,15,8494,54.4
13163,Jefferson County,2021-09-25,7,8501,54.4
13163,Jefferson County,2021-09-26,3,8504,54.4
13163,Jefferson County,2021-09-27,14,8518,54.5
13163,Jefferson County,2021-09-28,19,8537,54.7
13163,Jefferson County,2021-09-29,26,8563,54.8
13163,Jefferson County,2021-09-30,11,8574,54.9
13163,Jefferson County,2021-10-01,11,8585,55
13163,Jefferson County,2021-10-02,4,8589,55
13163,Jefferson County,2021-10-04,12,8601,55.1
13163,Jefferson County,2021-10-05,7,8608,55.1
13163,Jefferson County,2021-10-06,16,8624,55.2
13163,Jefferson County,2021-10-07,4,8628,55.2
13165,Jenkins County,2020-12-17,1,1,0
13165,Jenkins County,2020-12-19,1,2,0
13165,Jenkins County,2020-12-20,1,3,0
13165,Jenkins County,2020-12-22,2,5,0.1
13165,Jenkins County,2020-12-23,8,13,0.1
13165,Jenkins County,2020-12-28,12,25,0.3
13165,Jenkins County,2020-12-29,14,39,0.4
13165,Jenkins County,2020-12-30,18,57,0.6
13165,Jenkins County,2020-12-31,7,64,0.7
13165,Jenkins County,2021-01-01,1,65,0.7
13165,Jenkins County,2021-01-04,9,74,0.8
13165,Jenkins County,2021-01-05,20,94,1.1
13165,Jenkins County,2021-01-06,29,123,1.4
13165,Jenkins County,2021-01-07,20,143,1.6
13165,Jenkins County,2021-01-08,18,161,1.8
13165,Jenkins County,2021-01-09,1,162,1.8
13165,Jenkins County,2021-01-10,1,163,1.9
13165,Jenkins County,2021-01-11,45,208,2.4
13165,Jenkins County,2021-01-12,22,230,2.6
13165,Jenkins County,2021-01-13,69,299,3.4
13165,Jenkins County,2021-01-14,46,345,3.9
13165,Jenkins County,2021-01-15,24,369,4.2
13165,Jenkins County,2021-01-16,3,372,4.2
13165,Jenkins County,2021-01-17,1,373,4.2
13165,Jenkins County,2021-01-18,4,377,4.3
13165,Jenkins County,2021-01-19,19,396,4.5
13165,Jenkins County,2021-01-20,19,415,4.7
13165,Jenkins County,2021-01-21,89,504,5.7
13165,Jenkins County,2021-01-22,7,511,5.8
13165,Jenkins County,2021-01-23,4,515,5.9
13165,Jenkins County,2021-01-25,32,547,6.2
13165,Jenkins County,2021-01-26,96,643,7.3
13165,Jenkins County,2021-01-27,28,671,7.6
13165,Jenkins County,2021-01-28,24,695,7.9
13165,Jenkins County,2021-01-29,5,700,8
13165,Jenkins County,2021-02-01,21,721,8.2
13165,Jenkins County,2021-02-02,8,729,8.3
13165,Jenkins County,2021-02-03,40,769,8.7
13165,Jenkins County,2021-02-04,75,844,9.6
13165,Jenkins County,2021-02-05,30,874,9.9
13165,Jenkins County,2021-02-06,4,878,10
13165,Jenkins County,2021-02-08,27,905,10.3
13165,Jenkins County,2021-02-09,14,919,10.5
13165,Jenkins County,2021-02-10,23,942,10.7
13165,Jenkins County,2021-02-11,18,960,10.9
13165,Jenkins County,2021-02-12,5,965,11
13165,Jenkins County,2021-02-13,6,971,11
13165,Jenkins County,2021-02-15,3,974,11.1
13165,Jenkins County,2021-02-16,16,990,11.3
13165,Jenkins County,2021-02-17,16,1006,11.4
13165,Jenkins County,2021-02-18,50,1056,12
13165,Jenkins County,2021-02-19,16,1072,12.2
13165,Jenkins County,2021-02-20,2,1074,12.2
13165,Jenkins County,2021-02-23,35,1109,12.6
13165,Jenkins County,2021-02-24,30,1139,13
13165,Jenkins County,2021-02-25,3,1142,13
13165,Jenkins County,2021-02-26,7,1149,13.1
13165,Jenkins County,2021-02-28,4,1153,13.1
13165,Jenkins County,2021-03-01,9,1162,13.2
13165,Jenkins County,2021-03-02,13,1175,13.4
13165,Jenkins County,2021-03-03,17,1192,13.6
13165,Jenkins County,2021-03-04,10,1202,13.7
13165,Jenkins County,2021-03-05,6,1208,13.7
13165,Jenkins County,2021-03-06,1,1209,13.7
13165,Jenkins County,2021-03-07,1,1210,13.8
13165,Jenkins County,2021-03-08,8,1218,13.9
13165,Jenkins County,2021-03-09,8,1226,13.9
13165,Jenkins County,2021-03-10,19,1245,14.2
13165,Jenkins County,2021-03-11,64,1309,14.9
13165,Jenkins County,2021-03-12,30,1339,15.2
13165,Jenkins County,2021-03-13,2,1341,15.3
13165,Jenkins County,2021-03-14,2,1343,15.3
13165,Jenkins County,2021-03-15,11,1354,15.4
13165,Jenkins County,2021-03-16,19,1373,15.6
13165,Jenkins County,2021-03-17,41,1414,16.1
13165,Jenkins County,2021-03-18,27,1441,16.4
13165,Jenkins County,2021-03-19,27,1468,16.7
13165,Jenkins County,2021-03-20,2,1470,16.7
13165,Jenkins County,2021-03-21,1,1471,16.7
13165,Jenkins County,2021-03-22,24,1495,17
13165,Jenkins County,2021-03-23,48,1543,17.5
13165,Jenkins County,2021-03-24,45,1588,18.1
13165,Jenkins County,2021-03-25,41,1629,18.5
13165,Jenkins County,2021-03-26,26,1655,18.8
13165,Jenkins County,2021-03-27,12,1667,19
13165,Jenkins County,2021-03-28,2,1669,19
13165,Jenkins County,2021-03-29,6,1675,19
13165,Jenkins County,2021-03-30,13,1688,19.2
13165,Jenkins County,2021-03-31,30,1718,19.5
13165,Jenkins County,2021-04-01,33,1751,19.9
13165,Jenkins County,2021-04-02,28,1779,20.2
13165,Jenkins County,2021-04-03,6,1785,20.3
13165,Jenkins County,2021-04-05,10,1795,20.4
13165,Jenkins County,2021-04-06,13,1808,20.6
13165,Jenkins County,2021-04-07,29,1837,20.9
13165,Jenkins County,2021-04-08,20,1857,21.1
13165,Jenkins County,2021-04-09,20,1877,21.3
13165,Jenkins County,2021-04-10,6,1883,21.4
13165,Jenkins County,2021-04-11,1,1884,21.4
13165,Jenkins County,2021-04-12,5,1889,21.5
13165,Jenkins County,2021-04-13,15,1904,21.7
13165,Jenkins County,2021-04-14,8,1912,21.7
13165,Jenkins County,2021-04-15,10,1922,21.9
13165,Jenkins County,2021-04-16,8,1930,21.9
13165,Jenkins County,2021-04-17,3,1933,22
13165,Jenkins County,2021-04-18,1,1934,22
13165,Jenkins County,2021-04-19,7,1941,22.1
13165,Jenkins County,2021-04-20,18,1959,22.3
13165,Jenkins County,2021-04-21,16,1975,22.5
13165,Jenkins County,2021-04-22,15,1990,22.6
13165,Jenkins County,2021-04-23,10,2000,22.7
13165,Jenkins County,2021-04-24,2,2002,22.8
13165,Jenkins County,2021-04-26,5,2007,22.8
13165,Jenkins County,2021-04-27,7,2014,22.9
13165,Jenkins County,2021-04-28,9,2023,23
13165,Jenkins County,2021-04-29,10,2033,23.1
13165,Jenkins County,2021-04-30,14,2047,23.3
13165,Jenkins County,2021-05-01,6,2053,23.3
13165,Jenkins County,2021-05-02,2,2055,23.4
13165,Jenkins County,2021-05-03,6,2061,23.4
13165,Jenkins County,2021-05-04,9,2070,23.5
13165,Jenkins County,2021-05-05,8,2078,23.6
13165,Jenkins County,2021-05-06,13,2091,23.8
13165,Jenkins County,2021-05-07,10,2101,23.9
13165,Jenkins County,2021-05-08,1,2102,23.9
13165,Jenkins County,2021-05-09,1,2103,23.9
13165,Jenkins County,2021-05-10,4,2107,24
13165,Jenkins County,2021-05-11,8,2115,24.1
13165,Jenkins County,2021-05-12,8,2123,24.1
13165,Jenkins County,2021-05-13,11,2134,24.3
13165,Jenkins County,2021-05-14,5,2139,24.3
13165,Jenkins County,2021-05-15,2,2141,24.3
13165,Jenkins County,2021-05-16,1,2142,24.4
13165,Jenkins County,2021-05-17,3,2145,24.4
13165,Jenkins County,2021-05-18,11,2156,24.5
13165,Jenkins County,2021-05-19,11,2167,24.6
13165,Jenkins County,2021-05-20,19,2186,24.9
13165,Jenkins County,2021-05-21,7,2193,24.9
13165,Jenkins County,2021-05-22,4,2197,25
13165,Jenkins County,2021-05-24,8,2205,25.1
13165,Jenkins County,2021-05-25,14,2219,25.2
13165,Jenkins County,2021-05-26,11,2230,25.4
13165,Jenkins County,2021-05-27,4,2234,25.4
13165,Jenkins County,2021-05-28,5,2239,25.5
13165,Jenkins County,2021-05-29,1,2240,25.5
13165,Jenkins County,2021-05-30,1,2241,25.5
13165,Jenkins County,2021-06-01,3,2244,25.5
13165,Jenkins County,2021-06-02,8,2252,25.6
13165,Jenkins County,2021-06-03,6,2258,25.7
13165,Jenkins County,2021-06-04,5,2263,25.7
13165,Jenkins County,2021-06-05,7,2270,25.8
13165,Jenkins County,2021-06-07,1,2271,25.8
13165,Jenkins County,2021-06-08,4,2275,25.9
13165,Jenkins County,2021-06-09,5,2280,25.9
13165,Jenkins County,2021-06-10,5,2285,26
13165,Jenkins County,2021-06-11,8,2293,26.1
13165,Jenkins County,2021-06-12,4,2297,26.1
13165,Jenkins County,2021-06-13,1,2298,26.1
13165,Jenkins County,2021-06-15,4,2302,26.2
13165,Jenkins County,2021-06-16,7,2309,26.3
13165,Jenkins County,2021-06-17,5,2314,26.3
13165,Jenkins County,2021-06-18,8,2322,26.4
13165,Jenkins County,2021-06-19,6,2328,26.5
13165,Jenkins County,2021-06-21,3,2331,26.5
13165,Jenkins County,2021-06-22,6,2337,26.6
13165,Jenkins County,2021-06-23,5,2342,26.6
13165,Jenkins County,2021-06-24,3,2345,26.7
13165,Jenkins County,2021-06-25,9,2354,26.8
13165,Jenkins County,2021-06-26,1,2355,26.8
13165,Jenkins County,2021-06-28,2,2357,26.8
13165,Jenkins County,2021-06-29,2,2359,26.8
13165,Jenkins County,2021-06-30,4,2363,26.9
13165,Jenkins County,2021-07-02,5,2368,26.9
13165,Jenkins County,2021-07-03,2,2370,27
13165,Jenkins County,2021-07-06,2,2372,27
13165,Jenkins County,2021-07-07,4,2376,27
13165,Jenkins County,2021-07-08,1,2377,27
13165,Jenkins County,2021-07-10,1,2378,27
13165,Jenkins County,2021-07-12,1,2379,27.1
13165,Jenkins County,2021-07-13,9,2388,27.2
13165,Jenkins County,2021-07-14,10,2398,27.3
13165,Jenkins County,2021-07-15,4,2402,27.3
13165,Jenkins County,2021-07-16,7,2409,27.4
13165,Jenkins County,2021-07-19,2,2411,27.4
13165,Jenkins County,2021-07-20,20,2431,27.6
13165,Jenkins County,2021-07-21,13,2444,27.8
13165,Jenkins County,2021-07-22,8,2452,27.9
13165,Jenkins County,2021-07-23,20,2472,28.1
13165,Jenkins County,2021-07-25,6,2478,28.2
13165,Jenkins County,2021-07-26,7,2485,28.3
13165,Jenkins County,2021-07-27,14,2499,28.4
13165,Jenkins County,2021-07-28,15,2514,28.6
13165,Jenkins County,2021-07-29,27,2541,28.9
13165,Jenkins County,2021-07-30,15,2556,29.1
13165,Jenkins County,2021-07-31,4,2560,29.1
13165,Jenkins County,2021-08-01,1,2561,29.1
13165,Jenkins County,2021-08-02,12,2573,29.3
13165,Jenkins County,2021-08-03,15,2588,29.4
13165,Jenkins County,2021-08-04,16,2604,29.6
13165,Jenkins County,2021-08-05,15,2619,29.8
13165,Jenkins County,2021-08-06,14,2633,29.9
13165,Jenkins County,2021-08-07,6,2639,30
13165,Jenkins County,2021-08-08,2,2641,30
13165,Jenkins County,2021-08-09,13,2654,30.2
13165,Jenkins County,2021-08-10,29,2683,30.5
13165,Jenkins County,2021-08-11,26,2709,30.8
13165,Jenkins County,2021-08-12,49,2758,31.4
13165,Jenkins County,2021-08-13,32,2790,31.7
13165,Jenkins County,2021-08-14,10,2800,31.8
13165,Jenkins County,2021-08-15,5,2805,31.9
13165,Jenkins County,2021-08-16,14,2819,32.1
13165,Jenkins County,2021-08-17,27,2846,32.4
13165,Jenkins County,2021-08-18,26,2872,32.7
13165,Jenkins County,2021-08-19,21,2893,32.9
13165,Jenkins County,2021-08-20,33,2926,33.3
13165,Jenkins County,2021-08-21,7,2933,33.4
13165,Jenkins County,2021-08-22,2,2935,33.4
13165,Jenkins County,2021-08-23,25,2960,33.7
13165,Jenkins County,2021-08-24,24,2984,33.9
13165,Jenkins County,2021-08-25,17,3001,34.1
13165,Jenkins County,2021-08-26,18,3019,34.3
13165,Jenkins County,2021-08-27,22,3041,34.6
13165,Jenkins County,2021-08-28,8,3049,34.7
13165,Jenkins County,2021-08-29,6,3055,34.7
13165,Jenkins County,2021-08-30,26,3081,35
13165,Jenkins County,2021-08-31,23,3104,35.3
13165,Jenkins County,2021-09-01,13,3117,35.4
13165,Jenkins County,2021-09-02,25,3142,35.7
13165,Jenkins County,2021-09-03,22,3164,36
13165,Jenkins County,2021-09-04,5,3169,36
13165,Jenkins County,2021-09-06,3,3172,36.1
13165,Jenkins County,2021-09-07,18,3190,36.3
13165,Jenkins County,2021-09-08,18,3208,36.5
13165,Jenkins County,2021-09-09,10,3218,36.6
13165,Jenkins County,2021-09-10,20,3238,36.8
13165,Jenkins County,2021-09-11,4,3242,36.9
13165,Jenkins County,2021-09-12,1,3243,36.9
13165,Jenkins County,2021-09-13,15,3258,37.1
13165,Jenkins County,2021-09-14,20,3278,37.3
13165,Jenkins County,2021-09-15,15,3293,37.5
13165,Jenkins County,2021-09-16,8,3301,37.5
13165,Jenkins County,2021-09-17,8,3309,37.6
13165,Jenkins County,2021-09-18,4,3313,37.7
13165,Jenkins County,2021-09-20,7,3320,37.8
13165,Jenkins County,2021-09-21,15,3335,37.9
13165,Jenkins County,2021-09-22,10,3345,38
13165,Jenkins County,2021-09-23,10,3355,38.2
13165,Jenkins County,2021-09-24,8,3363,38.2
13165,Jenkins County,2021-09-25,2,3365,38.3
13165,Jenkins County,2021-09-27,4,3369,38.3
13165,Jenkins County,2021-09-28,7,3376,38.4
13165,Jenkins County,2021-09-29,7,3383,38.5
13165,Jenkins County,2021-09-30,2,3385,38.5
13165,Jenkins County,2021-10-01,4,3389,38.5
13165,Jenkins County,2021-10-02,4,3393,38.6
13165,Jenkins County,2021-10-04,2,3395,38.6
13165,Jenkins County,2021-10-05,10,3405,38.7
13165,Jenkins County,2021-10-06,4,3409,38.8
13165,Jenkins County,2021-10-07,4,3413,38.8
13167,Johnson County,2020-12-17,1,1,0
13167,Johnson County,2020-12-18,1,2,0
13167,Johnson County,2020-12-19,1,3,0
13167,Johnson County,2020-12-21,1,4,0
13167,Johnson County,2020-12-22,9,13,0.1
13167,Johnson County,2020-12-23,6,19,0.2
13167,Johnson County,2020-12-24,4,23,0.2
13167,Johnson County,2020-12-28,30,53,0.5
13167,Johnson County,2020-12-29,8,61,0.6
13167,Johnson County,2020-12-30,6,67,0.7
13167,Johnson County,2020-12-31,7,74,0.8
13167,Johnson County,2021-01-02,2,76,0.8
13167,Johnson County,2021-01-04,10,86,0.9
13167,Johnson County,2021-01-05,30,116,1.2
13167,Johnson County,2021-01-06,10,126,1.3
13167,Johnson County,2021-01-07,29,155,1.6
13167,Johnson County,2021-01-08,29,184,1.9
13167,Johnson County,2021-01-09,1,185,1.9
13167,Johnson County,2021-01-11,8,193,2
13167,Johnson County,2021-01-12,33,226,2.3
13167,Johnson County,2021-01-13,30,256,2.6
13167,Johnson County,2021-01-14,22,278,2.9
13167,Johnson County,2021-01-15,139,417,4.3
13167,Johnson County,2021-01-16,2,419,4.3
13167,Johnson County,2021-01-17,3,422,4.4
13167,Johnson County,2021-01-18,16,438,4.5
13167,Johnson County,2021-01-19,60,498,5.1
13167,Johnson County,2021-01-20,58,556,5.7
13167,Johnson County,2021-01-21,22,578,6
13167,Johnson County,2021-01-22,115,693,7.2
13167,Johnson County,2021-01-23,1,694,7.2
13167,Johnson County,2021-01-25,35,729,7.5
13167,Johnson County,2021-01-26,12,741,7.6
13167,Johnson County,2021-01-27,11,752,7.8
13167,Johnson County,2021-01-28,7,759,7.8
13167,Johnson County,2021-01-29,137,896,9.2
13167,Johnson County,2021-01-30,1,897,9.3
13167,Johnson County,2021-02-01,2,899,9.3
13167,Johnson County,2021-02-02,11,910,9.4
13167,Johnson County,2021-02-03,17,927,9.6
13167,Johnson County,2021-02-04,14,941,9.7
13167,Johnson County,2021-02-05,45,986,10.2
13167,Johnson County,2021-02-08,2,988,10.2
13167,Johnson County,2021-02-09,66,1054,10.9
13167,Johnson County,2021-02-10,13,1067,11
13167,Johnson County,2021-02-11,5,1072,11.1
13167,Johnson County,2021-02-12,35,1107,11.4
13167,Johnson County,2021-02-13,2,1109,11.4
13167,Johnson County,2021-02-14,9,1118,11.5
13167,Johnson County,2021-02-15,6,1124,11.6
13167,Johnson County,2021-02-16,3,1127,11.6
13167,Johnson County,2021-02-17,49,1176,12.1
13167,Johnson County,2021-02-18,7,1183,12.2
13167,Johnson County,2021-02-19,4,1187,12.2
13167,Johnson County,2021-02-22,4,1191,12.3
13167,Johnson County,2021-02-23,6,1197,12.4
13167,Johnson County,2021-02-24,25,1222,12.6
13167,Johnson County,2021-02-25,10,1232,12.7
13167,Johnson County,2021-02-26,4,1236,12.8
13167,Johnson County,2021-03-01,4,1240,12.8
13167,Johnson County,2021-03-02,4,1244,12.8
13167,Johnson County,2021-03-03,24,1268,13.1
13167,Johnson County,2021-03-04,4,1272,13.1
13167,Johnson County,2021-03-05,8,1280,13.2
13167,Johnson County,2021-03-08,6,1286,13.3
13167,Johnson County,2021-03-09,9,1295,13.4
13167,Johnson County,2021-03-10,41,1336,13.8
13167,Johnson County,2021-03-11,10,1346,13.9
13167,Johnson County,2021-03-12,37,1383,14.3
13167,Johnson County,2021-03-13,1,1384,14.3
13167,Johnson County,2021-03-15,19,1403,14.5
13167,Johnson County,2021-03-16,13,1416,14.6
13167,Johnson County,2021-03-17,117,1533,15.8
13167,Johnson County,2021-03-18,15,1548,16
13167,Johnson County,2021-03-19,20,1568,16.2
13167,Johnson County,2021-03-20,4,1572,16.2
13167,Johnson County,2021-03-21,1,1573,16.2
13167,Johnson County,2021-03-22,7,1580,16.3
13167,Johnson County,2021-03-23,10,1590,16.4
13167,Johnson County,2021-03-24,61,1651,17
13167,Johnson County,2021-03-25,18,1669,17.2
13167,Johnson County,2021-03-26,26,1695,17.5
13167,Johnson County,2021-03-27,10,1705,17.6
13167,Johnson County,2021-03-28,2,1707,17.6
13167,Johnson County,2021-03-29,5,1712,17.7
13167,Johnson County,2021-03-30,25,1737,17.9
13167,Johnson County,2021-03-31,46,1783,18.4
13167,Johnson County,2021-04-01,27,1810,18.7
13167,Johnson County,2021-04-02,13,1823,18.8
13167,Johnson County,2021-04-03,4,1827,18.9
13167,Johnson County,2021-04-04,1,1828,18.9
13167,Johnson County,2021-04-05,9,1837,19
13167,Johnson County,2021-04-06,45,1882,19.4
13167,Johnson County,2021-04-07,42,1924,19.9
13167,Johnson County,2021-04-08,14,1938,20
13167,Johnson County,2021-04-09,72,2010,20.7
13167,Johnson County,2021-04-10,5,2015,20.8
13167,Johnson County,2021-04-11,1,2016,20.8
13167,Johnson County,2021-04-12,3,2019,20.8
13167,Johnson County,2021-04-13,12,2031,21
13167,Johnson County,2021-04-14,19,2050,21.2
13167,Johnson County,2021-04-15,12,2062,21.3
13167,Johnson County,2021-04-16,7,2069,21.3
13167,Johnson County,2021-04-17,2,2071,21.4
13167,Johnson County,2021-04-19,1,2072,21.4
13167,Johnson County,2021-04-20,5,2077,21.4
13167,Johnson County,2021-04-21,48,2125,21.9
13167,Johnson County,2021-04-22,8,2133,22
13167,Johnson County,2021-04-23,10,2143,22.1
13167,Johnson County,2021-04-24,1,2144,22.1
13167,Johnson County,2021-04-26,3,2147,22.2
13167,Johnson County,2021-04-27,13,2160,22.3
13167,Johnson County,2021-04-28,16,2176,22.5
13167,Johnson County,2021-04-29,7,2183,22.5
13167,Johnson County,2021-04-30,19,2202,22.7
13167,Johnson County,2021-05-01,3,2205,22.8
13167,Johnson County,2021-05-03,1,2206,22.8
13167,Johnson County,2021-05-04,9,2215,22.9
13167,Johnson County,2021-05-05,8,2223,22.9
13167,Johnson County,2021-05-06,12,2235,23.1
13167,Johnson County,2021-05-07,7,2242,23.1
13167,Johnson County,2021-05-08,7,2249,23.2
13167,Johnson County,2021-05-10,6,2255,23.3
13167,Johnson County,2021-05-11,10,2265,23.4
13167,Johnson County,2021-05-12,11,2276,23.5
13167,Johnson County,2021-05-13,17,2293,23.7
13167,Johnson County,2021-05-14,9,2302,23.8
13167,Johnson County,2021-05-15,5,2307,23.8
13167,Johnson County,2021-05-16,1,2308,23.8
13167,Johnson County,2021-05-17,13,2321,24
13167,Johnson County,2021-05-18,24,2345,24.2
13167,Johnson County,2021-05-19,7,2352,24.3
13167,Johnson County,2021-05-20,7,2359,24.3
13167,Johnson County,2021-05-21,4,2363,24.4
13167,Johnson County,2021-05-22,4,2367,24.4
13167,Johnson County,2021-05-23,1,2368,24.4
13167,Johnson County,2021-05-24,4,2372,24.5
13167,Johnson County,2021-05-25,16,2388,24.6
13167,Johnson County,2021-05-26,6,2394,24.7
13167,Johnson County,2021-05-27,10,2404,24.8
13167,Johnson County,2021-05-28,3,2407,24.8
13167,Johnson County,2021-05-29,3,2410,24.9
13167,Johnson County,2021-05-30,2,2412,24.9
13167,Johnson County,2021-05-31,1,2413,24.9
13167,Johnson County,2021-06-01,10,2423,25
13167,Johnson County,2021-06-02,16,2439,25.2
13167,Johnson County,2021-06-03,2,2441,25.2
13167,Johnson County,2021-06-04,2,2443,25.2
13167,Johnson County,2021-06-05,1,2444,25.2
13167,Johnson County,2021-06-07,4,2448,25.3
13167,Johnson County,2021-06-08,5,2453,25.3
13167,Johnson County,2021-06-09,7,2460,25.4
13167,Johnson County,2021-06-10,1,2461,25.4
13167,Johnson County,2021-06-11,3,2464,25.4
13167,Johnson County,2021-06-12,2,2466,25.4
13167,Johnson County,2021-06-14,3,2469,25.5
13167,Johnson County,2021-06-15,2,2471,25.5
13167,Johnson County,2021-06-16,16,2487,25.7
13167,Johnson County,2021-06-17,4,2491,25.7
13167,Johnson County,2021-06-18,6,2497,25.8
13167,Johnson County,2021-06-21,1,2498,25.8
13167,Johnson County,2021-06-22,5,2503,25.8
13167,Johnson County,2021-06-23,2,2505,25.8
13167,Johnson County,2021-06-24,4,2509,25.9
13167,Johnson County,2021-06-25,3,2512,25.9
13167,Johnson County,2021-06-26,3,2515,26
13167,Johnson County,2021-06-29,3,2518,26
13167,Johnson County,2021-06-30,2,2520,26
13167,Johnson County,2021-07-01,4,2524,26
13167,Johnson County,2021-07-02,1,2525,26.1
13167,Johnson County,2021-07-06,1,2526,26.1
13167,Johnson County,2021-07-07,3,2529,26.1
13167,Johnson County,2021-07-08,8,2537,26.2
13167,Johnson County,2021-07-09,5,2542,26.2
13167,Johnson County,2021-07-11,1,2543,26.2
13167,Johnson County,2021-07-12,2,2545,26.3
13167,Johnson County,2021-07-13,5,2550,26.3
13167,Johnson County,2021-07-14,1,2551,26.3
13167,Johnson County,2021-07-15,3,2554,26.4
13167,Johnson County,2021-07-16,6,2560,26.4
13167,Johnson County,2021-07-17,1,2561,26.4
13167,Johnson County,2021-07-19,6,2567,26.5
13167,Johnson County,2021-07-20,10,2577,26.6
13167,Johnson County,2021-07-21,4,2581,26.6
13167,Johnson County,2021-07-22,11,2592,26.7
13167,Johnson County,2021-07-23,12,2604,26.9
13167,Johnson County,2021-07-24,8,2612,27
13167,Johnson County,2021-07-25,5,2617,27
13167,Johnson County,2021-07-26,14,2631,27.1
13167,Johnson County,2021-07-27,9,2640,27.2
13167,Johnson County,2021-07-28,23,2663,27.5
13167,Johnson County,2021-07-29,13,2676,27.6
13167,Johnson County,2021-07-30,11,2687,27.7
13167,Johnson County,2021-07-31,6,2693,27.8
13167,Johnson County,2021-08-01,5,2698,27.8
13167,Johnson County,2021-08-02,19,2717,28
13167,Johnson County,2021-08-03,18,2735,28.2
13167,Johnson County,2021-08-04,21,2756,28.4
13167,Johnson County,2021-08-05,8,2764,28.5
13167,Johnson County,2021-08-06,23,2787,28.8
13167,Johnson County,2021-08-07,10,2797,28.9
13167,Johnson County,2021-08-08,5,2802,28.9
13167,Johnson County,2021-08-09,28,2830,29.2
13167,Johnson County,2021-08-10,21,2851,29.4
13167,Johnson County,2021-08-11,23,2874,29.7
13167,Johnson County,2021-08-12,17,2891,29.8
13167,Johnson County,2021-08-13,20,2911,30
13167,Johnson County,2021-08-14,5,2916,30.1
13167,Johnson County,2021-08-15,4,2920,30.1
13167,Johnson County,2021-08-16,27,2947,30.4
13167,Johnson County,2021-08-17,25,2972,30.7
13167,Johnson County,2021-08-18,18,2990,30.9
13167,Johnson County,2021-08-19,26,3016,31.1
13167,Johnson County,2021-08-20,31,3047,31.4
13167,Johnson County,2021-08-21,16,3063,31.6
13167,Johnson County,2021-08-22,2,3065,31.6
13167,Johnson County,2021-08-23,22,3087,31.9
13167,Johnson County,2021-08-24,28,3115,32.1
13167,Johnson County,2021-08-25,45,3160,32.6
13167,Johnson County,2021-08-26,21,3181,32.8
13167,Johnson County,2021-08-27,28,3209,33.1
13167,Johnson County,2021-08-28,7,3216,33.2
13167,Johnson County,2021-08-29,4,3220,33.2
13167,Johnson County,2021-08-30,35,3255,33.6
13167,Johnson County,2021-08-31,16,3271,33.8
13167,Johnson County,2021-09-01,40,3311,34.2
13167,Johnson County,2021-09-02,25,3336,34.4
13167,Johnson County,2021-09-03,14,3350,34.6
13167,Johnson County,2021-09-04,4,3354,34.6
13167,Johnson County,2021-09-05,6,3360,34.7
13167,Johnson County,2021-09-06,4,3364,34.7
13167,Johnson County,2021-09-07,10,3374,34.8
13167,Johnson County,2021-09-08,22,3396,35
13167,Johnson County,2021-09-09,37,3433,35.4
13167,Johnson County,2021-09-10,19,3452,35.6
13167,Johnson County,2021-09-11,6,3458,35.7
13167,Johnson County,2021-09-12,6,3464,35.7
13167,Johnson County,2021-09-13,10,3474,35.8
13167,Johnson County,2021-09-14,13,3487,36
13167,Johnson County,2021-09-15,19,3506,36.2
13167,Johnson County,2021-09-16,6,3512,36.2
13167,Johnson County,2021-09-17,12,3524,36.4
13167,Johnson County,2021-09-18,4,3528,36.4
13167,Johnson County,2021-09-20,8,3536,36.5
13167,Johnson County,2021-09-21,2,3538,36.5
13167,Johnson County,2021-09-22,6,3544,36.6
13167,Johnson County,2021-09-23,8,3552,36.7
13167,Johnson County,2021-09-24,8,3560,36.7
13167,Johnson County,2021-09-25,1,3561,36.7
13167,Johnson County,2021-09-26,1,3562,36.8
13167,Johnson County,2021-09-27,7,3569,36.8
13167,Johnson County,2021-09-28,2,3571,36.8
13167,Johnson County,2021-09-29,7,3578,36.9
13167,Johnson County,2021-09-30,5,3583,37
13167,Johnson County,2021-10-01,4,3587,37
13167,Johnson County,2021-10-02,2,3589,37
13167,Johnson County,2021-10-03,1,3590,37
13167,Johnson County,2021-10-04,4,3594,37.1
13167,Johnson County,2021-10-05,3,3597,37.1
13169,Jones County,2020-12-17,2,2,0
13169,Jones County,2020-12-18,1,3,0
13169,Jones County,2020-12-19,1,4,0
13169,Jones County,2020-12-20,1,5,0
13169,Jones County,2020-12-21,6,11,0
13169,Jones County,2020-12-22,14,25,0.1
13169,Jones County,2020-12-23,24,49,0.2
13169,Jones County,2020-12-24,34,83,0.3
13169,Jones County,2020-12-26,21,104,0.4
13169,Jones County,2020-12-27,7,111,0.4
13169,Jones County,2020-12-28,82,193,0.7
13169,Jones County,2020-12-29,43,236,0.8
13169,Jones County,2020-12-30,47,283,1
13169,Jones County,2020-12-31,6,289,1
13169,Jones County,2021-01-01,1,290,1
13169,Jones County,2021-01-02,2,292,1
13169,Jones County,2021-01-03,3,295,1
13169,Jones County,2021-01-04,43,338,1.2
13169,Jones County,2021-01-05,92,430,1.5
13169,Jones County,2021-01-06,57,487,1.7
13169,Jones County,2021-01-07,44,531,1.9
13169,Jones County,2021-01-08,31,562,2
13169,Jones County,2021-01-09,5,567,2
13169,Jones County,2021-01-10,4,571,2
13169,Jones County,2021-01-11,64,635,2.2
13169,Jones County,2021-01-12,63,698,2.4
13169,Jones County,2021-01-13,72,770,2.7
13169,Jones County,2021-01-14,139,909,3.2
13169,Jones County,2021-01-15,93,1002,3.5
13169,Jones County,2021-01-16,19,1021,3.6
13169,Jones County,2021-01-17,14,1035,3.6
13169,Jones County,2021-01-18,89,1124,3.9
13169,Jones County,2021-01-19,137,1261,4.4
13169,Jones County,2021-01-20,141,1402,4.9
13169,Jones County,2021-01-21,143,1545,5.4
13169,Jones County,2021-01-22,166,1711,6
13169,Jones County,2021-01-23,81,1792,6.3
13169,Jones County,2021-01-24,19,1811,6.3
13169,Jones County,2021-01-25,80,1891,6.6
13169,Jones County,2021-01-26,32,1923,6.7
13169,Jones County,2021-01-27,130,2053,7.2
13169,Jones County,2021-01-28,75,2128,7.4
13169,Jones County,2021-01-29,148,2276,8
13169,Jones County,2021-01-30,13,2289,8
13169,Jones County,2021-01-31,2,2291,8
13169,Jones County,2021-02-01,52,2343,8.2
13169,Jones County,2021-02-02,82,2425,8.5
13169,Jones County,2021-02-03,71,2496,8.7
13169,Jones County,2021-02-04,121,2617,9.2
13169,Jones County,2021-02-05,107,2724,9.5
13169,Jones County,2021-02-06,13,2737,9.6
13169,Jones County,2021-02-07,1,2738,9.6
13169,Jones County,2021-02-08,36,2774,9.7
13169,Jones County,2021-02-09,66,2840,9.9
13169,Jones County,2021-02-10,90,2930,10.3
13169,Jones County,2021-02-11,56,2986,10.4
13169,Jones County,2021-02-12,72,3058,10.7
13169,Jones County,2021-02-13,21,3079,10.8
13169,Jones County,2021-02-14,10,3089,10.8
13169,Jones County,2021-02-15,53,3142,11
13169,Jones County,2021-02-16,51,3193,11.2
13169,Jones County,2021-02-17,56,3249,11.4
13169,Jones County,2021-02-18,66,3315,11.6
13169,Jones County,2021-02-19,32,3347,11.7
13169,Jones County,2021-02-20,32,3379,11.8
13169,Jones County,2021-02-21,5,3384,11.8
13169,Jones County,2021-02-22,68,3452,12.1
13169,Jones County,2021-02-23,57,3509,12.3
13169,Jones County,2021-02-24,78,3587,12.6
13169,Jones County,2021-02-25,94,3681,12.9
13169,Jones County,2021-02-26,72,3753,13.1
13169,Jones County,2021-02-27,34,3787,13.3
13169,Jones County,2021-02-28,24,3811,13.3
13169,Jones County,2021-03-01,139,3950,13.8
13169,Jones County,2021-03-02,85,4035,14.1
13169,Jones County,2021-03-03,111,4146,14.5
13169,Jones County,2021-03-04,154,4300,15
13169,Jones County,2021-03-05,107,4407,15.4
13169,Jones County,2021-03-06,22,4429,15.5
13169,Jones County,2021-03-07,27,4456,15.6
13169,Jones County,2021-03-08,136,4592,16.1
13169,Jones County,2021-03-09,96,4688,16.4
13169,Jones County,2021-03-10,199,4887,17.1
13169,Jones County,2021-03-11,128,5015,17.5
13169,Jones County,2021-03-12,134,5149,18
13169,Jones County,2021-03-13,65,5214,18.2
13169,Jones County,2021-03-14,32,5246,18.4
13169,Jones County,2021-03-15,114,5360,18.8
13169,Jones County,2021-03-16,174,5534,19.4
13169,Jones County,2021-03-17,154,5688,19.9
13169,Jones County,2021-03-18,100,5788,20.3
13169,Jones County,2021-03-19,170,5958,20.8
13169,Jones County,2021-03-20,58,6016,21.1
13169,Jones County,2021-03-21,23,6039,21.1
13169,Jones County,2021-03-22,133,6172,21.6
13169,Jones County,2021-03-23,113,6285,22
13169,Jones County,2021-03-24,95,6380,22.3
13169,Jones County,2021-03-25,147,6527,22.8
13169,Jones County,2021-03-26,103,6630,23.2
13169,Jones County,2021-03-27,19,6649,23.3
13169,Jones County,2021-03-28,24,6673,23.3
13169,Jones County,2021-03-29,132,6805,23.8
13169,Jones County,2021-03-30,102,6907,24.2
13169,Jones County,2021-03-31,109,7016,24.5
13169,Jones County,2021-04-01,186,7202,25.2
13169,Jones County,2021-04-02,131,7333,25.7
13169,Jones County,2021-04-03,21,7354,25.7
13169,Jones County,2021-04-04,25,7379,25.8
13169,Jones County,2021-04-05,87,7466,26.1
13169,Jones County,2021-04-06,93,7559,26.4
13169,Jones County,2021-04-07,88,7647,26.8
13169,Jones County,2021-04-08,113,7760,27.2
13169,Jones County,2021-04-09,90,7850,27.5
13169,Jones County,2021-04-10,33,7883,27.6
13169,Jones County,2021-04-11,17,7900,27.6
13169,Jones County,2021-04-12,36,7936,27.8
13169,Jones County,2021-04-13,46,7982,27.9
13169,Jones County,2021-04-14,56,8038,28.1
13169,Jones County,2021-04-15,70,8108,28.4
13169,Jones County,2021-04-16,44,8152,28.5
13169,Jones County,2021-04-17,11,8163,28.6
13169,Jones County,2021-04-18,6,8169,28.6
13169,Jones County,2021-04-19,31,8200,28.7
13169,Jones County,2021-04-20,36,8236,28.8
13169,Jones County,2021-04-21,56,8292,29
13169,Jones County,2021-04-22,59,8351,29.2
13169,Jones County,2021-04-23,59,8410,29.4
13169,Jones County,2021-04-24,10,8420,29.5
13169,Jones County,2021-04-25,8,8428,29.5
13169,Jones County,2021-04-26,40,8468,29.6
13169,Jones County,2021-04-27,35,8503,29.8
13169,Jones County,2021-04-28,29,8532,29.9
13169,Jones County,2021-04-29,48,8580,30
13169,Jones County,2021-04-30,44,8624,30.2
13169,Jones County,2021-05-01,16,8640,30.2
13169,Jones County,2021-05-02,12,8652,30.3
13169,Jones County,2021-05-03,19,8671,30.3
13169,Jones County,2021-05-04,32,8703,30.5
13169,Jones County,2021-05-05,42,8745,30.6
13169,Jones County,2021-05-06,32,8777,30.7
13169,Jones County,2021-05-07,27,8804,30.8
13169,Jones County,2021-05-08,16,8820,30.9
13169,Jones County,2021-05-09,3,8823,30.9
13169,Jones County,2021-05-10,17,8840,30.9
13169,Jones County,2021-05-11,38,8878,31.1
13169,Jones County,2021-05-12,15,8893,31.1
13169,Jones County,2021-05-13,34,8927,31.2
13169,Jones County,2021-05-14,38,8965,31.4
13169,Jones County,2021-05-15,22,8987,31.4
13169,Jones County,2021-05-16,23,9010,31.5
13169,Jones County,2021-05-17,25,9035,31.6
13169,Jones County,2021-05-18,30,9065,31.7
13169,Jones County,2021-05-19,30,9095,31.8
13169,Jones County,2021-05-20,37,9132,32
13169,Jones County,2021-05-21,31,9163,32.1
13169,Jones County,2021-05-22,21,9184,32.1
13169,Jones County,2021-05-23,9,9193,32.2
13169,Jones County,2021-05-24,28,9221,32.3
13169,Jones County,2021-05-25,28,9249,32.4
13169,Jones County,2021-05-26,26,9275,32.5
13169,Jones County,2021-05-27,19,9294,32.5
13169,Jones County,2021-05-28,18,9312,32.6
13169,Jones County,2021-05-29,20,9332,32.7
13169,Jones County,2021-05-30,13,9345,32.7
13169,Jones County,2021-05-31,8,9353,32.7
13169,Jones County,2021-06-01,17,9370,32.8
13169,Jones County,2021-06-02,23,9393,32.9
13169,Jones County,2021-06-03,21,9414,32.9
13169,Jones County,2021-06-04,12,9426,33
13169,Jones County,2021-06-05,12,9438,33
13169,Jones County,2021-06-06,9,9447,33.1
13169,Jones County,2021-06-07,21,9468,33.1
13169,Jones County,2021-06-08,20,9488,33.2
13169,Jones County,2021-06-09,14,9502,33.2
13169,Jones County,2021-06-10,27,9529,33.3
13169,Jones County,2021-06-11,17,9546,33.4
13169,Jones County,2021-06-12,9,9555,33.4
13169,Jones County,2021-06-13,12,9567,33.5
13169,Jones County,2021-06-14,15,9582,33.5
13169,Jones County,2021-06-15,18,9600,33.6
13169,Jones County,2021-06-16,11,9611,33.6
13169,Jones County,2021-06-17,13,9624,33.7
13169,Jones County,2021-06-18,17,9641,33.7
13169,Jones County,2021-06-19,5,9646,33.8
13169,Jones County,2021-06-20,4,9650,33.8
13169,Jones County,2021-06-21,15,9665,33.8
13169,Jones County,2021-06-22,13,9678,33.9
13169,Jones County,2021-06-23,22,9700,33.9
13169,Jones County,2021-06-24,12,9712,34
13169,Jones County,2021-06-25,20,9732,34.1
13169,Jones County,2021-06-26,9,9741,34.1
13169,Jones County,2021-06-27,6,9747,34.1
13169,Jones County,2021-06-28,9,9756,34.1
13169,Jones County,2021-06-29,24,9780,34.2
13169,Jones County,2021-06-30,17,9797,34.3
13169,Jones County,2021-07-01,18,9815,34.3
13169,Jones County,2021-07-02,11,9826,34.4
13169,Jones County,2021-07-03,8,9834,34.4
13169,Jones County,2021-07-04,1,9835,34.4
13169,Jones County,2021-07-05,11,9846,34.5
13169,Jones County,2021-07-06,18,9864,34.5
13169,Jones County,2021-07-07,12,9876,34.6
13169,Jones County,2021-07-08,20,9896,34.6
13169,Jones County,2021-07-09,15,9911,34.7
13169,Jones County,2021-07-10,13,9924,34.7
13169,Jones County,2021-07-11,9,9933,34.8
13169,Jones County,2021-07-12,13,9946,34.8
13169,Jones County,2021-07-13,21,9967,34.9
13169,Jones County,2021-07-14,21,9988,34.9
13169,Jones County,2021-07-15,19,10007,35
13169,Jones County,2021-07-16,18,10025,35.1
13169,Jones County,2021-07-17,13,10038,35.1
13169,Jones County,2021-07-18,11,10049,35.2
13169,Jones County,2021-07-19,29,10078,35.3
13169,Jones County,2021-07-20,28,10106,35.4
13169,Jones County,2021-07-21,30,10136,35.5
13169,Jones County,2021-07-22,28,10164,35.6
13169,Jones County,2021-07-23,44,10208,35.7
13169,Jones County,2021-07-24,28,10236,35.8
13169,Jones County,2021-07-25,20,10256,35.9
13169,Jones County,2021-07-26,36,10292,36
13169,Jones County,2021-07-27,41,10333,36.2
13169,Jones County,2021-07-28,52,10385,36.3
13169,Jones County,2021-07-29,49,10434,36.5
13169,Jones County,2021-07-30,76,10510,36.8
13169,Jones County,2021-07-31,44,10554,36.9
13169,Jones County,2021-08-01,20,10574,37
13169,Jones County,2021-08-02,67,10641,37.2
13169,Jones County,2021-08-03,46,10687,37.4
13169,Jones County,2021-08-04,51,10738,37.6
13169,Jones County,2021-08-05,51,10789,37.8
13169,Jones County,2021-08-06,81,10870,38
13169,Jones County,2021-08-07,47,10917,38.2
13169,Jones County,2021-08-08,25,10942,38.3
13169,Jones County,2021-08-09,72,11014,38.5
13169,Jones County,2021-08-10,64,11078,38.8
13169,Jones County,2021-08-11,68,11146,39
13169,Jones County,2021-08-12,75,11221,39.3
13169,Jones County,2021-08-13,82,11303,39.6
13169,Jones County,2021-08-14,38,11341,39.7
13169,Jones County,2021-08-15,35,11376,39.8
13169,Jones County,2021-08-16,67,11443,40
13169,Jones County,2021-08-17,60,11503,40.2
13169,Jones County,2021-08-18,50,11553,40.4
13169,Jones County,2021-08-19,78,11631,40.7
13169,Jones County,2021-08-20,83,11714,41
13169,Jones County,2021-08-21,52,11766,41.2
13169,Jones County,2021-08-22,34,11800,41.3
13169,Jones County,2021-08-23,53,11853,41.5
13169,Jones County,2021-08-24,82,11935,41.8
13169,Jones County,2021-08-25,69,12004,42
13169,Jones County,2021-08-26,79,12083,42.3
13169,Jones County,2021-08-27,59,12142,42.5
13169,Jones County,2021-08-28,35,12177,42.6
13169,Jones County,2021-08-29,38,12215,42.7
13169,Jones County,2021-08-30,37,12252,42.9
13169,Jones County,2021-08-31,49,12301,43
13169,Jones County,2021-09-01,70,12371,43.3
13169,Jones County,2021-09-02,54,12425,43.5
13169,Jones County,2021-09-03,75,12500,43.7
13169,Jones County,2021-09-04,38,12538,43.9
13169,Jones County,2021-09-05,27,12565,44
13169,Jones County,2021-09-06,16,12581,44
13169,Jones County,2021-09-07,40,12621,44.2
13169,Jones County,2021-09-08,68,12689,44.4
13169,Jones County,2021-09-09,71,12760,44.6
13169,Jones County,2021-09-10,60,12820,44.9
13169,Jones County,2021-09-11,38,12858,45
13169,Jones County,2021-09-12,25,12883,45.1
13169,Jones County,2021-09-13,38,12921,45.2
13169,Jones County,2021-09-14,49,12970,45.4
13169,Jones County,2021-09-15,32,13002,45.5
13169,Jones County,2021-09-16,26,13028,45.6
13169,Jones County,2021-09-17,47,13075,45.8
13169,Jones County,2021-09-18,21,13096,45.8
13169,Jones County,2021-09-19,16,13112,45.9
13169,Jones County,2021-09-20,24,13136,46
13169,Jones County,2021-09-21,29,13165,46.1
13169,Jones County,2021-09-22,41,13206,46.2
13169,Jones County,2021-09-23,28,13234,46.3
13169,Jones County,2021-09-24,23,13257,46.4
13169,Jones County,2021-09-25,10,13267,46.4
13169,Jones County,2021-09-26,4,13271,46.4
13169,Jones County,2021-09-27,14,13285,46.5
13169,Jones County,2021-09-28,18,13303,46.5
13169,Jones County,2021-09-29,22,13325,46.6
13169,Jones County,2021-09-30,17,13342,46.7
13169,Jones County,2021-10-01,18,13360,46.7
13169,Jones County,2021-10-02,6,13366,46.8
13169,Jones County,2021-10-03,5,13371,46.8
13169,Jones County,2021-10-04,9,13380,46.8
13169,Jones County,2021-10-05,8,13388,46.8
13169,Jones County,2021-10-06,12,13400,46.9
13169,Jones County,2021-10-07,4,13404,46.9
13171,Lamar County,2020-12-18,3,3,0
13171,Lamar County,2020-12-19,5,8,0
13171,Lamar County,2020-12-21,25,33,0.2
13171,Lamar County,2020-12-22,12,45,0.2
13171,Lamar County,2020-12-23,27,72,0.4
13171,Lamar County,2020-12-28,30,102,0.5
13171,Lamar County,2020-12-29,18,120,0.6
13171,Lamar County,2020-12-30,35,155,0.8
13171,Lamar County,2020-12-31,11,166,0.9
13171,Lamar County,2021-01-01,6,172,0.9
13171,Lamar County,2021-01-02,1,173,0.9
13171,Lamar County,2021-01-03,3,176,0.9
13171,Lamar County,2021-01-04,8,184,1
13171,Lamar County,2021-01-05,15,199,1.1
13171,Lamar County,2021-01-06,25,224,1.2
13171,Lamar County,2021-01-07,12,236,1.3
13171,Lamar County,2021-01-08,8,244,1.3
13171,Lamar County,2021-01-09,11,255,1.4
13171,Lamar County,2021-01-10,32,287,1.5
13171,Lamar County,2021-01-11,28,315,1.7
13171,Lamar County,2021-01-12,14,329,1.8
13171,Lamar County,2021-01-13,167,496,2.7
13171,Lamar County,2021-01-14,36,532,2.8
13171,Lamar County,2021-01-15,183,715,3.8
13171,Lamar County,2021-01-16,51,766,4.1
13171,Lamar County,2021-01-17,13,779,4.2
13171,Lamar County,2021-01-18,34,813,4.4
13171,Lamar County,2021-01-19,26,839,4.5
13171,Lamar County,2021-01-20,130,969,5.2
13171,Lamar County,2021-01-21,57,1026,5.5
13171,Lamar County,2021-01-22,71,1097,5.9
13171,Lamar County,2021-01-23,46,1143,6.1
13171,Lamar County,2021-01-24,6,1149,6.2
13171,Lamar County,2021-01-25,33,1182,6.3
13171,Lamar County,2021-01-26,27,1209,6.5
13171,Lamar County,2021-01-27,94,1303,7
13171,Lamar County,2021-01-28,48,1351,7.2
13171,Lamar County,2021-01-29,28,1379,7.4
13171,Lamar County,2021-01-30,7,1386,7.4
13171,Lamar County,2021-01-31,4,1390,7.4
13171,Lamar County,2021-02-01,4,1394,7.5
13171,Lamar County,2021-02-02,27,1421,7.6
13171,Lamar County,2021-02-03,55,1476,7.9
13171,Lamar County,2021-02-04,49,1525,8.2
13171,Lamar County,2021-02-05,15,1540,8.2
13171,Lamar County,2021-02-06,6,1546,8.3
13171,Lamar County,2021-02-07,2,1548,8.3
13171,Lamar County,2021-02-08,7,1555,8.3
13171,Lamar County,2021-02-09,6,1561,8.4
13171,Lamar County,2021-02-10,21,1582,8.5
13171,Lamar County,2021-02-11,30,1612,8.6
13171,Lamar County,2021-02-12,38,1650,8.8
13171,Lamar County,2021-02-13,4,1654,8.9
13171,Lamar County,2021-02-15,11,1665,8.9
13171,Lamar County,2021-02-16,13,1678,9
13171,Lamar County,2021-02-17,29,1707,9.1
13171,Lamar County,2021-02-18,32,1739,9.3
13171,Lamar County,2021-02-19,25,1764,9.4
13171,Lamar County,2021-02-20,7,1771,9.5
13171,Lamar County,2021-02-22,18,1789,9.6
13171,Lamar County,2021-02-23,29,1818,9.7
13171,Lamar County,2021-02-24,36,1854,9.9
13171,Lamar County,2021-02-25,31,1885,10.1
13171,Lamar County,2021-02-26,52,1937,10.4
13171,Lamar County,2021-02-27,15,1952,10.5
13171,Lamar County,2021-02-28,13,1965,10.5
13171,Lamar County,2021-03-01,33,1998,10.7
13171,Lamar County,2021-03-02,40,2038,10.9
13171,Lamar County,2021-03-03,70,2108,11.3
13171,Lamar County,2021-03-04,56,2164,11.6
13171,Lamar County,2021-03-05,94,2258,12.1
13171,Lamar County,2021-03-06,15,2273,12.2
13171,Lamar County,2021-03-07,7,2280,12.2
13171,Lamar County,2021-03-08,55,2335,12.5
13171,Lamar County,2021-03-09,43,2378,12.7
13171,Lamar County,2021-03-10,72,2450,13.1
13171,Lamar County,2021-03-11,66,2516,13.5
13171,Lamar County,2021-03-12,81,2597,13.9
13171,Lamar County,2021-03-13,14,2611,14
13171,Lamar County,2021-03-14,11,2622,14
13171,Lamar County,2021-03-15,69,2691,14.4
13171,Lamar County,2021-03-16,33,2724,14.6
13171,Lamar County,2021-03-17,77,2801,15
13171,Lamar County,2021-03-18,95,2896,15.5
13171,Lamar County,2021-03-19,58,2954,15.8
13171,Lamar County,2021-03-20,10,2964,15.9
13171,Lamar County,2021-03-21,14,2978,15.9
13171,Lamar County,2021-03-22,38,3016,16.2
13171,Lamar County,2021-03-23,46,3062,16.4
13171,Lamar County,2021-03-24,67,3129,16.8
13171,Lamar County,2021-03-25,121,3250,17.4
13171,Lamar County,2021-03-26,83,3333,17.9
13171,Lamar County,2021-03-27,17,3350,17.9
13171,Lamar County,2021-03-28,12,3362,18
13171,Lamar County,2021-03-29,56,3418,18.3
13171,Lamar County,2021-03-30,41,3459,18.5
13171,Lamar County,2021-03-31,71,3530,18.9
13171,Lamar County,2021-04-01,108,3638,19.5
13171,Lamar County,2021-04-02,69,3707,19.9
13171,Lamar County,2021-04-03,13,3720,19.9
13171,Lamar County,2021-04-04,14,3734,20
13171,Lamar County,2021-04-05,52,3786,20.3
13171,Lamar County,2021-04-06,33,3819,20.5
13171,Lamar County,2021-04-07,64,3883,20.8
13171,Lamar County,2021-04-08,75,3958,21.2
13171,Lamar County,2021-04-09,58,4016,21.5
13171,Lamar County,2021-04-10,19,4035,21.6
13171,Lamar County,2021-04-11,15,4050,21.7
13171,Lamar County,2021-04-12,34,4084,21.9
13171,Lamar County,2021-04-13,23,4107,22
13171,Lamar County,2021-04-14,35,4142,22.2
13171,Lamar County,2021-04-15,68,4210,22.5
13171,Lamar County,2021-04-16,66,4276,22.9
13171,Lamar County,2021-04-17,17,4293,23
13171,Lamar County,2021-04-18,5,4298,23
13171,Lamar County,2021-04-19,13,4311,23.1
13171,Lamar County,2021-04-20,16,4327,23.2
13171,Lamar County,2021-04-21,36,4363,23.4
13171,Lamar County,2021-04-22,76,4439,23.8
13171,Lamar County,2021-04-23,28,4467,23.9
13171,Lamar County,2021-04-24,8,4475,24
13171,Lamar County,2021-04-25,13,4488,24
13171,Lamar County,2021-04-26,26,4514,24.2
13171,Lamar County,2021-04-27,19,4533,24.3
13171,Lamar County,2021-04-28,18,4551,24.4
13171,Lamar County,2021-04-29,34,4585,24.6
13171,Lamar County,2021-04-30,21,4606,24.7
13171,Lamar County,2021-05-01,10,4616,24.7
13171,Lamar County,2021-05-02,3,4619,24.7
13171,Lamar County,2021-05-03,14,4633,24.8
13171,Lamar County,2021-05-04,21,4654,24.9
13171,Lamar County,2021-05-05,16,4670,25
13171,Lamar County,2021-05-06,18,4688,25.1
13171,Lamar County,2021-05-07,18,4706,25.2
13171,Lamar County,2021-05-08,5,4711,25.2
13171,Lamar County,2021-05-09,2,4713,25.2
13171,Lamar County,2021-05-10,13,4726,25.3
13171,Lamar County,2021-05-11,17,4743,25.4
13171,Lamar County,2021-05-12,16,4759,25.5
13171,Lamar County,2021-05-13,19,4778,25.6
13171,Lamar County,2021-05-14,27,4805,25.7
13171,Lamar County,2021-05-15,28,4833,25.9
13171,Lamar County,2021-05-16,10,4843,25.9
13171,Lamar County,2021-05-17,17,4860,26
13171,Lamar County,2021-05-18,28,4888,26.2
13171,Lamar County,2021-05-19,19,4907,26.3
13171,Lamar County,2021-05-20,20,4927,26.4
13171,Lamar County,2021-05-21,22,4949,26.5
13171,Lamar County,2021-05-22,15,4964,26.6
13171,Lamar County,2021-05-23,3,4967,26.6
13171,Lamar County,2021-05-24,20,4987,26.7
13171,Lamar County,2021-05-25,21,5008,26.8
13171,Lamar County,2021-05-26,7,5015,26.9
13171,Lamar County,2021-05-27,19,5034,27
13171,Lamar County,2021-05-28,12,5046,27
13171,Lamar County,2021-05-29,5,5051,27.1
13171,Lamar County,2021-05-30,3,5054,27.1
13171,Lamar County,2021-06-01,15,5069,27.1
13171,Lamar County,2021-06-02,16,5085,27.2
13171,Lamar County,2021-06-03,17,5102,27.3
13171,Lamar County,2021-06-04,14,5116,27.4
13171,Lamar County,2021-06-05,13,5129,27.5
13171,Lamar County,2021-06-06,5,5134,27.5
13171,Lamar County,2021-06-07,9,5143,27.5
13171,Lamar County,2021-06-08,5,5148,27.6
13171,Lamar County,2021-06-09,5,5153,27.6
13171,Lamar County,2021-06-10,14,5167,27.7
13171,Lamar County,2021-06-11,9,5176,27.7
13171,Lamar County,2021-06-12,5,5181,27.7
13171,Lamar County,2021-06-13,2,5183,27.8
13171,Lamar County,2021-06-14,4,5187,27.8
13171,Lamar County,2021-06-15,6,5193,27.8
13171,Lamar County,2021-06-16,6,5199,27.8
13171,Lamar County,2021-06-17,8,5207,27.9
13171,Lamar County,2021-06-18,8,5215,27.9
13171,Lamar County,2021-06-19,3,5218,27.9
13171,Lamar County,2021-06-20,4,5222,28
13171,Lamar County,2021-06-21,9,5231,28
13171,Lamar County,2021-06-22,12,5243,28.1
13171,Lamar County,2021-06-23,6,5249,28.1
13171,Lamar County,2021-06-24,10,5259,28.2
13171,Lamar County,2021-06-25,6,5265,28.2
13171,Lamar County,2021-06-26,13,5278,28.3
13171,Lamar County,2021-06-27,2,5280,28.3
13171,Lamar County,2021-06-28,14,5294,28.4
13171,Lamar County,2021-06-29,8,5302,28.4
13171,Lamar County,2021-06-30,10,5312,28.4
13171,Lamar County,2021-07-01,5,5317,28.5
13171,Lamar County,2021-07-02,10,5327,28.5
13171,Lamar County,2021-07-03,6,5333,28.6
13171,Lamar County,2021-07-05,5,5338,28.6
13171,Lamar County,2021-07-06,12,5350,28.7
13171,Lamar County,2021-07-07,10,5360,28.7
13171,Lamar County,2021-07-08,12,5372,28.8
13171,Lamar County,2021-07-09,10,5382,28.8
13171,Lamar County,2021-07-10,5,5387,28.9
13171,Lamar County,2021-07-11,1,5388,28.9
13171,Lamar County,2021-07-12,8,5396,28.9
13171,Lamar County,2021-07-13,8,5404,28.9
13171,Lamar County,2021-07-14,3,5407,29
13171,Lamar County,2021-07-15,8,5415,29
13171,Lamar County,2021-07-16,8,5423,29
13171,Lamar County,2021-07-17,4,5427,29.1
13171,Lamar County,2021-07-18,3,5430,29.1
13171,Lamar County,2021-07-19,20,5450,29.2
13171,Lamar County,2021-07-20,11,5461,29.2
13171,Lamar County,2021-07-21,16,5477,29.3
13171,Lamar County,2021-07-22,17,5494,29.4
13171,Lamar County,2021-07-23,17,5511,29.5
13171,Lamar County,2021-07-24,17,5528,29.6
13171,Lamar County,2021-07-25,4,5532,29.6
13171,Lamar County,2021-07-26,26,5558,29.8
13171,Lamar County,2021-07-27,40,5598,30
13171,Lamar County,2021-07-28,23,5621,30.1
13171,Lamar County,2021-07-29,17,5638,30.2
13171,Lamar County,2021-07-30,33,5671,30.4
13171,Lamar County,2021-07-31,15,5686,30.5
13171,Lamar County,2021-08-01,2,5688,30.5
13171,Lamar County,2021-08-02,24,5712,30.6
13171,Lamar County,2021-08-03,16,5728,30.7
13171,Lamar County,2021-08-04,32,5760,30.8
13171,Lamar County,2021-08-05,25,5785,31
13171,Lamar County,2021-08-06,31,5816,31.1
13171,Lamar County,2021-08-07,20,5836,31.3
13171,Lamar County,2021-08-08,17,5853,31.3
13171,Lamar County,2021-08-09,24,5877,31.5
13171,Lamar County,2021-08-10,40,5917,31.7
13171,Lamar County,2021-08-11,25,5942,31.8
13171,Lamar County,2021-08-12,30,5972,32
13171,Lamar County,2021-08-13,50,6022,32.3
13171,Lamar County,2021-08-14,21,6043,32.4
13171,Lamar County,2021-08-15,11,6054,32.4
13171,Lamar County,2021-08-16,28,6082,32.6
13171,Lamar County,2021-08-17,30,6112,32.7
13171,Lamar County,2021-08-18,28,6140,32.9
13171,Lamar County,2021-08-19,29,6169,33
13171,Lamar County,2021-08-20,46,6215,33.3
13171,Lamar County,2021-08-21,14,6229,33.4
13171,Lamar County,2021-08-22,14,6243,33.4
13171,Lamar County,2021-08-23,43,6286,33.7
13171,Lamar County,2021-08-24,28,6314,33.8
13171,Lamar County,2021-08-25,30,6344,34
13171,Lamar County,2021-08-26,32,6376,34.1
13171,Lamar County,2021-08-27,48,6424,34.4
13171,Lamar County,2021-08-28,21,6445,34.5
13171,Lamar County,2021-08-29,19,6464,34.6
13171,Lamar County,2021-08-30,44,6508,34.9
13171,Lamar County,2021-08-31,32,6540,35
13171,Lamar County,2021-09-01,37,6577,35.2
13171,Lamar County,2021-09-02,32,6609,35.4
13171,Lamar County,2021-09-03,46,6655,35.6
13171,Lamar County,2021-09-04,22,6677,35.8
13171,Lamar County,2021-09-05,4,6681,35.8
13171,Lamar County,2021-09-06,10,6691,35.8
13171,Lamar County,2021-09-07,34,6725,36
13171,Lamar County,2021-09-08,25,6750,36.2
13171,Lamar County,2021-09-09,24,6774,36.3
13171,Lamar County,2021-09-10,32,6806,36.5
13171,Lamar County,2021-09-11,20,6826,36.6
13171,Lamar County,2021-09-12,12,6838,36.6
13171,Lamar County,2021-09-13,21,6859,36.7
13171,Lamar County,2021-09-14,26,6885,36.9
13171,Lamar County,2021-09-15,18,6903,37
13171,Lamar County,2021-09-16,26,6929,37.1
13171,Lamar County,2021-09-17,18,6947,37.2
13171,Lamar County,2021-09-18,16,6963,37.3
13171,Lamar County,2021-09-19,4,6967,37.3
13171,Lamar County,2021-09-20,30,6997,37.5
13171,Lamar County,2021-09-21,21,7018,37.6
13171,Lamar County,2021-09-22,15,7033,37.7
13171,Lamar County,2021-09-23,20,7053,37.8
13171,Lamar County,2021-09-24,13,7066,37.8
13171,Lamar County,2021-09-25,7,7073,37.9
13171,Lamar County,2021-09-26,7,7080,37.9
13171,Lamar County,2021-09-27,11,7091,38
13171,Lamar County,2021-09-28,8,7099,38
13171,Lamar County,2021-09-29,4,7103,38
13171,Lamar County,2021-09-30,8,7111,38.1
13171,Lamar County,2021-10-01,10,7121,38.1
13171,Lamar County,2021-10-02,4,7125,38.2
13171,Lamar County,2021-10-03,1,7126,38.2
13171,Lamar County,2021-10-04,11,7137,38.2
13171,Lamar County,2021-10-05,5,7142,38.2
13171,Lamar County,2021-10-06,2,7144,38.3
13171,Lamar County,2021-10-07,3,7147,38.3
13173,Lanier County,2020-12-18,1,1,0
13173,Lanier County,2020-12-21,4,5,0
13173,Lanier County,2020-12-22,16,21,0.2
13173,Lanier County,2020-12-23,9,30,0.3
13173,Lanier County,2020-12-24,8,38,0.4
13173,Lanier County,2020-12-26,1,39,0.4
13173,Lanier County,2020-12-28,16,55,0.5
13173,Lanier County,2020-12-29,7,62,0.6
13173,Lanier County,2020-12-30,8,70,0.7
13173,Lanier County,2020-12-31,8,78,0.8
13173,Lanier County,2021-01-01,3,81,0.8
13173,Lanier County,2021-01-03,3,84,0.8
13173,Lanier County,2021-01-04,14,98,0.9
13173,Lanier County,2021-01-05,6,104,1
13173,Lanier County,2021-01-06,13,117,1.1
13173,Lanier County,2021-01-07,3,120,1.2
13173,Lanier County,2021-01-08,10,130,1.3
13173,Lanier County,2021-01-11,17,147,1.4
13173,Lanier County,2021-01-12,54,201,1.9
13173,Lanier County,2021-01-13,34,235,2.3
13173,Lanier County,2021-01-14,20,255,2.5
13173,Lanier County,2021-01-15,71,326,3.1
13173,Lanier County,2021-01-17,2,328,3.2
13173,Lanier County,2021-01-18,18,346,3.3
13173,Lanier County,2021-01-19,21,367,3.5
13173,Lanier County,2021-01-20,27,394,3.8
13173,Lanier County,2021-01-21,21,415,4
13173,Lanier County,2021-01-22,25,440,4.2
13173,Lanier County,2021-01-23,1,441,4.2
13173,Lanier County,2021-01-25,13,454,4.4
13173,Lanier County,2021-01-26,38,492,4.7
13173,Lanier County,2021-01-27,22,514,5
13173,Lanier County,2021-01-28,13,527,5.1
13173,Lanier County,2021-01-29,49,576,5.5
13173,Lanier County,2021-02-01,9,585,5.6
13173,Lanier County,2021-02-02,29,614,5.9
13173,Lanier County,2021-02-03,6,620,6
13173,Lanier County,2021-02-04,18,638,6.1
13173,Lanier County,2021-02-05,5,643,6.2
13173,Lanier County,2021-02-06,5,648,6.2
13173,Lanier County,2021-02-08,1,649,6.3
13173,Lanier County,2021-02-09,1,650,6.3
13173,Lanier County,2021-02-10,38,688,6.6
13173,Lanier County,2021-02-11,34,722,7
13173,Lanier County,2021-02-12,20,742,7.1
13173,Lanier County,2021-02-13,3,745,7.2
13173,Lanier County,2021-02-14,1,746,7.2
13173,Lanier County,2021-02-15,5,751,7.2
13173,Lanier County,2021-02-16,8,759,7.3
13173,Lanier County,2021-02-17,53,812,7.8
13173,Lanier County,2021-02-18,12,824,7.9
13173,Lanier County,2021-02-19,6,830,8
13173,Lanier County,2021-02-20,1,831,8
13173,Lanier County,2021-02-22,8,839,8.1
13173,Lanier County,2021-02-23,14,853,8.2
13173,Lanier County,2021-02-24,4,857,8.3
13173,Lanier County,2021-02-25,3,860,8.3
13173,Lanier County,2021-02-26,36,896,8.6
13173,Lanier County,2021-02-27,2,898,8.7
13173,Lanier County,2021-03-01,17,915,8.8
13173,Lanier County,2021-03-02,37,952,9.2
13173,Lanier County,2021-03-03,28,980,9.4
13173,Lanier County,2021-03-04,9,989,9.5
13173,Lanier County,2021-03-05,17,1006,9.7
13173,Lanier County,2021-03-06,3,1009,9.7
13173,Lanier County,2021-03-08,14,1023,9.9
13173,Lanier County,2021-03-09,39,1062,10.2
13173,Lanier County,2021-03-10,24,1086,10.5
13173,Lanier County,2021-03-11,16,1102,10.6
13173,Lanier County,2021-03-12,40,1142,11
13173,Lanier County,2021-03-13,4,1146,11
13173,Lanier County,2021-03-14,2,1148,11.1
13173,Lanier County,2021-03-15,60,1208,11.6
13173,Lanier County,2021-03-16,26,1234,11.9
13173,Lanier County,2021-03-17,26,1260,12.1
13173,Lanier County,2021-03-18,28,1288,12.4
13173,Lanier County,2021-03-19,65,1353,13
13173,Lanier County,2021-03-20,15,1368,13.2
13173,Lanier County,2021-03-22,11,1379,13.3
13173,Lanier County,2021-03-23,19,1398,13.5
13173,Lanier County,2021-03-24,61,1459,14.1
13173,Lanier County,2021-03-25,15,1474,14.2
13173,Lanier County,2021-03-26,49,1523,14.7
13173,Lanier County,2021-03-27,4,1527,14.7
13173,Lanier County,2021-03-28,18,1545,14.9
13173,Lanier County,2021-03-29,10,1555,15
13173,Lanier County,2021-03-30,35,1590,15.3
13173,Lanier County,2021-03-31,42,1632,15.7
13173,Lanier County,2021-04-01,7,1639,15.8
13173,Lanier County,2021-04-02,25,1664,16
13173,Lanier County,2021-04-03,5,1669,16.1
13173,Lanier County,2021-04-04,2,1671,16.1
13173,Lanier County,2021-04-05,15,1686,16.2
13173,Lanier County,2021-04-06,13,1699,16.4
13173,Lanier County,2021-04-07,45,1744,16.8
13173,Lanier County,2021-04-08,7,1751,16.9
13173,Lanier County,2021-04-09,33,1784,17.2
13173,Lanier County,2021-04-10,5,1789,17.2
13173,Lanier County,2021-04-11,5,1794,17.3
13173,Lanier County,2021-04-12,17,1811,17.4
13173,Lanier County,2021-04-13,2,1813,17.5
13173,Lanier County,2021-04-14,13,1826,17.6
13173,Lanier County,2021-04-15,21,1847,17.8
13173,Lanier County,2021-04-16,4,1851,17.8
13173,Lanier County,2021-04-17,1,1852,17.8
13173,Lanier County,2021-04-18,3,1855,17.9
13173,Lanier County,2021-04-19,2,1857,17.9
13173,Lanier County,2021-04-20,8,1865,18
13173,Lanier County,2021-04-21,33,1898,18.3
13173,Lanier County,2021-04-22,7,1905,18.4
13173,Lanier County,2021-04-23,9,1914,18.4
13173,Lanier County,2021-04-24,1,1915,18.4
13173,Lanier County,2021-04-25,5,1920,18.5
13173,Lanier County,2021-04-26,6,1926,18.6
13173,Lanier County,2021-04-27,8,1934,18.6
13173,Lanier County,2021-04-28,7,1941,18.7
13173,Lanier County,2021-04-29,2,1943,18.7
13173,Lanier County,2021-04-30,27,1970,19
13173,Lanier County,2021-05-01,1,1971,19
13173,Lanier County,2021-05-02,2,1973,19
13173,Lanier County,2021-05-03,8,1981,19.1
13173,Lanier County,2021-05-04,8,1989,19.2
13173,Lanier County,2021-05-05,6,1995,19.2
13173,Lanier County,2021-05-06,8,2003,19.3
13173,Lanier County,2021-05-07,8,2011,19.4
13173,Lanier County,2021-05-08,3,2014,19.4
13173,Lanier County,2021-05-10,1,2015,19.4
13173,Lanier County,2021-05-11,10,2025,19.5
13173,Lanier County,2021-05-12,7,2032,19.6
13173,Lanier County,2021-05-14,7,2039,19.6
13173,Lanier County,2021-05-15,3,2042,19.7
13173,Lanier County,2021-05-16,1,2043,19.7
13173,Lanier County,2021-05-17,8,2051,19.8
13173,Lanier County,2021-05-18,11,2062,19.9
13173,Lanier County,2021-05-19,20,2082,20.1
13173,Lanier County,2021-05-20,4,2086,20.1
13173,Lanier County,2021-05-21,15,2101,20.2
13173,Lanier County,2021-05-22,1,2102,20.3
13173,Lanier County,2021-05-23,2,2104,20.3
13173,Lanier County,2021-05-24,5,2109,20.3
13173,Lanier County,2021-05-25,9,2118,20.4
13173,Lanier County,2021-05-26,20,2138,20.6
13173,Lanier County,2021-05-27,3,2141,20.6
13173,Lanier County,2021-05-28,5,2146,20.7
13173,Lanier County,2021-06-01,3,2149,20.7
13173,Lanier County,2021-06-02,8,2157,20.8
13173,Lanier County,2021-06-03,2,2159,20.8
13173,Lanier County,2021-06-04,6,2165,20.9
13173,Lanier County,2021-06-05,4,2169,20.9
13173,Lanier County,2021-06-07,1,2170,20.9
13173,Lanier County,2021-06-08,3,2173,20.9
13173,Lanier County,2021-06-09,9,2182,21
13173,Lanier County,2021-06-10,3,2185,21.1
13173,Lanier County,2021-06-11,8,2193,21.1
13173,Lanier County,2021-06-12,3,2196,21.2
13173,Lanier County,2021-06-14,6,2202,21.2
13173,Lanier County,2021-06-15,1,2203,21.2
13173,Lanier County,2021-06-16,1,2204,21.2
13173,Lanier County,2021-06-18,19,2223,21.4
13173,Lanier County,2021-06-20,1,2224,21.4
13173,Lanier County,2021-06-22,1,2225,21.4
13173,Lanier County,2021-06-23,4,2229,21.5
13173,Lanier County,2021-06-25,8,2237,21.6
13173,Lanier County,2021-06-26,4,2241,21.6
13173,Lanier County,2021-06-27,1,2242,21.6
13173,Lanier County,2021-06-28,3,2245,21.6
13173,Lanier County,2021-06-29,1,2246,21.6
13173,Lanier County,2021-06-30,3,2249,21.7
13173,Lanier County,2021-07-01,2,2251,21.7
13173,Lanier County,2021-07-02,6,2257,21.7
13173,Lanier County,2021-07-03,7,2264,21.8
13173,Lanier County,2021-07-05,2,2266,21.8
13173,Lanier County,2021-07-06,5,2271,21.9
13173,Lanier County,2021-07-07,4,2275,21.9
13173,Lanier County,2021-07-08,1,2276,21.9
13173,Lanier County,2021-07-09,6,2282,22
13173,Lanier County,2021-07-10,1,2283,22
13173,Lanier County,2021-07-11,1,2284,22
13173,Lanier County,2021-07-12,1,2285,22
13173,Lanier County,2021-07-13,5,2290,22.1
13173,Lanier County,2021-07-14,6,2296,22.1
13173,Lanier County,2021-07-15,7,2303,22.2
13173,Lanier County,2021-07-16,8,2311,22.3
13173,Lanier County,2021-07-17,6,2317,22.3
13173,Lanier County,2021-07-18,1,2318,22.3
13173,Lanier County,2021-07-19,2,2320,22.4
13173,Lanier County,2021-07-20,5,2325,22.4
13173,Lanier County,2021-07-21,17,2342,22.6
13173,Lanier County,2021-07-22,14,2356,22.7
13173,Lanier County,2021-07-23,9,2365,22.8
13173,Lanier County,2021-07-24,3,2368,22.8
13173,Lanier County,2021-07-25,3,2371,22.8
13173,Lanier County,2021-07-26,5,2376,22.9
13173,Lanier County,2021-07-27,14,2390,23
13173,Lanier County,2021-07-28,23,2413,23.2
13173,Lanier County,2021-07-29,18,2431,23.4
13173,Lanier County,2021-07-30,24,2455,23.7
13173,Lanier County,2021-07-31,7,2462,23.7
13173,Lanier County,2021-08-01,4,2466,23.8
13173,Lanier County,2021-08-02,22,2488,24
13173,Lanier County,2021-08-03,16,2504,24.1
13173,Lanier County,2021-08-04,18,2522,24.3
13173,Lanier County,2021-08-05,11,2533,24.4
13173,Lanier County,2021-08-06,19,2552,24.6
13173,Lanier County,2021-08-07,19,2571,24.8
13173,Lanier County,2021-08-08,6,2577,24.8
13173,Lanier County,2021-08-09,22,2599,25
13173,Lanier County,2021-08-10,21,2620,25.2
13173,Lanier County,2021-08-11,23,2643,25.5
13173,Lanier County,2021-08-12,19,2662,25.6
13173,Lanier County,2021-08-13,34,2696,26
13173,Lanier County,2021-08-14,10,2706,26.1
13173,Lanier County,2021-08-15,1,2707,26.1
13173,Lanier County,2021-08-16,20,2727,26.3
13173,Lanier County,2021-08-17,18,2745,26.4
13173,Lanier County,2021-08-18,23,2768,26.7
13173,Lanier County,2021-08-19,18,2786,26.8
13173,Lanier County,2021-08-20,27,2813,27.1
13173,Lanier County,2021-08-21,2,2815,27.1
13173,Lanier County,2021-08-22,3,2818,27.1
13173,Lanier County,2021-08-23,15,2833,27.3
13173,Lanier County,2021-08-24,10,2843,27.4
13173,Lanier County,2021-08-25,19,2862,27.6
13173,Lanier County,2021-08-26,31,2893,27.9
13173,Lanier County,2021-08-27,23,2916,28.1
13173,Lanier County,2021-08-28,13,2929,28.2
13173,Lanier County,2021-08-30,10,2939,28.3
13173,Lanier County,2021-08-31,8,2947,28.4
13173,Lanier County,2021-09-01,10,2957,28.5
13173,Lanier County,2021-09-02,18,2975,28.7
13173,Lanier County,2021-09-03,7,2982,28.7
13173,Lanier County,2021-09-04,1,2983,28.7
13173,Lanier County,2021-09-06,2,2985,28.8
13173,Lanier County,2021-09-07,6,2991,28.8
13173,Lanier County,2021-09-08,12,3003,28.9
13173,Lanier County,2021-09-09,5,3008,29
13173,Lanier County,2021-09-10,18,3026,29.2
13173,Lanier County,2021-09-11,1,3027,29.2
13173,Lanier County,2021-09-12,5,3032,29.2
13173,Lanier County,2021-09-13,7,3039,29.3
13173,Lanier County,2021-09-14,4,3043,29.3
13173,Lanier County,2021-09-15,8,3051,29.4
13173,Lanier County,2021-09-16,3,3054,29.4
13173,Lanier County,2021-09-17,14,3068,29.6
13173,Lanier County,2021-09-18,4,3072,29.6
13173,Lanier County,2021-09-19,1,3073,29.6
13173,Lanier County,2021-09-20,4,3077,29.6
13173,Lanier County,2021-09-21,3,3080,29.7
13173,Lanier County,2021-09-22,4,3084,29.7
13173,Lanier County,2021-09-23,3,3087,29.7
13173,Lanier County,2021-09-24,1,3088,29.7
13173,Lanier County,2021-09-27,2,3090,29.8
13173,Lanier County,2021-09-28,3,3093,29.8
13173,Lanier County,2021-09-30,2,3095,29.8
13173,Lanier County,2021-10-04,2,3097,29.8
13173,Lanier County,2021-10-05,1,3098,29.8
13173,Lanier County,2021-10-06,1,3099,29.9
13173,Lanier County,2021-10-07,1,3100,29.9
13175,Laurens County,2020-12-15,1,1,0
13175,Laurens County,2020-12-17,11,12,0
13175,Laurens County,2020-12-18,69,81,0.2
13175,Laurens County,2020-12-19,12,93,0.2
13175,Laurens County,2020-12-20,17,110,0.2
13175,Laurens County,2020-12-21,26,136,0.3
13175,Laurens County,2020-12-22,56,192,0.4
13175,Laurens County,2020-12-23,55,247,0.5
13175,Laurens County,2020-12-24,18,265,0.6
13175,Laurens County,2020-12-25,1,266,0.6
13175,Laurens County,2020-12-26,8,274,0.6
13175,Laurens County,2020-12-27,6,280,0.6
13175,Laurens County,2020-12-28,137,417,0.9
13175,Laurens County,2020-12-29,81,498,1.1
13175,Laurens County,2020-12-30,91,589,1.2
13175,Laurens County,2020-12-31,67,656,1.4
13175,Laurens County,2021-01-01,8,664,1.4
13175,Laurens County,2021-01-02,18,682,1.4
13175,Laurens County,2021-01-03,3,685,1.4
13175,Laurens County,2021-01-04,57,742,1.6
13175,Laurens County,2021-01-05,164,906,1.9
13175,Laurens County,2021-01-06,107,1013,2.1
13175,Laurens County,2021-01-07,147,1160,2.4
13175,Laurens County,2021-01-08,624,1784,3.8
13175,Laurens County,2021-01-09,8,1792,3.8
13175,Laurens County,2021-01-10,2,1794,3.8
13175,Laurens County,2021-01-11,126,1920,4.1
13175,Laurens County,2021-01-12,121,2041,4.3
13175,Laurens County,2021-01-13,829,2870,6.1
13175,Laurens County,2021-01-14,792,3662,7.7
13175,Laurens County,2021-01-15,170,3832,8.1
13175,Laurens County,2021-01-16,12,3844,8.1
13175,Laurens County,2021-01-17,12,3856,8.1
13175,Laurens County,2021-01-18,206,4062,8.6
13175,Laurens County,2021-01-19,162,4224,8.9
13175,Laurens County,2021-01-20,694,4918,10.4
13175,Laurens County,2021-01-21,446,5364,11.3
13175,Laurens County,2021-01-22,153,5517,11.6
13175,Laurens County,2021-01-23,16,5533,11.7
13175,Laurens County,2021-01-24,4,5537,11.7
13175,Laurens County,2021-01-25,80,5617,11.8
13175,Laurens County,2021-01-26,109,5726,12.1
13175,Laurens County,2021-01-27,65,5791,12.2
13175,Laurens County,2021-01-28,343,6134,12.9
13175,Laurens County,2021-01-29,52,6186,13
13175,Laurens County,2021-01-30,3,6189,13.1
13175,Laurens County,2021-01-31,1,6190,13.1
13175,Laurens County,2021-02-01,23,6213,13.1
13175,Laurens County,2021-02-02,82,6295,13.3
13175,Laurens County,2021-02-03,220,6515,13.7
13175,Laurens County,2021-02-04,66,6581,13.9
13175,Laurens County,2021-02-05,36,6617,14
13175,Laurens County,2021-02-06,2,6619,14
13175,Laurens County,2021-02-07,4,6623,14
13175,Laurens County,2021-02-08,38,6661,14.1
13175,Laurens County,2021-02-09,35,6696,14.1
13175,Laurens County,2021-02-10,93,6789,14.3
13175,Laurens County,2021-02-11,76,6865,14.5
13175,Laurens County,2021-02-12,71,6936,14.6
13175,Laurens County,2021-02-13,6,6942,14.6
13175,Laurens County,2021-02-14,8,6950,14.7
13175,Laurens County,2021-02-15,66,7016,14.8
13175,Laurens County,2021-02-16,93,7109,15
13175,Laurens County,2021-02-17,313,7422,15.7
13175,Laurens County,2021-02-18,90,7512,15.8
13175,Laurens County,2021-02-19,13,7525,15.9
13175,Laurens County,2021-02-20,4,7529,15.9
13175,Laurens County,2021-02-21,2,7531,15.9
13175,Laurens County,2021-02-22,36,7567,16
13175,Laurens County,2021-02-23,41,7608,16
13175,Laurens County,2021-02-24,88,7696,16.2
13175,Laurens County,2021-02-25,117,7813,16.5
13175,Laurens County,2021-02-26,36,7849,16.6
13175,Laurens County,2021-02-27,2,7851,16.6
13175,Laurens County,2021-02-28,4,7855,16.6
13175,Laurens County,2021-03-01,55,7910,16.7
13175,Laurens County,2021-03-02,24,7934,16.7
13175,Laurens County,2021-03-03,89,8023,16.9
13175,Laurens County,2021-03-04,146,8169,17.2
13175,Laurens County,2021-03-05,61,8230,17.4
13175,Laurens County,2021-03-06,7,8237,17.4
13175,Laurens County,2021-03-07,10,8247,17.4
13175,Laurens County,2021-03-08,72,8319,17.5
13175,Laurens County,2021-03-09,58,8377,17.7
13175,Laurens County,2021-03-10,485,8862,18.7
13175,Laurens County,2021-03-11,161,9023,19
13175,Laurens County,2021-03-12,128,9151,19.3
13175,Laurens County,2021-03-13,24,9175,19.4
13175,Laurens County,2021-03-14,7,9182,19.4
13175,Laurens County,2021-03-15,128,9310,19.6
13175,Laurens County,2021-03-16,134,9444,19.9
13175,Laurens County,2021-03-17,208,9652,20.4
13175,Laurens County,2021-03-18,118,9770,20.6
13175,Laurens County,2021-03-19,117,9887,20.9
13175,Laurens County,2021-03-20,8,9895,20.9
13175,Laurens County,2021-03-21,16,9911,20.9
13175,Laurens County,2021-03-22,83,9994,21.1
13175,Laurens County,2021-03-23,72,10066,21.2
13175,Laurens County,2021-03-24,366,10432,22
13175,Laurens County,2021-03-25,303,10735,22.6
13175,Laurens County,2021-03-26,142,10877,22.9
13175,Laurens County,2021-03-27,35,10912,23
13175,Laurens County,2021-03-28,12,10924,23
13175,Laurens County,2021-03-29,137,11061,23.3
13175,Laurens County,2021-03-30,117,11178,23.6
13175,Laurens County,2021-03-31,286,11464,24.2
13175,Laurens County,2021-04-01,153,11617,24.5
13175,Laurens County,2021-04-02,142,11759,24.8
13175,Laurens County,2021-04-03,24,11783,24.9
13175,Laurens County,2021-04-04,14,11797,24.9
13175,Laurens County,2021-04-05,97,11894,25.1
13175,Laurens County,2021-04-06,174,12068,25.5
13175,Laurens County,2021-04-07,207,12275,25.9
13175,Laurens County,2021-04-08,105,12380,26.1
13175,Laurens County,2021-04-09,149,12529,26.4
13175,Laurens County,2021-04-10,44,12573,26.5
13175,Laurens County,2021-04-11,19,12592,26.6
13175,Laurens County,2021-04-12,58,12650,26.7
13175,Laurens County,2021-04-13,150,12800,27
13175,Laurens County,2021-04-14,102,12902,27.2
13175,Laurens County,2021-04-15,56,12958,27.3
13175,Laurens County,2021-04-16,62,13020,27.5
13175,Laurens County,2021-04-17,12,13032,27.5
13175,Laurens County,2021-04-18,3,13035,27.5
13175,Laurens County,2021-04-19,45,13080,27.6
13175,Laurens County,2021-04-20,93,13173,27.8
13175,Laurens County,2021-04-21,102,13275,28
13175,Laurens County,2021-04-22,51,13326,28.1
13175,Laurens County,2021-04-23,63,13389,28.2
13175,Laurens County,2021-04-24,20,13409,28.3
13175,Laurens County,2021-04-25,6,13415,28.3
13175,Laurens County,2021-04-26,41,13456,28.4
13175,Laurens County,2021-04-27,73,13529,28.5
13175,Laurens County,2021-04-28,67,13596,28.7
13175,Laurens County,2021-04-29,48,13644,28.8
13175,Laurens County,2021-04-30,63,13707,28.9
13175,Laurens County,2021-05-01,14,13721,28.9
13175,Laurens County,2021-05-02,5,13726,29
13175,Laurens County,2021-05-03,32,13758,29
13175,Laurens County,2021-05-04,89,13847,29.2
13175,Laurens County,2021-05-05,61,13908,29.3
13175,Laurens County,2021-05-06,43,13951,29.4
13175,Laurens County,2021-05-07,51,14002,29.5
13175,Laurens County,2021-05-08,22,14024,29.6
13175,Laurens County,2021-05-09,1,14025,29.6
13175,Laurens County,2021-05-10,38,14063,29.7
13175,Laurens County,2021-05-11,53,14116,29.8
13175,Laurens County,2021-05-12,66,14182,29.9
13175,Laurens County,2021-05-13,44,14226,30
13175,Laurens County,2021-05-14,57,14283,30.1
13175,Laurens County,2021-05-15,20,14303,30.2
13175,Laurens County,2021-05-16,22,14325,30.2
13175,Laurens County,2021-05-17,74,14399,30.4
13175,Laurens County,2021-05-18,71,14470,30.5
13175,Laurens County,2021-05-19,75,14545,30.7
13175,Laurens County,2021-05-20,55,14600,30.8
13175,Laurens County,2021-05-21,58,14658,30.9
13175,Laurens County,2021-05-22,25,14683,31
13175,Laurens County,2021-05-23,14,14697,31
13175,Laurens County,2021-05-24,33,14730,31.1
13175,Laurens County,2021-05-25,86,14816,31.3
13175,Laurens County,2021-05-26,58,14874,31.4
13175,Laurens County,2021-05-27,37,14911,31.5
13175,Laurens County,2021-05-28,44,14955,31.5
13175,Laurens County,2021-05-29,15,14970,31.6
13175,Laurens County,2021-05-30,6,14976,31.6
13175,Laurens County,2021-05-31,6,14982,31.6
13175,Laurens County,2021-06-01,36,15018,31.7
13175,Laurens County,2021-06-02,41,15059,31.8
13175,Laurens County,2021-06-03,42,15101,31.9
13175,Laurens County,2021-06-04,44,15145,31.9
13175,Laurens County,2021-06-05,15,15160,32
13175,Laurens County,2021-06-06,10,15170,32
13175,Laurens County,2021-06-07,35,15205,32.1
13175,Laurens County,2021-06-08,37,15242,32.2
13175,Laurens County,2021-06-09,27,15269,32.2
13175,Laurens County,2021-06-10,35,15304,32.3
13175,Laurens County,2021-06-11,31,15335,32.3
13175,Laurens County,2021-06-12,13,15348,32.4
13175,Laurens County,2021-06-13,4,15352,32.4
13175,Laurens County,2021-06-14,23,15375,32.4
13175,Laurens County,2021-06-15,33,15408,32.5
13175,Laurens County,2021-06-16,29,15437,32.6
13175,Laurens County,2021-06-17,41,15478,32.7
13175,Laurens County,2021-06-18,15,15493,32.7
13175,Laurens County,2021-06-19,7,15500,32.7
13175,Laurens County,2021-06-20,3,15503,32.7
13175,Laurens County,2021-06-21,23,15526,32.8
13175,Laurens County,2021-06-22,25,15551,32.8
13175,Laurens County,2021-06-23,33,15584,32.9
13175,Laurens County,2021-06-24,23,15607,32.9
13175,Laurens County,2021-06-25,34,15641,33
13175,Laurens County,2021-06-26,5,15646,33
13175,Laurens County,2021-06-27,5,15651,33
13175,Laurens County,2021-06-28,28,15679,33.1
13175,Laurens County,2021-06-29,26,15705,33.1
13175,Laurens County,2021-06-30,45,15750,33.2
13175,Laurens County,2021-07-01,30,15780,33.3
13175,Laurens County,2021-07-02,15,15795,33.3
13175,Laurens County,2021-07-03,9,15804,33.3
13175,Laurens County,2021-07-05,28,15832,33.4
13175,Laurens County,2021-07-06,21,15853,33.4
13175,Laurens County,2021-07-07,40,15893,33.5
13175,Laurens County,2021-07-08,23,15916,33.6
13175,Laurens County,2021-07-09,46,15962,33.7
13175,Laurens County,2021-07-10,17,15979,33.7
13175,Laurens County,2021-07-11,9,15988,33.7
13175,Laurens County,2021-07-12,35,16023,33.8
13175,Laurens County,2021-07-13,27,16050,33.9
13175,Laurens County,2021-07-14,44,16094,34
13175,Laurens County,2021-07-15,54,16148,34.1
13175,Laurens County,2021-07-16,51,16199,34.2
13175,Laurens County,2021-07-17,17,16216,34.2
13175,Laurens County,2021-07-18,13,16229,34.2
13175,Laurens County,2021-07-19,55,16284,34.4
13175,Laurens County,2021-07-20,36,16320,34.4
13175,Laurens County,2021-07-21,69,16389,34.6
13175,Laurens County,2021-07-22,68,16457,34.7
13175,Laurens County,2021-07-23,106,16563,34.9
13175,Laurens County,2021-07-24,30,16593,35
13175,Laurens County,2021-07-25,16,16609,35
13175,Laurens County,2021-07-26,99,16708,35.2
13175,Laurens County,2021-07-27,83,16791,35.4
13175,Laurens County,2021-07-28,175,16966,35.8
13175,Laurens County,2021-07-29,69,17035,35.9
13175,Laurens County,2021-07-30,134,17169,36.2
13175,Laurens County,2021-07-31,45,17214,36.3
13175,Laurens County,2021-08-01,20,17234,36.4
13175,Laurens County,2021-08-02,112,17346,36.6
13175,Laurens County,2021-08-03,92,17438,36.8
13175,Laurens County,2021-08-04,92,17530,37
13175,Laurens County,2021-08-05,98,17628,37.2
13175,Laurens County,2021-08-06,123,17751,37.4
13175,Laurens County,2021-08-07,43,17794,37.5
13175,Laurens County,2021-08-08,35,17829,37.6
13175,Laurens County,2021-08-09,126,17955,37.9
13175,Laurens County,2021-08-10,97,18052,38.1
13175,Laurens County,2021-08-11,159,18211,38.4
13175,Laurens County,2021-08-12,92,18303,38.6
13175,Laurens County,2021-08-13,157,18460,38.9
13175,Laurens County,2021-08-14,49,18509,39
13175,Laurens County,2021-08-15,39,18548,39.1
13175,Laurens County,2021-08-16,102,18650,39.3
13175,Laurens County,2021-08-17,148,18798,39.7
13175,Laurens County,2021-08-18,169,18967,40
13175,Laurens County,2021-08-19,132,19099,40.3
13175,Laurens County,2021-08-20,148,19247,40.6
13175,Laurens County,2021-08-21,39,19286,40.7
13175,Laurens County,2021-08-22,48,19334,40.8
13175,Laurens County,2021-08-23,127,19461,41.1
13175,Laurens County,2021-08-24,134,19595,41.3
13175,Laurens County,2021-08-25,197,19792,41.8
13175,Laurens County,2021-08-26,140,19932,42
13175,Laurens County,2021-08-27,145,20077,42.4
13175,Laurens County,2021-08-28,32,20109,42.4
13175,Laurens County,2021-08-29,33,20142,42.5
13175,Laurens County,2021-08-30,134,20276,42.8
13175,Laurens County,2021-08-31,161,20437,43.1
13175,Laurens County,2021-09-01,154,20591,43.4
13175,Laurens County,2021-09-02,107,20698,43.7
13175,Laurens County,2021-09-03,176,20874,44
13175,Laurens County,2021-09-04,61,20935,44.2
13175,Laurens County,2021-09-05,24,20959,44.2
13175,Laurens County,2021-09-06,21,20980,44.3
13175,Laurens County,2021-09-07,70,21050,44.4
13175,Laurens County,2021-09-08,98,21148,44.6
13175,Laurens County,2021-09-09,92,21240,44.8
13175,Laurens County,2021-09-10,96,21336,45
13175,Laurens County,2021-09-11,47,21383,45.1
13175,Laurens County,2021-09-12,19,21402,45.1
13175,Laurens County,2021-09-13,57,21459,45.3
13175,Laurens County,2021-09-14,57,21516,45.4
13175,Laurens County,2021-09-15,72,21588,45.5
13175,Laurens County,2021-09-16,48,21636,45.6
13175,Laurens County,2021-09-17,64,21700,45.8
13175,Laurens County,2021-09-18,19,21719,45.8
13175,Laurens County,2021-09-19,16,21735,45.8
13175,Laurens County,2021-09-20,19,21754,45.9
13175,Laurens County,2021-09-21,26,21780,45.9
13175,Laurens County,2021-09-22,50,21830,46
13175,Laurens County,2021-09-23,38,21868,46.1
13175,Laurens County,2021-09-24,36,21904,46.2
13175,Laurens County,2021-09-25,14,21918,46.2
13175,Laurens County,2021-09-26,5,21923,46.2
13175,Laurens County,2021-09-27,20,21943,46.3
13175,Laurens County,2021-09-28,38,21981,46.4
13175,Laurens County,2021-09-29,34,22015,46.4
13175,Laurens County,2021-09-30,33,22048,46.5
13175,Laurens County,2021-10-01,31,22079,46.6
13175,Laurens County,2021-10-02,12,22091,46.6
13175,Laurens County,2021-10-03,4,22095,46.6
13175,Laurens County,2021-10-04,19,22114,46.6
13175,Laurens County,2021-10-05,15,22129,46.7
13175,Laurens County,2021-10-06,29,22158,46.7
13175,Laurens County,2021-10-07,6,22164,46.8
13177,Lee County,2020-12-16,2,2,0
13177,Lee County,2020-12-17,41,43,0.1
13177,Lee County,2020-12-18,97,140,0.5
13177,Lee County,2020-12-19,40,180,0.6
13177,Lee County,2020-12-20,11,191,0.6
13177,Lee County,2020-12-21,53,244,0.8
13177,Lee County,2020-12-22,71,315,1.1
13177,Lee County,2020-12-23,79,394,1.3
13177,Lee County,2020-12-24,21,415,1.4
13177,Lee County,2020-12-26,17,432,1.5
13177,Lee County,2020-12-27,1,433,1.5
13177,Lee County,2020-12-28,43,476,1.6
13177,Lee County,2020-12-29,58,534,1.8
13177,Lee County,2020-12-30,66,600,2
13177,Lee County,2020-12-31,40,640,2.2
13177,Lee County,2021-01-01,11,651,2.2
13177,Lee County,2021-01-02,1,652,2.2
13177,Lee County,2021-01-03,2,654,2.2
13177,Lee County,2021-01-04,42,696,2.4
13177,Lee County,2021-01-05,50,746,2.5
13177,Lee County,2021-01-06,50,796,2.7
13177,Lee County,2021-01-07,87,883,3
13177,Lee County,2021-01-08,81,964,3.3
13177,Lee County,2021-01-09,3,967,3.3
13177,Lee County,2021-01-10,13,980,3.3
13177,Lee County,2021-01-11,151,1131,3.8
13177,Lee County,2021-01-12,178,1309,4.4
13177,Lee County,2021-01-13,199,1508,5.1
13177,Lee County,2021-01-14,231,1739,5.9
13177,Lee County,2021-01-15,260,1999,6.8
13177,Lee County,2021-01-16,119,2118,7.2
13177,Lee County,2021-01-17,33,2151,7.3
13177,Lee County,2021-01-18,280,2431,8.2
13177,Lee County,2021-01-19,225,2656,9
13177,Lee County,2021-01-20,211,2867,9.7
13177,Lee County,2021-01-21,195,3062,10.4
13177,Lee County,2021-01-22,185,3247,11
13177,Lee County,2021-01-23,37,3284,11.1
13177,Lee County,2021-01-24,2,3286,11.1
13177,Lee County,2021-01-25,157,3443,11.7
13177,Lee County,2021-01-26,177,3620,12.3
13177,Lee County,2021-01-27,176,3796,12.9
13177,Lee County,2021-01-28,155,3951,13.4
13177,Lee County,2021-01-29,177,4128,14
13177,Lee County,2021-01-30,9,4137,14
13177,Lee County,2021-01-31,3,4140,14
13177,Lee County,2021-02-01,99,4239,14.4
13177,Lee County,2021-02-02,106,4345,14.7
13177,Lee County,2021-02-03,116,4461,15.1
13177,Lee County,2021-02-04,88,4549,15.4
13177,Lee County,2021-02-05,66,4615,15.6
13177,Lee County,2021-02-06,17,4632,15.7
13177,Lee County,2021-02-07,3,4635,15.7
13177,Lee County,2021-02-08,28,4663,15.8
13177,Lee County,2021-02-09,50,4713,16
13177,Lee County,2021-02-10,49,4762,16.1
13177,Lee County,2021-02-11,69,4831,16.4
13177,Lee County,2021-02-12,78,4909,16.6
13177,Lee County,2021-02-13,35,4944,16.8
13177,Lee County,2021-02-14,9,4953,16.8
13177,Lee County,2021-02-15,54,5007,17
13177,Lee County,2021-02-16,75,5082,17.2
13177,Lee County,2021-02-17,54,5136,17.4
13177,Lee County,2021-02-18,43,5179,17.6
13177,Lee County,2021-02-19,36,5215,17.7
13177,Lee County,2021-02-20,22,5237,17.8
13177,Lee County,2021-02-21,2,5239,17.8
13177,Lee County,2021-02-22,29,5268,17.9
13177,Lee County,2021-02-23,75,5343,18.1
13177,Lee County,2021-02-24,60,5403,18.3
13177,Lee County,2021-02-25,68,5471,18.5
13177,Lee County,2021-02-26,41,5512,18.7
13177,Lee County,2021-02-27,29,5541,18.8
13177,Lee County,2021-02-28,8,5549,18.8
13177,Lee County,2021-03-01,144,5693,19.3
13177,Lee County,2021-03-02,88,5781,19.6
13177,Lee County,2021-03-03,66,5847,19.8
13177,Lee County,2021-03-04,94,5941,20.1
13177,Lee County,2021-03-05,68,6009,20.4
13177,Lee County,2021-03-06,8,6017,20.4
13177,Lee County,2021-03-07,6,6023,20.4
13177,Lee County,2021-03-08,107,6130,20.8
13177,Lee County,2021-03-09,145,6275,21.3
13177,Lee County,2021-03-10,111,6386,21.6
13177,Lee County,2021-03-11,118,6504,22
13177,Lee County,2021-03-12,147,6651,22.5
13177,Lee County,2021-03-13,22,6673,22.6
13177,Lee County,2021-03-14,18,6691,22.7
13177,Lee County,2021-03-15,229,6920,23.5
13177,Lee County,2021-03-16,216,7136,24.2
13177,Lee County,2021-03-17,159,7295,24.7
13177,Lee County,2021-03-18,119,7414,25.1
13177,Lee County,2021-03-19,195,7609,25.8
13177,Lee County,2021-03-20,58,7667,26
13177,Lee County,2021-03-21,30,7697,26.1
13177,Lee County,2021-03-22,100,7797,26.4
13177,Lee County,2021-03-23,136,7933,26.9
13177,Lee County,2021-03-24,125,8058,27.3
13177,Lee County,2021-03-25,174,8232,27.9
13177,Lee County,2021-03-26,126,8358,28.3
13177,Lee County,2021-03-27,27,8385,28.4
13177,Lee County,2021-03-28,28,8413,28.5
13177,Lee County,2021-03-29,87,8500,28.8
13177,Lee County,2021-03-30,187,8687,29.4
13177,Lee County,2021-03-31,173,8860,30
13177,Lee County,2021-04-01,172,9032,30.6
13177,Lee County,2021-04-02,82,9114,30.9
13177,Lee County,2021-04-03,21,9135,31
13177,Lee County,2021-04-04,21,9156,31
13177,Lee County,2021-04-05,93,9249,31.4
13177,Lee County,2021-04-06,149,9398,31.9
13177,Lee County,2021-04-07,111,9509,32.2
13177,Lee County,2021-04-08,119,9628,32.6
13177,Lee County,2021-04-09,89,9717,32.9
13177,Lee County,2021-04-10,40,9757,33.1
13177,Lee County,2021-04-11,9,9766,33.1
13177,Lee County,2021-04-12,53,9819,33.3
13177,Lee County,2021-04-13,127,9946,33.7
13177,Lee County,2021-04-14,48,9994,33.9
13177,Lee County,2021-04-15,66,10060,34.1
13177,Lee County,2021-04-16,46,10106,34.3
13177,Lee County,2021-04-17,9,10115,34.3
13177,Lee County,2021-04-18,9,10124,34.3
13177,Lee County,2021-04-19,38,10162,34.4
13177,Lee County,2021-04-20,75,10237,34.7
13177,Lee County,2021-04-21,34,10271,34.8
13177,Lee County,2021-04-22,52,10323,35
13177,Lee County,2021-04-23,46,10369,35.1
13177,Lee County,2021-04-24,10,10379,35.2
13177,Lee County,2021-04-25,4,10383,35.2
13177,Lee County,2021-04-26,36,10419,35.3
13177,Lee County,2021-04-27,58,10477,35.5
13177,Lee County,2021-04-28,36,10513,35.6
13177,Lee County,2021-04-29,73,10586,35.9
13177,Lee County,2021-04-30,70,10656,36.1
13177,Lee County,2021-05-01,18,10674,36.2
13177,Lee County,2021-05-02,14,10688,36.2
13177,Lee County,2021-05-03,21,10709,36.3
13177,Lee County,2021-05-04,49,10758,36.5
13177,Lee County,2021-05-05,28,10786,36.6
13177,Lee County,2021-05-06,28,10814,36.7
13177,Lee County,2021-05-07,33,10847,36.8
13177,Lee County,2021-05-08,19,10866,36.8
13177,Lee County,2021-05-09,9,10875,36.9
13177,Lee County,2021-05-10,28,10903,37
13177,Lee County,2021-05-11,51,10954,37.1
13177,Lee County,2021-05-12,33,10987,37.2
13177,Lee County,2021-05-13,40,11027,37.4
13177,Lee County,2021-05-14,43,11070,37.5
13177,Lee County,2021-05-15,26,11096,37.6
13177,Lee County,2021-05-16,20,11116,37.7
13177,Lee County,2021-05-17,54,11170,37.9
13177,Lee County,2021-05-18,60,11230,38.1
13177,Lee County,2021-05-19,43,11273,38.2
13177,Lee County,2021-05-20,52,11325,38.4
13177,Lee County,2021-05-21,54,11379,38.6
13177,Lee County,2021-05-22,25,11404,38.7
13177,Lee County,2021-05-23,12,11416,38.7
13177,Lee County,2021-05-24,34,11450,38.8
13177,Lee County,2021-05-25,38,11488,38.9
13177,Lee County,2021-05-26,32,11520,39
13177,Lee County,2021-05-27,33,11553,39.2
13177,Lee County,2021-05-28,35,11588,39.3
13177,Lee County,2021-05-29,6,11594,39.3
13177,Lee County,2021-05-30,7,11601,39.3
13177,Lee County,2021-05-31,2,11603,39.3
13177,Lee County,2021-06-01,35,11638,39.4
13177,Lee County,2021-06-02,32,11670,39.6
13177,Lee County,2021-06-03,25,11695,39.6
13177,Lee County,2021-06-04,33,11728,39.8
13177,Lee County,2021-06-05,13,11741,39.8
13177,Lee County,2021-06-06,7,11748,39.8
13177,Lee County,2021-06-07,26,11774,39.9
13177,Lee County,2021-06-08,27,11801,40
13177,Lee County,2021-06-09,15,11816,40.1
13177,Lee County,2021-06-10,26,11842,40.1
13177,Lee County,2021-06-11,35,11877,40.3
13177,Lee County,2021-06-12,20,11897,40.3
13177,Lee County,2021-06-13,5,11902,40.3
13177,Lee County,2021-06-14,27,11929,40.4
13177,Lee County,2021-06-15,18,11947,40.5
13177,Lee County,2021-06-16,29,11976,40.6
13177,Lee County,2021-06-17,18,11994,40.7
13177,Lee County,2021-06-18,21,12015,40.7
13177,Lee County,2021-06-19,8,12023,40.8
13177,Lee County,2021-06-20,6,12029,40.8
13177,Lee County,2021-06-21,11,12040,40.8
13177,Lee County,2021-06-22,23,12063,40.9
13177,Lee County,2021-06-23,18,12081,40.9
13177,Lee County,2021-06-24,60,12141,41.2
13177,Lee County,2021-06-25,17,12158,41.2
13177,Lee County,2021-06-26,10,12168,41.2
13177,Lee County,2021-06-27,7,12175,41.3
13177,Lee County,2021-06-28,13,12188,41.3
13177,Lee County,2021-06-29,16,12204,41.4
13177,Lee County,2021-06-30,18,12222,41.4
13177,Lee County,2021-07-01,21,12243,41.5
13177,Lee County,2021-07-02,20,12263,41.6
13177,Lee County,2021-07-03,10,12273,41.6
13177,Lee County,2021-07-04,1,12274,41.6
13177,Lee County,2021-07-05,6,12280,41.6
13177,Lee County,2021-07-06,18,12298,41.7
13177,Lee County,2021-07-07,31,12329,41.8
13177,Lee County,2021-07-08,17,12346,41.8
13177,Lee County,2021-07-09,19,12365,41.9
13177,Lee County,2021-07-10,13,12378,42
13177,Lee County,2021-07-11,9,12387,42
13177,Lee County,2021-07-12,11,12398,42
13177,Lee County,2021-07-13,27,12425,42.1
13177,Lee County,2021-07-14,13,12438,42.2
13177,Lee County,2021-07-15,23,12461,42.2
13177,Lee County,2021-07-16,27,12488,42.3
13177,Lee County,2021-07-17,20,12508,42.4
13177,Lee County,2021-07-18,14,12522,42.4
13177,Lee County,2021-07-19,25,12547,42.5
13177,Lee County,2021-07-20,30,12577,42.6
13177,Lee County,2021-07-21,20,12597,42.7
13177,Lee County,2021-07-22,43,12640,42.8
13177,Lee County,2021-07-23,47,12687,43
13177,Lee County,2021-07-24,27,12714,43.1
13177,Lee County,2021-07-25,9,12723,43.1
13177,Lee County,2021-07-26,28,12751,43.2
13177,Lee County,2021-07-27,41,12792,43.4
13177,Lee County,2021-07-28,44,12836,43.5
13177,Lee County,2021-07-29,61,12897,43.7
13177,Lee County,2021-07-30,79,12976,44
13177,Lee County,2021-07-31,45,13021,44.1
13177,Lee County,2021-08-01,18,13039,44.2
13177,Lee County,2021-08-02,50,13089,44.4
13177,Lee County,2021-08-03,64,13153,44.6
13177,Lee County,2021-08-04,63,13216,44.8
13177,Lee County,2021-08-05,79,13295,45.1
13177,Lee County,2021-08-06,83,13378,45.3
13177,Lee County,2021-08-07,61,13439,45.6
13177,Lee County,2021-08-08,32,13471,45.7
13177,Lee County,2021-08-09,55,13526,45.8
13177,Lee County,2021-08-10,102,13628,46.2
13177,Lee County,2021-08-11,79,13707,46.5
13177,Lee County,2021-08-12,82,13789,46.7
13177,Lee County,2021-08-13,139,13928,47.2
13177,Lee County,2021-08-14,45,13973,47.4
13177,Lee County,2021-08-15,38,14011,47.5
13177,Lee County,2021-08-16,57,14068,47.7
13177,Lee County,2021-08-17,80,14148,48
13177,Lee County,2021-08-18,68,14216,48.2
13177,Lee County,2021-08-19,76,14292,48.4
13177,Lee County,2021-08-20,113,14405,48.8
13177,Lee County,2021-08-21,48,14453,49
13177,Lee County,2021-08-22,17,14470,49
13177,Lee County,2021-08-23,51,14521,49.2
13177,Lee County,2021-08-24,75,14596,49.5
13177,Lee County,2021-08-25,52,14648,49.7
13177,Lee County,2021-08-26,59,14707,49.9
13177,Lee County,2021-08-27,87,14794,50.1
13177,Lee County,2021-08-28,36,14830,50.3
13177,Lee County,2021-08-29,20,14850,50.3
13177,Lee County,2021-08-30,55,14905,50.5
13177,Lee County,2021-08-31,63,14968,50.7
13177,Lee County,2021-09-01,62,15030,50.9
13177,Lee County,2021-09-02,48,15078,51.1
13177,Lee County,2021-09-03,54,15132,51.3
13177,Lee County,2021-09-04,27,15159,51.4
13177,Lee County,2021-09-05,18,15177,51.4
13177,Lee County,2021-09-06,9,15186,51.5
13177,Lee County,2021-09-07,30,15216,51.6
13177,Lee County,2021-09-08,37,15253,51.7
13177,Lee County,2021-09-09,25,15278,51.8
13177,Lee County,2021-09-10,35,15313,51.9
13177,Lee County,2021-09-11,13,15326,51.9
13177,Lee County,2021-09-12,16,15342,52
13177,Lee County,2021-09-13,23,15365,52.1
13177,Lee County,2021-09-14,35,15400,52.2
13177,Lee County,2021-09-15,38,15438,52.3
13177,Lee County,2021-09-16,29,15467,52.4
13177,Lee County,2021-09-17,33,15500,52.5
13177,Lee County,2021-09-18,10,15510,52.6
13177,Lee County,2021-09-19,10,15520,52.6
13177,Lee County,2021-09-20,21,15541,52.7
13177,Lee County,2021-09-21,24,15565,52.8
13177,Lee County,2021-09-22,17,15582,52.8
13177,Lee County,2021-09-23,15,15597,52.9
13177,Lee County,2021-09-24,23,15620,52.9
13177,Lee County,2021-09-25,5,15625,53
13177,Lee County,2021-09-26,9,15634,53
13177,Lee County,2021-09-27,11,15645,53
13177,Lee County,2021-09-28,9,15654,53.1
13177,Lee County,2021-09-29,8,15662,53.1
13177,Lee County,2021-09-30,14,15676,53.1
13177,Lee County,2021-10-01,13,15689,53.2
13177,Lee County,2021-10-02,4,15693,53.2
13177,Lee County,2021-10-03,3,15696,53.2
13177,Lee County,2021-10-04,8,15704,53.2
13177,Lee County,2021-10-05,9,15713,53.3
13177,Lee County,2021-10-06,11,15724,53.3
13177,Lee County,2021-10-07,6,15730,53.3
13179,Liberty County,2020-12-15,4,4,0
13179,Liberty County,2020-12-16,9,13,0
13179,Liberty County,2020-12-17,7,20,0
13179,Liberty County,2020-12-18,26,46,0.1
13179,Liberty County,2020-12-19,1,47,0.1
13179,Liberty County,2020-12-21,13,60,0.1
13179,Liberty County,2020-12-22,21,81,0.1
13179,Liberty County,2020-12-23,15,96,0.2
13179,Liberty County,2020-12-24,1,97,0.2
13179,Liberty County,2020-12-27,3,100,0.2
13179,Liberty County,2020-12-28,18,118,0.2
13179,Liberty County,2020-12-29,28,146,0.2
13179,Liberty County,2020-12-30,38,184,0.3
13179,Liberty County,2020-12-31,20,204,0.3
13179,Liberty County,2021-01-01,8,212,0.3
13179,Liberty County,2021-01-02,4,216,0.4
13179,Liberty County,2021-01-03,2,218,0.4
13179,Liberty County,2021-01-04,15,233,0.4
13179,Liberty County,2021-01-05,33,266,0.4
13179,Liberty County,2021-01-06,34,300,0.5
13179,Liberty County,2021-01-07,37,337,0.5
13179,Liberty County,2021-01-08,60,397,0.6
13179,Liberty County,2021-01-09,4,401,0.7
13179,Liberty County,2021-01-10,57,458,0.7
13179,Liberty County,2021-01-11,99,557,0.9
13179,Liberty County,2021-01-12,77,634,1
13179,Liberty County,2021-01-13,155,789,1.3
13179,Liberty County,2021-01-14,207,996,1.6
13179,Liberty County,2021-01-15,118,1114,1.8
13179,Liberty County,2021-01-16,67,1181,1.9
13179,Liberty County,2021-01-17,27,1208,2
13179,Liberty County,2021-01-18,192,1400,2.3
13179,Liberty County,2021-01-19,127,1527,2.5
13179,Liberty County,2021-01-20,126,1653,2.7
13179,Liberty County,2021-01-21,247,1900,3.1
13179,Liberty County,2021-01-22,125,2025,3.3
13179,Liberty County,2021-01-23,51,2076,3.4
13179,Liberty County,2021-01-24,57,2133,3.5
13179,Liberty County,2021-01-25,187,2320,3.8
13179,Liberty County,2021-01-26,82,2402,3.9
13179,Liberty County,2021-01-27,77,2479,4
13179,Liberty County,2021-01-28,161,2640,4.3
13179,Liberty County,2021-01-29,181,2821,4.6
13179,Liberty County,2021-01-30,51,2872,4.7
13179,Liberty County,2021-01-31,31,2903,4.7
13179,Liberty County,2021-02-01,125,3028,4.9
13179,Liberty County,2021-02-02,73,3101,5.1
13179,Liberty County,2021-02-03,148,3249,5.3
13179,Liberty County,2021-02-04,101,3350,5.5
13179,Liberty County,2021-02-05,70,3420,5.6
13179,Liberty County,2021-02-06,39,3459,5.6
13179,Liberty County,2021-02-07,4,3463,5.6
13179,Liberty County,2021-02-08,118,3581,5.8
13179,Liberty County,2021-02-09,47,3628,5.9
13179,Liberty County,2021-02-10,57,3685,6
13179,Liberty County,2021-02-11,43,3728,6.1
13179,Liberty County,2021-02-12,87,3815,6.2
13179,Liberty County,2021-02-13,18,3833,6.2
13179,Liberty County,2021-02-14,14,3847,6.3
13179,Liberty County,2021-02-15,120,3967,6.5
13179,Liberty County,2021-02-16,68,4035,6.6
13179,Liberty County,2021-02-17,100,4135,6.7
13179,Liberty County,2021-02-18,57,4192,6.8
13179,Liberty County,2021-02-19,45,4237,6.9
13179,Liberty County,2021-02-20,11,4248,6.9
13179,Liberty County,2021-02-21,10,4258,6.9
13179,Liberty County,2021-02-22,87,4345,7.1
13179,Liberty County,2021-02-23,42,4387,7.2
13179,Liberty County,2021-02-24,83,4470,7.3
13179,Liberty County,2021-02-25,50,4520,7.4
13179,Liberty County,2021-02-26,30,4550,7.4
13179,Liberty County,2021-02-27,134,4684,7.6
13179,Liberty County,2021-02-28,9,4693,7.6
13179,Liberty County,2021-03-01,86,4779,7.8
13179,Liberty County,2021-03-02,65,4844,7.9
13179,Liberty County,2021-03-03,68,4912,8
13179,Liberty County,2021-03-04,56,4968,8.1
13179,Liberty County,2021-03-05,31,4999,8.1
13179,Liberty County,2021-03-06,19,5018,8.2
13179,Liberty County,2021-03-07,14,5032,8.2
13179,Liberty County,2021-03-08,121,5153,8.4
13179,Liberty County,2021-03-09,120,5273,8.6
13179,Liberty County,2021-03-10,121,5394,8.8
13179,Liberty County,2021-03-11,135,5529,9
13179,Liberty County,2021-03-12,128,5657,9.2
13179,Liberty County,2021-03-13,327,5984,9.8
13179,Liberty County,2021-03-14,19,6003,9.8
13179,Liberty County,2021-03-15,206,6209,10.1
13179,Liberty County,2021-03-16,112,6321,10.3
13179,Liberty County,2021-03-17,199,6520,10.6
13179,Liberty County,2021-03-18,132,6652,10.8
13179,Liberty County,2021-03-19,169,6821,11.1
13179,Liberty County,2021-03-20,65,6886,11.2
13179,Liberty County,2021-03-21,28,6914,11.3
13179,Liberty County,2021-03-22,214,7128,11.6
13179,Liberty County,2021-03-23,161,7289,11.9
13179,Liberty County,2021-03-24,166,7455,12.2
13179,Liberty County,2021-03-25,168,7623,12.4
13179,Liberty County,2021-03-26,184,7807,12.7
13179,Liberty County,2021-03-27,74,7881,12.8
13179,Liberty County,2021-03-28,46,7927,12.9
13179,Liberty County,2021-03-29,200,8127,13.2
13179,Liberty County,2021-03-30,223,8350,13.6
13179,Liberty County,2021-03-31,217,8567,14
13179,Liberty County,2021-04-01,216,8783,14.3
13179,Liberty County,2021-04-02,169,8952,14.6
13179,Liberty County,2021-04-03,69,9021,14.7
13179,Liberty County,2021-04-04,16,9037,14.7
13179,Liberty County,2021-04-05,248,9285,15.1
13179,Liberty County,2021-04-06,163,9448,15.4
13179,Liberty County,2021-04-07,194,9642,15.7
13179,Liberty County,2021-04-08,156,9798,16
13179,Liberty County,2021-04-09,148,9946,16.2
13179,Liberty County,2021-04-10,58,10004,16.3
13179,Liberty County,2021-04-11,21,10025,16.3
13179,Liberty County,2021-04-12,135,10160,16.6
13179,Liberty County,2021-04-13,117,10277,16.8
13179,Liberty County,2021-04-14,165,10442,17
13179,Liberty County,2021-04-15,73,10515,17.1
13179,Liberty County,2021-04-16,92,10607,17.3
13179,Liberty County,2021-04-17,48,10655,17.4
13179,Liberty County,2021-04-18,13,10668,17.4
13179,Liberty County,2021-04-19,87,10755,17.5
13179,Liberty County,2021-04-20,67,10822,17.6
13179,Liberty County,2021-04-21,54,10876,17.7
13179,Liberty County,2021-04-22,73,10949,17.8
13179,Liberty County,2021-04-23,73,11022,18
13179,Liberty County,2021-04-24,26,11048,18
13179,Liberty County,2021-04-25,12,11060,18
13179,Liberty County,2021-04-26,89,11149,18.2
13179,Liberty County,2021-04-27,54,11203,18.3
13179,Liberty County,2021-04-28,45,11248,18.3
13179,Liberty County,2021-04-29,74,11322,18.5
13179,Liberty County,2021-04-30,77,11399,18.6
13179,Liberty County,2021-05-01,45,11444,18.7
13179,Liberty County,2021-05-02,11,11455,18.7
13179,Liberty County,2021-05-03,69,11524,18.8
13179,Liberty County,2021-05-04,49,11573,18.9
13179,Liberty County,2021-05-05,54,11627,19
13179,Liberty County,2021-05-06,69,11696,19.1
13179,Liberty County,2021-05-07,67,11763,19.2
13179,Liberty County,2021-05-08,34,11797,19.2
13179,Liberty County,2021-05-09,12,11809,19.2
13179,Liberty County,2021-05-10,50,11859,19.3
13179,Liberty County,2021-05-11,41,11900,19.4
13179,Liberty County,2021-05-12,53,11953,19.5
13179,Liberty County,2021-05-13,65,12018,19.6
13179,Liberty County,2021-05-14,63,12081,19.7
13179,Liberty County,2021-05-15,46,12127,19.8
13179,Liberty County,2021-05-16,28,12155,19.8
13179,Liberty County,2021-05-17,107,12262,20
13179,Liberty County,2021-05-18,66,12328,20.1
13179,Liberty County,2021-05-19,70,12398,20.2
13179,Liberty County,2021-05-20,80,12478,20.3
13179,Liberty County,2021-05-21,96,12574,20.5
13179,Liberty County,2021-05-22,46,12620,20.6
13179,Liberty County,2021-05-23,28,12648,20.6
13179,Liberty County,2021-05-24,57,12705,20.7
13179,Liberty County,2021-05-25,78,12783,20.8
13179,Liberty County,2021-05-26,46,12829,20.9
13179,Liberty County,2021-05-27,76,12905,21
13179,Liberty County,2021-05-28,52,12957,21.1
13179,Liberty County,2021-05-29,32,12989,21.2
13179,Liberty County,2021-05-30,23,13012,21.2
13179,Liberty County,2021-05-31,8,13020,21.2
13179,Liberty County,2021-06-01,66,13086,21.3
13179,Liberty County,2021-06-02,54,13140,21.4
13179,Liberty County,2021-06-03,50,13190,21.5
13179,Liberty County,2021-06-04,59,13249,21.6
13179,Liberty County,2021-06-05,35,13284,21.7
13179,Liberty County,2021-06-06,6,13290,21.7
13179,Liberty County,2021-06-07,65,13355,21.8
13179,Liberty County,2021-06-08,47,13402,21.8
13179,Liberty County,2021-06-09,23,13425,21.9
13179,Liberty County,2021-06-10,43,13468,22
13179,Liberty County,2021-06-11,45,13513,22
13179,Liberty County,2021-06-12,29,13542,22.1
13179,Liberty County,2021-06-13,13,13555,22.1
13179,Liberty County,2021-06-14,68,13623,22.2
13179,Liberty County,2021-06-15,44,13667,22.3
13179,Liberty County,2021-06-16,29,13696,22.3
13179,Liberty County,2021-06-17,52,13748,22.4
13179,Liberty County,2021-06-18,43,13791,22.5
13179,Liberty County,2021-06-19,14,13805,22.5
13179,Liberty County,2021-06-20,19,13824,22.5
13179,Liberty County,2021-06-21,44,13868,22.6
13179,Liberty County,2021-06-22,29,13897,22.7
13179,Liberty County,2021-06-23,35,13932,22.7
13179,Liberty County,2021-06-24,42,13974,22.8
13179,Liberty County,2021-06-25,30,14004,22.8
13179,Liberty County,2021-06-26,15,14019,22.9
13179,Liberty County,2021-06-27,13,14032,22.9
13179,Liberty County,2021-06-28,39,14071,22.9
13179,Liberty County,2021-06-29,66,14137,23
13179,Liberty County,2021-06-30,37,14174,23.1
13179,Liberty County,2021-07-01,27,14201,23.1
13179,Liberty County,2021-07-02,52,14253,23.2
13179,Liberty County,2021-07-03,23,14276,23.3
13179,Liberty County,2021-07-04,3,14279,23.3
13179,Liberty County,2021-07-05,26,14305,23.3
13179,Liberty County,2021-07-06,25,14330,23.4
13179,Liberty County,2021-07-07,25,14355,23.4
13179,Liberty County,2021-07-08,35,14390,23.5
13179,Liberty County,2021-07-09,37,14427,23.5
13179,Liberty County,2021-07-10,17,14444,23.5
13179,Liberty County,2021-07-11,14,14458,23.6
13179,Liberty County,2021-07-12,31,14489,23.6
13179,Liberty County,2021-07-13,26,14515,23.7
13179,Liberty County,2021-07-14,28,14543,23.7
13179,Liberty County,2021-07-15,35,14578,23.8
13179,Liberty County,2021-07-16,39,14617,23.8
13179,Liberty County,2021-07-17,27,14644,23.9
13179,Liberty County,2021-07-18,20,14664,23.9
13179,Liberty County,2021-07-19,52,14716,24
13179,Liberty County,2021-07-20,39,14755,24.1
13179,Liberty County,2021-07-21,45,14800,24.1
13179,Liberty County,2021-07-22,75,14875,24.2
13179,Liberty County,2021-07-23,68,14943,24.4
13179,Liberty County,2021-07-24,184,15127,24.7
13179,Liberty County,2021-07-25,21,15148,24.7
13179,Liberty County,2021-07-26,115,15263,24.9
13179,Liberty County,2021-07-27,97,15360,25
13179,Liberty County,2021-07-28,62,15422,25.1
13179,Liberty County,2021-07-29,104,15526,25.3
13179,Liberty County,2021-07-30,96,15622,25.5
13179,Liberty County,2021-07-31,53,15675,25.6
13179,Liberty County,2021-08-01,34,15709,25.6
13179,Liberty County,2021-08-02,72,15781,25.7
13179,Liberty County,2021-08-03,64,15845,25.8
13179,Liberty County,2021-08-04,79,15924,26
13179,Liberty County,2021-08-05,99,16023,26.1
13179,Liberty County,2021-08-06,94,16117,26.3
13179,Liberty County,2021-08-07,42,16159,26.3
13179,Liberty County,2021-08-08,26,16185,26.4
13179,Liberty County,2021-08-09,76,16261,26.5
13179,Liberty County,2021-08-10,103,16364,26.7
13179,Liberty County,2021-08-11,116,16480,26.9
13179,Liberty County,2021-08-12,83,16563,27
13179,Liberty County,2021-08-13,153,16716,27.2
13179,Liberty County,2021-08-14,72,16788,27.4
13179,Liberty County,2021-08-15,31,16819,27.4
13179,Liberty County,2021-08-16,99,16918,27.6
13179,Liberty County,2021-08-17,87,17005,27.7
13179,Liberty County,2021-08-18,78,17083,27.8
13179,Liberty County,2021-08-19,120,17203,28
13179,Liberty County,2021-08-20,99,17302,28.2
13179,Liberty County,2021-08-21,47,17349,28.3
13179,Liberty County,2021-08-22,28,17377,28.3
13179,Liberty County,2021-08-23,69,17446,28.4
13179,Liberty County,2021-08-24,68,17514,28.5
13179,Liberty County,2021-08-25,77,17591,28.7
13179,Liberty County,2021-08-26,94,17685,28.8
13179,Liberty County,2021-08-27,68,17753,28.9
13179,Liberty County,2021-08-28,47,17800,29
13179,Liberty County,2021-08-29,35,17835,29.1
13179,Liberty County,2021-08-30,82,17917,29.2
13179,Liberty County,2021-08-31,74,17991,29.3
13179,Liberty County,2021-09-01,61,18052,29.4
13179,Liberty County,2021-09-02,78,18130,29.6
13179,Liberty County,2021-09-03,77,18207,29.7
13179,Liberty County,2021-09-04,34,18241,29.7
13179,Liberty County,2021-09-05,24,18265,29.8
13179,Liberty County,2021-09-06,15,18280,29.8
13179,Liberty County,2021-09-07,58,18338,29.9
13179,Liberty County,2021-09-08,95,18433,30
13179,Liberty County,2021-09-09,66,18499,30.2
13179,Liberty County,2021-09-10,90,18589,30.3
13179,Liberty County,2021-09-11,34,18623,30.4
13179,Liberty County,2021-09-12,15,18638,30.4
13179,Liberty County,2021-09-13,61,18699,30.5
13179,Liberty County,2021-09-14,59,18758,30.6
13179,Liberty County,2021-09-15,43,18801,30.6
13179,Liberty County,2021-09-16,47,18848,30.7
13179,Liberty County,2021-09-17,53,18901,30.8
13179,Liberty County,2021-09-18,20,18921,30.8
13179,Liberty County,2021-09-19,19,18940,30.9
13179,Liberty County,2021-09-20,37,18977,30.9
13179,Liberty County,2021-09-21,41,19018,31
13179,Liberty County,2021-09-22,52,19070,31.1
13179,Liberty County,2021-09-23,55,19125,31.2
13179,Liberty County,2021-09-24,43,19168,31.2
13179,Liberty County,2021-09-25,15,19183,31.3
13179,Liberty County,2021-09-26,13,19196,31.3
13179,Liberty County,2021-09-27,16,19212,31.3
13179,Liberty County,2021-09-28,26,19238,31.4
13179,Liberty County,2021-09-29,31,19269,31.4
13179,Liberty County,2021-09-30,38,19307,31.5
13179,Liberty County,2021-10-01,19,19326,31.5
13179,Liberty County,2021-10-02,13,19339,31.5
13179,Liberty County,2021-10-03,9,19348,31.5
13179,Liberty County,2021-10-04,18,19366,31.6
13179,Liberty County,2021-10-05,16,19382,31.6
13179,Liberty County,2021-10-06,10,19392,31.6
13179,Liberty County,2021-10-07,14,19406,31.6
13181,Lincoln County,2020-12-13,1,1,0
13181,Lincoln County,2020-12-17,2,3,0
13181,Lincoln County,2020-12-18,3,6,0.1
13181,Lincoln County,2020-12-21,1,7,0.1
13181,Lincoln County,2020-12-22,12,19,0.2
13181,Lincoln County,2020-12-23,9,28,0.4
13181,Lincoln County,2020-12-24,4,32,0.4
13181,Lincoln County,2020-12-27,1,33,0.4
13181,Lincoln County,2020-12-28,5,38,0.5
13181,Lincoln County,2020-12-29,12,50,0.6
13181,Lincoln County,2020-12-30,10,60,0.8
13181,Lincoln County,2020-12-31,8,68,0.9
13181,Lincoln County,2021-01-01,3,71,0.9
13181,Lincoln County,2021-01-02,5,76,1
13181,Lincoln County,2021-01-04,11,87,1.1
13181,Lincoln County,2021-01-05,3,90,1.1
13181,Lincoln County,2021-01-06,5,95,1.2
13181,Lincoln County,2021-01-07,15,110,1.4
13181,Lincoln County,2021-01-08,9,119,1.5
13181,Lincoln County,2021-01-09,10,129,1.6
13181,Lincoln County,2021-01-11,16,145,1.8
13181,Lincoln County,2021-01-12,48,193,2.5
13181,Lincoln County,2021-01-13,35,228,2.9
13181,Lincoln County,2021-01-14,36,264,3.4
13181,Lincoln County,2021-01-15,32,296,3.8
13181,Lincoln County,2021-01-16,11,307,3.9
13181,Lincoln County,2021-01-17,1,308,3.9
13181,Lincoln County,2021-01-18,54,362,4.6
13181,Lincoln County,2021-01-19,77,439,5.6
13181,Lincoln County,2021-01-20,73,512,6.5
13181,Lincoln County,2021-01-21,127,639,8.1
13181,Lincoln County,2021-01-22,57,696,8.9
13181,Lincoln County,2021-01-23,24,720,9.2
13181,Lincoln County,2021-01-24,1,721,9.2
13181,Lincoln County,2021-01-25,28,749,9.5
13181,Lincoln County,2021-01-26,33,782,10
13181,Lincoln County,2021-01-27,36,818,10.4
13181,Lincoln County,2021-01-28,42,860,10.9
13181,Lincoln County,2021-01-29,49,909,11.6
13181,Lincoln County,2021-01-30,5,914,11.6
13181,Lincoln County,2021-01-31,1,915,11.6
13181,Lincoln County,2021-02-01,17,932,11.9
13181,Lincoln County,2021-02-02,71,1003,12.8
13181,Lincoln County,2021-02-03,4,1007,12.8
13181,Lincoln County,2021-02-04,38,1045,13.3
13181,Lincoln County,2021-02-05,26,1071,13.6
13181,Lincoln County,2021-02-06,4,1075,13.7
13181,Lincoln County,2021-02-08,7,1082,13.8
13181,Lincoln County,2021-02-09,9,1091,13.9
13181,Lincoln County,2021-02-10,9,1100,14
13181,Lincoln County,2021-02-11,2,1102,14
13181,Lincoln County,2021-02-12,31,1133,14.4
13181,Lincoln County,2021-02-13,10,1143,14.5
13181,Lincoln County,2021-02-15,3,1146,14.6
13181,Lincoln County,2021-02-16,9,1155,14.7
13181,Lincoln County,2021-02-17,9,1164,14.8
13181,Lincoln County,2021-02-18,20,1184,15.1
13181,Lincoln County,2021-02-19,5,1189,15.1
13181,Lincoln County,2021-02-20,2,1191,15.2
13181,Lincoln County,2021-02-22,4,1195,15.2
13181,Lincoln County,2021-02-23,4,1199,15.3
13181,Lincoln County,2021-02-24,5,1204,15.3
13181,Lincoln County,2021-02-25,18,1222,15.6
13181,Lincoln County,2021-02-26,10,1232,15.7
13181,Lincoln County,2021-02-27,1,1233,15.7
13181,Lincoln County,2021-03-01,11,1244,15.8
13181,Lincoln County,2021-03-02,46,1290,16.4
13181,Lincoln County,2021-03-03,36,1326,16.9
13181,Lincoln County,2021-03-04,48,1374,17.5
13181,Lincoln County,2021-03-05,13,1387,17.7
13181,Lincoln County,2021-03-06,3,1390,17.7
13181,Lincoln County,2021-03-07,3,1393,17.7
13181,Lincoln County,2021-03-08,19,1412,18
13181,Lincoln County,2021-03-09,25,1437,18.3
13181,Lincoln County,2021-03-10,28,1465,18.6
13181,Lincoln County,2021-03-11,54,1519,19.3
13181,Lincoln County,2021-03-12,98,1617,20.6
13181,Lincoln County,2021-03-13,26,1643,20.9
13181,Lincoln County,2021-03-14,3,1646,21
13181,Lincoln County,2021-03-15,20,1666,21.2
13181,Lincoln County,2021-03-16,117,1783,22.7
13181,Lincoln County,2021-03-17,53,1836,23.4
13181,Lincoln County,2021-03-18,69,1905,24.2
13181,Lincoln County,2021-03-19,31,1936,24.6
13181,Lincoln County,2021-03-20,18,1954,24.9
13181,Lincoln County,2021-03-21,2,1956,24.9
13181,Lincoln County,2021-03-22,33,1989,25.3
13181,Lincoln County,2021-03-23,57,2046,26
13181,Lincoln County,2021-03-24,32,2078,26.5
13181,Lincoln County,2021-03-25,79,2157,27.5
13181,Lincoln County,2021-03-26,42,2199,28
13181,Lincoln County,2021-03-27,16,2215,28.2
13181,Lincoln County,2021-03-28,8,2223,28.3
13181,Lincoln County,2021-03-29,22,2245,28.6
13181,Lincoln County,2021-03-30,60,2305,29.3
13181,Lincoln County,2021-03-31,14,2319,29.5
13181,Lincoln County,2021-04-01,44,2363,30.1
13181,Lincoln County,2021-04-02,21,2384,30.3
13181,Lincoln County,2021-04-03,6,2390,30.4
13181,Lincoln County,2021-04-04,3,2393,30.5
13181,Lincoln County,2021-04-05,13,2406,30.6
13181,Lincoln County,2021-04-06,28,2434,31
13181,Lincoln County,2021-04-07,12,2446,31.1
13181,Lincoln County,2021-04-08,25,2471,31.5
13181,Lincoln County,2021-04-09,18,2489,31.7
13181,Lincoln County,2021-04-10,4,2493,31.7
13181,Lincoln County,2021-04-11,2,2495,31.8
13181,Lincoln County,2021-04-12,16,2511,32
13181,Lincoln County,2021-04-13,24,2535,32.3
13181,Lincoln County,2021-04-14,7,2542,32.4
13181,Lincoln County,2021-04-15,20,2562,32.6
13181,Lincoln County,2021-04-16,12,2574,32.8
13181,Lincoln County,2021-04-17,4,2578,32.8
13181,Lincoln County,2021-04-18,1,2579,32.8
13181,Lincoln County,2021-04-19,5,2584,32.9
13181,Lincoln County,2021-04-20,13,2597,33.1
13181,Lincoln County,2021-04-21,8,2605,33.2
13181,Lincoln County,2021-04-22,23,2628,33.5
13181,Lincoln County,2021-04-23,12,2640,33.6
13181,Lincoln County,2021-04-24,3,2643,33.6
13181,Lincoln County,2021-04-25,2,2645,33.7
13181,Lincoln County,2021-04-26,7,2652,33.8
13181,Lincoln County,2021-04-27,11,2663,33.9
13181,Lincoln County,2021-04-28,12,2675,34.1
13181,Lincoln County,2021-04-29,19,2694,34.3
13181,Lincoln County,2021-04-30,24,2718,34.6
13181,Lincoln County,2021-05-01,7,2725,34.7
13181,Lincoln County,2021-05-02,2,2727,34.7
13181,Lincoln County,2021-05-03,8,2735,34.8
13181,Lincoln County,2021-05-04,8,2743,34.9
13181,Lincoln County,2021-05-05,7,2750,35
13181,Lincoln County,2021-05-06,6,2756,35.1
13181,Lincoln County,2021-05-07,24,2780,35.4
13181,Lincoln County,2021-05-08,4,2784,35.4
13181,Lincoln County,2021-05-10,3,2787,35.5
13181,Lincoln County,2021-05-11,11,2798,35.6
13181,Lincoln County,2021-05-12,6,2804,35.7
13181,Lincoln County,2021-05-13,14,2818,35.9
13181,Lincoln County,2021-05-14,11,2829,36
13181,Lincoln County,2021-05-15,4,2833,36.1
13181,Lincoln County,2021-05-16,1,2834,36.1
13181,Lincoln County,2021-05-17,5,2839,36.1
13181,Lincoln County,2021-05-18,5,2844,36.2
13181,Lincoln County,2021-05-19,8,2852,36.3
13181,Lincoln County,2021-05-20,5,2857,36.4
13181,Lincoln County,2021-05-21,15,2872,36.6
13181,Lincoln County,2021-05-22,9,2881,36.7
13181,Lincoln County,2021-05-25,7,2888,36.8
13181,Lincoln County,2021-05-26,5,2893,36.8
13181,Lincoln County,2021-05-27,5,2898,36.9
13181,Lincoln County,2021-05-28,12,2910,37
13181,Lincoln County,2021-05-30,1,2911,37.1
13181,Lincoln County,2021-06-01,6,2917,37.1
13181,Lincoln County,2021-06-02,1,2918,37.1
13181,Lincoln County,2021-06-03,4,2922,37.2
13181,Lincoln County,2021-06-04,9,2931,37.3
13181,Lincoln County,2021-06-05,4,2935,37.4
13181,Lincoln County,2021-06-06,2,2937,37.4
13181,Lincoln County,2021-06-07,2,2939,37.4
13181,Lincoln County,2021-06-08,5,2944,37.5
13181,Lincoln County,2021-06-09,4,2948,37.5
13181,Lincoln County,2021-06-10,2,2950,37.6
13181,Lincoln County,2021-06-11,13,2963,37.7
13181,Lincoln County,2021-06-12,4,2967,37.8
13181,Lincoln County,2021-06-13,1,2968,37.8
13181,Lincoln County,2021-06-14,1,2969,37.8
13181,Lincoln County,2021-06-15,4,2973,37.8
13181,Lincoln County,2021-06-16,3,2976,37.9
13181,Lincoln County,2021-06-17,6,2982,38
13181,Lincoln County,2021-06-18,11,2993,38.1
13181,Lincoln County,2021-06-19,5,2998,38.2
13181,Lincoln County,2021-06-21,8,3006,38.3
13181,Lincoln County,2021-06-22,7,3013,38.4
13181,Lincoln County,2021-06-23,5,3018,38.4
13181,Lincoln County,2021-06-24,4,3022,38.5
13181,Lincoln County,2021-06-25,8,3030,38.6
13181,Lincoln County,2021-06-26,1,3031,38.6
13181,Lincoln County,2021-06-27,1,3032,38.6
13181,Lincoln County,2021-06-28,4,3036,38.6
13181,Lincoln County,2021-06-29,1,3037,38.7
13181,Lincoln County,2021-06-30,3,3040,38.7
13181,Lincoln County,2021-07-02,5,3045,38.8
13181,Lincoln County,2021-07-03,1,3046,38.8
13181,Lincoln County,2021-07-05,2,3048,38.8
13181,Lincoln County,2021-07-06,3,3051,38.8
13181,Lincoln County,2021-07-07,2,3053,38.9
13181,Lincoln County,2021-07-08,6,3059,38.9
13181,Lincoln County,2021-07-09,10,3069,39.1
13181,Lincoln County,2021-07-10,1,3070,39.1
13181,Lincoln County,2021-07-11,1,3071,39.1
13181,Lincoln County,2021-07-13,5,3076,39.2
13181,Lincoln County,2021-07-14,6,3082,39.2
13181,Lincoln County,2021-07-15,5,3087,39.3
13181,Lincoln County,2021-07-16,6,3093,39.4
13181,Lincoln County,2021-07-17,3,3096,39.4
13181,Lincoln County,2021-07-18,1,3097,39.4
13181,Lincoln County,2021-07-19,2,3099,39.4
13181,Lincoln County,2021-07-20,4,3103,39.5
13181,Lincoln County,2021-07-21,12,3115,39.7
13181,Lincoln County,2021-07-22,14,3129,39.8
13181,Lincoln County,2021-07-23,26,3155,40.2
13181,Lincoln County,2021-07-24,8,3163,40.3
13181,Lincoln County,2021-07-25,3,3166,40.3
13181,Lincoln County,2021-07-26,12,3178,40.5
13181,Lincoln County,2021-07-27,10,3188,40.6
13181,Lincoln County,2021-07-28,10,3198,40.7
13181,Lincoln County,2021-07-29,11,3209,40.8
13181,Lincoln County,2021-07-30,30,3239,41.2
13181,Lincoln County,2021-07-31,6,3245,41.3
13181,Lincoln County,2021-08-01,3,3248,41.3
13181,Lincoln County,2021-08-02,7,3255,41.4
13181,Lincoln County,2021-08-03,14,3269,41.6
13181,Lincoln County,2021-08-04,17,3286,41.8
13181,Lincoln County,2021-08-05,11,3297,42
13181,Lincoln County,2021-08-06,12,3309,42.1
13181,Lincoln County,2021-08-07,5,3314,42.2
13181,Lincoln County,2021-08-08,1,3315,42.2
13181,Lincoln County,2021-08-09,18,3333,42.4
13181,Lincoln County,2021-08-10,15,3348,42.6
13181,Lincoln County,2021-08-11,12,3360,42.8
13181,Lincoln County,2021-08-12,15,3375,43
13181,Lincoln County,2021-08-13,25,3400,43.3
13181,Lincoln County,2021-08-14,5,3405,43.3
13181,Lincoln County,2021-08-15,3,3408,43.4
13181,Lincoln County,2021-08-16,13,3421,43.5
13181,Lincoln County,2021-08-17,15,3436,43.7
13181,Lincoln County,2021-08-18,12,3448,43.9
13181,Lincoln County,2021-08-19,22,3470,44.2
13181,Lincoln County,2021-08-20,21,3491,44.4
13181,Lincoln County,2021-08-21,1,3492,44.5
13181,Lincoln County,2021-08-22,5,3497,44.5
13181,Lincoln County,2021-08-23,8,3505,44.6
13181,Lincoln County,2021-08-24,14,3519,44.8
13181,Lincoln County,2021-08-25,17,3536,45
13181,Lincoln County,2021-08-26,16,3552,45.2
13181,Lincoln County,2021-08-27,41,3593,45.7
13181,Lincoln County,2021-08-28,4,3597,45.8
13181,Lincoln County,2021-08-29,2,3599,45.8
13181,Lincoln County,2021-08-30,11,3610,46
13181,Lincoln County,2021-08-31,8,3618,46.1
13181,Lincoln County,2021-09-01,14,3632,46.2
13181,Lincoln County,2021-09-02,20,3652,46.5
13181,Lincoln County,2021-09-03,21,3673,46.8
13181,Lincoln County,2021-09-04,3,3676,46.8
13181,Lincoln County,2021-09-05,2,3678,46.8
13181,Lincoln County,2021-09-06,1,3679,46.8
13181,Lincoln County,2021-09-07,9,3688,46.9
13181,Lincoln County,2021-09-08,9,3697,47.1
13181,Lincoln County,2021-09-09,15,3712,47.3
13181,Lincoln County,2021-09-10,20,3732,47.5
13181,Lincoln County,2021-09-11,10,3742,47.6
13181,Lincoln County,2021-09-12,3,3745,47.7
13181,Lincoln County,2021-09-13,9,3754,47.8
13181,Lincoln County,2021-09-14,5,3759,47.8
13181,Lincoln County,2021-09-15,10,3769,48
13181,Lincoln County,2021-09-16,3,3772,48
13181,Lincoln County,2021-09-17,13,3785,48.2
13181,Lincoln County,2021-09-18,3,3788,48.2
13181,Lincoln County,2021-09-19,2,3790,48.2
13181,Lincoln County,2021-09-20,6,3796,48.3
13181,Lincoln County,2021-09-21,5,3801,48.4
13181,Lincoln County,2021-09-22,6,3807,48.5
13181,Lincoln County,2021-09-23,5,3812,48.5
13181,Lincoln County,2021-09-24,12,3824,48.7
13181,Lincoln County,2021-09-26,1,3825,48.7
13181,Lincoln County,2021-09-27,2,3827,48.7
13181,Lincoln County,2021-09-28,2,3829,48.7
13181,Lincoln County,2021-09-29,5,3834,48.8
13181,Lincoln County,2021-09-30,2,3836,48.8
13181,Lincoln County,2021-10-01,5,3841,48.9
13181,Lincoln County,2021-10-02,1,3842,48.9
13181,Lincoln County,2021-10-03,1,3843,48.9
13181,Lincoln County,2021-10-04,3,3846,49
13181,Lincoln County,2021-10-05,3,3849,49
13181,Lincoln County,2021-10-06,3,3852,49
13181,Lincoln County,2021-10-07,2,3854,49.1
13183,Long County,2020-12-15,1,1,0
13183,Long County,2020-12-16,2,3,0
13183,Long County,2020-12-18,5,8,0
13183,Long County,2020-12-19,1,9,0
13183,Long County,2020-12-21,1,10,0.1
13183,Long County,2020-12-22,4,14,0.1
13183,Long County,2020-12-23,4,18,0.1
13183,Long County,2020-12-24,1,19,0.1
13183,Long County,2020-12-28,3,22,0.1
13183,Long County,2020-12-29,9,31,0.2
13183,Long County,2020-12-30,5,36,0.2
13183,Long County,2020-12-31,2,38,0.2
13183,Long County,2021-01-01,2,40,0.2
13183,Long County,2021-01-02,1,41,0.2
13183,Long County,2021-01-03,1,42,0.2
13183,Long County,2021-01-04,5,47,0.3
13183,Long County,2021-01-05,9,56,0.3
13183,Long County,2021-01-06,15,71,0.4
13183,Long County,2021-01-07,15,86,0.5
13183,Long County,2021-01-08,26,112,0.6
13183,Long County,2021-01-09,1,113,0.6
13183,Long County,2021-01-10,1,114,0.6
13183,Long County,2021-01-11,35,149,0.8
13183,Long County,2021-01-12,6,155,0.8
13183,Long County,2021-01-13,12,167,0.9
13183,Long County,2021-01-14,50,217,1.2
13183,Long County,2021-01-15,27,244,1.3
13183,Long County,2021-01-16,8,252,1.3
13183,Long County,2021-01-17,12,264,1.4
13183,Long County,2021-01-18,43,307,1.6
13183,Long County,2021-01-19,3,310,1.7
13183,Long County,2021-01-20,20,330,1.8
13183,Long County,2021-01-21,69,399,2.1
13183,Long County,2021-01-22,14,413,2.2
13183,Long County,2021-01-23,11,424,2.3
13183,Long County,2021-01-24,2,426,2.3
13183,Long County,2021-01-25,51,477,2.6
13183,Long County,2021-01-26,11,488,2.6
13183,Long County,2021-01-27,5,493,2.6
13183,Long County,2021-01-28,43,536,2.9
13183,Long County,2021-01-29,9,545,2.9
13183,Long County,2021-01-30,12,557,3
13183,Long County,2021-01-31,2,559,3
13183,Long County,2021-02-01,35,594,3.2
13183,Long County,2021-02-02,20,614,3.3
13183,Long County,2021-02-03,13,627,3.4
13183,Long County,2021-02-04,22,649,3.5
13183,Long County,2021-02-05,15,664,3.6
13183,Long County,2021-02-06,9,673,3.6
13183,Long County,2021-02-08,12,685,3.7
13183,Long County,2021-02-09,19,704,3.8
13183,Long County,2021-02-10,8,712,3.8
13183,Long County,2021-02-11,11,723,3.9
13183,Long County,2021-02-12,18,741,4
13183,Long County,2021-02-13,3,744,4
13183,Long County,2021-02-14,2,746,4
13183,Long County,2021-02-15,18,764,4.1
13183,Long County,2021-02-16,20,784,4.2
13183,Long County,2021-02-17,22,806,4.3
13183,Long County,2021-02-18,20,826,4.4
13183,Long County,2021-02-19,17,843,4.5
13183,Long County,2021-02-20,4,847,4.5
13183,Long County,2021-02-21,1,848,4.5
13183,Long County,2021-02-22,30,878,4.7
13183,Long County,2021-02-23,24,902,4.8
13183,Long County,2021-02-24,8,910,4.9
13183,Long County,2021-02-25,23,933,5
13183,Long County,2021-02-26,7,940,5
13183,Long County,2021-02-27,8,948,5.1
13183,Long County,2021-02-28,4,952,5.1
13183,Long County,2021-03-01,19,971,5.2
13183,Long County,2021-03-02,25,996,5.3
13183,Long County,2021-03-03,6,1002,5.4
13183,Long County,2021-03-04,16,1018,5.4
13183,Long County,2021-03-05,9,1027,5.5
13183,Long County,2021-03-07,3,1030,5.5
13183,Long County,2021-03-08,22,1052,5.6
13183,Long County,2021-03-09,32,1084,5.8
13183,Long County,2021-03-10,27,1111,5.9
13183,Long County,2021-03-11,25,1136,6.1
13183,Long County,2021-03-12,25,1161,6.2
13183,Long County,2021-03-13,30,1191,6.4
13183,Long County,2021-03-14,3,1194,6.4
13183,Long County,2021-03-15,46,1240,6.6
13183,Long County,2021-03-16,38,1278,6.8
13183,Long County,2021-03-17,31,1309,7
13183,Long County,2021-03-18,31,1340,7.2
13183,Long County,2021-03-19,77,1417,7.6
13183,Long County,2021-03-20,16,1433,7.7
13183,Long County,2021-03-21,4,1437,7.7
13183,Long County,2021-03-22,61,1498,8
13183,Long County,2021-03-23,33,1531,8.2
13183,Long County,2021-03-24,33,1564,8.4
13183,Long County,2021-03-25,43,1607,8.6
13183,Long County,2021-03-26,27,1634,8.7
13183,Long County,2021-03-27,6,1640,8.8
13183,Long County,2021-03-28,8,1648,8.8
13183,Long County,2021-03-29,30,1678,9
13183,Long County,2021-03-30,48,1726,9.2
13183,Long County,2021-03-31,42,1768,9.5
13183,Long County,2021-04-01,44,1812,9.7
13183,Long County,2021-04-02,35,1847,9.9
13183,Long County,2021-04-03,10,1857,9.9
13183,Long County,2021-04-04,4,1861,10
13183,Long County,2021-04-05,27,1888,10.1
13183,Long County,2021-04-06,28,1916,10.3
13183,Long County,2021-04-07,30,1946,10.4
13183,Long County,2021-04-08,36,1982,10.6
13183,Long County,2021-04-09,15,1997,10.7
13183,Long County,2021-04-10,24,2021,10.8
13183,Long County,2021-04-11,6,2027,10.8
13183,Long County,2021-04-12,16,2043,10.9
13183,Long County,2021-04-13,33,2076,11.1
13183,Long County,2021-04-14,28,2104,11.3
13183,Long County,2021-04-15,79,2183,11.7
13183,Long County,2021-04-16,36,2219,11.9
13183,Long County,2021-04-17,9,2228,11.9
13183,Long County,2021-04-18,3,2231,11.9
13183,Long County,2021-04-19,14,2245,12
13183,Long County,2021-04-20,15,2260,12.1
13183,Long County,2021-04-21,15,2275,12.2
13183,Long County,2021-04-22,10,2285,12.2
13183,Long County,2021-04-23,12,2297,12.3
13183,Long County,2021-04-24,9,2306,12.3
13183,Long County,2021-04-25,4,2310,12.4
13183,Long County,2021-04-26,16,2326,12.4
13183,Long County,2021-04-27,19,2345,12.5
13183,Long County,2021-04-28,8,2353,12.6
13183,Long County,2021-04-29,14,2367,12.7
13183,Long County,2021-04-30,21,2388,12.8
13183,Long County,2021-05-01,7,2395,12.8
13183,Long County,2021-05-02,1,2396,12.8
13183,Long County,2021-05-03,14,2410,12.9
13183,Long County,2021-05-04,12,2422,13
13183,Long County,2021-05-05,13,2435,13
13183,Long County,2021-05-06,15,2450,13.1
13183,Long County,2021-05-07,13,2463,13.2
13183,Long County,2021-05-08,4,2467,13.2
13183,Long County,2021-05-09,3,2470,13.2
13183,Long County,2021-05-10,13,2483,13.3
13183,Long County,2021-05-11,12,2495,13.3
13183,Long County,2021-05-12,8,2503,13.4
13183,Long County,2021-05-13,24,2527,13.5
13183,Long County,2021-05-14,10,2537,13.6
13183,Long County,2021-05-15,11,2548,13.6
13183,Long County,2021-05-16,9,2557,13.7
13183,Long County,2021-05-17,20,2577,13.8
13183,Long County,2021-05-18,14,2591,13.9
13183,Long County,2021-05-19,20,2611,14
13183,Long County,2021-05-20,29,2640,14.1
13183,Long County,2021-05-21,17,2657,14.2
13183,Long County,2021-05-22,10,2667,14.3
13183,Long County,2021-05-23,3,2670,14.3
13183,Long County,2021-05-24,4,2674,14.3
13183,Long County,2021-05-25,15,2689,14.4
13183,Long County,2021-05-26,18,2707,14.5
13183,Long County,2021-05-27,6,2713,14.5
13183,Long County,2021-05-28,11,2724,14.6
13183,Long County,2021-05-29,7,2731,14.6
13183,Long County,2021-05-30,3,2734,14.6
13183,Long County,2021-05-31,3,2737,14.6
13183,Long County,2021-06-01,8,2745,14.7
13183,Long County,2021-06-02,11,2756,14.7
13183,Long County,2021-06-03,14,2770,14.8
13183,Long County,2021-06-04,14,2784,14.9
13183,Long County,2021-06-05,5,2789,14.9
13183,Long County,2021-06-06,5,2794,14.9
13183,Long County,2021-06-07,3,2797,15
13183,Long County,2021-06-08,10,2807,15
13183,Long County,2021-06-09,3,2810,15
13183,Long County,2021-06-10,7,2817,15.1
13183,Long County,2021-06-11,7,2824,15.1
13183,Long County,2021-06-12,12,2836,15.2
13183,Long County,2021-06-13,4,2840,15.2
13183,Long County,2021-06-14,8,2848,15.2
13183,Long County,2021-06-15,4,2852,15.3
13183,Long County,2021-06-16,7,2859,15.3
13183,Long County,2021-06-17,11,2870,15.4
13183,Long County,2021-06-18,7,2877,15.4
13183,Long County,2021-06-19,4,2881,15.4
13183,Long County,2021-06-20,1,2882,15.4
13183,Long County,2021-06-21,8,2890,15.5
13183,Long County,2021-06-22,4,2894,15.5
13183,Long County,2021-06-23,12,2906,15.5
13183,Long County,2021-06-24,8,2914,15.6
13183,Long County,2021-06-25,8,2922,15.6
13183,Long County,2021-06-26,7,2929,15.7
13183,Long County,2021-06-27,4,2933,15.7
13183,Long County,2021-06-28,11,2944,15.8
13183,Long County,2021-06-29,8,2952,15.8
13183,Long County,2021-06-30,8,2960,15.8
13183,Long County,2021-07-01,14,2974,15.9
13183,Long County,2021-07-02,9,2983,16
13183,Long County,2021-07-03,6,2989,16
13183,Long County,2021-07-04,1,2990,16
13183,Long County,2021-07-05,1,2991,16
13183,Long County,2021-07-06,6,2997,16
13183,Long County,2021-07-07,3,3000,16
13183,Long County,2021-07-08,2,3002,16.1
13183,Long County,2021-07-09,4,3006,16.1
13183,Long County,2021-07-10,7,3013,16.1
13183,Long County,2021-07-12,10,3023,16.2
13183,Long County,2021-07-13,2,3025,16.2
13183,Long County,2021-07-14,10,3035,16.2
13183,Long County,2021-07-15,7,3042,16.3
13183,Long County,2021-07-16,7,3049,16.3
13183,Long County,2021-07-17,10,3059,16.4
13183,Long County,2021-07-18,11,3070,16.4
13183,Long County,2021-07-19,6,3076,16.5
13183,Long County,2021-07-20,9,3085,16.5
13183,Long County,2021-07-21,17,3102,16.6
13183,Long County,2021-07-22,28,3130,16.7
13183,Long County,2021-07-23,36,3166,16.9
13183,Long County,2021-07-24,20,3186,17
13183,Long County,2021-07-25,7,3193,17.1
13183,Long County,2021-07-26,21,3214,17.2
13183,Long County,2021-07-27,16,3230,17.3
13183,Long County,2021-07-28,18,3248,17.4
13183,Long County,2021-07-29,23,3271,17.5
13183,Long County,2021-07-30,14,3285,17.6
13183,Long County,2021-07-31,8,3293,17.6
13183,Long County,2021-08-01,12,3305,17.7
13183,Long County,2021-08-02,21,3326,17.8
13183,Long County,2021-08-03,17,3343,17.9
13183,Long County,2021-08-04,17,3360,18
13183,Long County,2021-08-05,24,3384,18.1
13183,Long County,2021-08-06,26,3410,18.2
13183,Long County,2021-08-07,14,3424,18.3
13183,Long County,2021-08-08,8,3432,18.4
13183,Long County,2021-08-09,18,3450,18.5
13183,Long County,2021-08-10,24,3474,18.6
13183,Long County,2021-08-11,33,3507,18.8
13183,Long County,2021-08-12,28,3535,18.9
13183,Long County,2021-08-13,43,3578,19.1
13183,Long County,2021-08-14,23,3601,19.3
13183,Long County,2021-08-15,15,3616,19.3
13183,Long County,2021-08-16,32,3648,19.5
13183,Long County,2021-08-17,21,3669,19.6
13183,Long County,2021-08-18,19,3688,19.7
13183,Long County,2021-08-19,21,3709,19.8
13183,Long County,2021-08-20,29,3738,20
13183,Long County,2021-08-21,15,3753,20.1
13183,Long County,2021-08-22,8,3761,20.1
13183,Long County,2021-08-23,14,3775,20.2
13183,Long County,2021-08-24,8,3783,20.2
13183,Long County,2021-08-25,25,3808,20.4
13183,Long County,2021-08-26,35,3843,20.6
13183,Long County,2021-08-27,27,3870,20.7
13183,Long County,2021-08-28,13,3883,20.8
13183,Long County,2021-08-29,5,3888,20.8
13183,Long County,2021-08-30,15,3903,20.9
13183,Long County,2021-08-31,17,3920,21
13183,Long County,2021-09-01,26,3946,21.1
13183,Long County,2021-09-02,24,3970,21.2
13183,Long County,2021-09-03,16,3986,21.3
13183,Long County,2021-09-04,10,3996,21.4
13183,Long County,2021-09-05,7,4003,21.4
13183,Long County,2021-09-06,12,4015,21.5
13183,Long County,2021-09-07,11,4026,21.5
13183,Long County,2021-09-08,16,4042,21.6
13183,Long County,2021-09-09,24,4066,21.8
13183,Long County,2021-09-10,26,4092,21.9
13183,Long County,2021-09-11,16,4108,22
13183,Long County,2021-09-12,5,4113,22
13183,Long County,2021-09-13,17,4130,22.1
13183,Long County,2021-09-14,14,4144,22.2
13183,Long County,2021-09-15,11,4155,22.2
13183,Long County,2021-09-16,16,4171,22.3
13183,Long County,2021-09-17,8,4179,22.4
13183,Long County,2021-09-18,8,4187,22.4
13183,Long County,2021-09-19,5,4192,22.4
13183,Long County,2021-09-20,11,4203,22.5
13183,Long County,2021-09-21,10,4213,22.5
13183,Long County,2021-09-22,7,4220,22.6
13183,Long County,2021-09-23,10,4230,22.6
13183,Long County,2021-09-24,7,4237,22.7
13183,Long County,2021-09-25,7,4244,22.7
13183,Long County,2021-09-27,6,4250,22.7
13183,Long County,2021-09-28,2,4252,22.7
13183,Long County,2021-09-29,7,4259,22.8
13183,Long County,2021-09-30,16,4275,22.9
13183,Long County,2021-10-01,2,4277,22.9
13183,Long County,2021-10-02,3,4280,22.9
13183,Long County,2021-10-03,2,4282,22.9
13183,Long County,2021-10-04,3,4285,22.9
13183,Long County,2021-10-05,6,4291,23
13183,Long County,2021-10-06,4,4295,23
13183,Long County,2021-10-07,6,4301,23
13185,Lowndes County,2020-12-16,1,1,0
13185,Lowndes County,2020-12-17,9,10,0
13185,Lowndes County,2020-12-18,37,47,0
13185,Lowndes County,2020-12-19,3,50,0
13185,Lowndes County,2020-12-20,1,51,0
13185,Lowndes County,2020-12-21,87,138,0.1
13185,Lowndes County,2020-12-22,188,326,0.3
13185,Lowndes County,2020-12-23,144,470,0.4
13185,Lowndes County,2020-12-24,52,522,0.5
13185,Lowndes County,2020-12-25,2,524,0.5
13185,Lowndes County,2020-12-26,19,543,0.5
13185,Lowndes County,2020-12-27,1,544,0.5
13185,Lowndes County,2020-12-28,178,722,0.6
13185,Lowndes County,2020-12-29,137,859,0.7
13185,Lowndes County,2020-12-30,163,1022,0.9
13185,Lowndes County,2020-12-31,142,1164,1
13185,Lowndes County,2021-01-01,30,1194,1
13185,Lowndes County,2021-01-02,20,1214,1.1
13185,Lowndes County,2021-01-03,5,1219,1.1
13185,Lowndes County,2021-01-04,179,1398,1.2
13185,Lowndes County,2021-01-05,175,1573,1.4
13185,Lowndes County,2021-01-06,172,1745,1.5
13185,Lowndes County,2021-01-07,137,1882,1.6
13185,Lowndes County,2021-01-08,103,1985,1.7
13185,Lowndes County,2021-01-09,24,2009,1.7
13185,Lowndes County,2021-01-10,8,2017,1.7
13185,Lowndes County,2021-01-11,354,2371,2.1
13185,Lowndes County,2021-01-12,309,2680,2.3
13185,Lowndes County,2021-01-13,568,3248,2.8
13185,Lowndes County,2021-01-14,581,3829,3.3
13185,Lowndes County,2021-01-15,560,4389,3.8
13185,Lowndes County,2021-01-16,45,4434,3.8
13185,Lowndes County,2021-01-17,4,4438,3.8
13185,Lowndes County,2021-01-18,496,4934,4.3
13185,Lowndes County,2021-01-19,594,5528,4.8
13185,Lowndes County,2021-01-20,740,6268,5.4
13185,Lowndes County,2021-01-21,662,6930,6
13185,Lowndes County,2021-01-22,392,7322,6.3
13185,Lowndes County,2021-01-23,4,7326,6.4
13185,Lowndes County,2021-01-24,3,7329,6.4
13185,Lowndes County,2021-01-25,336,7665,6.6
13185,Lowndes County,2021-01-26,487,8152,7.1
13185,Lowndes County,2021-01-27,316,8468,7.3
13185,Lowndes County,2021-01-28,265,8733,7.6
13185,Lowndes County,2021-01-29,398,9131,7.9
13185,Lowndes County,2021-01-30,21,9152,7.9
13185,Lowndes County,2021-01-31,3,9155,7.9
13185,Lowndes County,2021-02-01,218,9373,8.1
13185,Lowndes County,2021-02-02,301,9674,8.4
13185,Lowndes County,2021-02-03,248,9922,8.6
13185,Lowndes County,2021-02-04,345,10267,8.9
13185,Lowndes County,2021-02-05,176,10443,9.1
13185,Lowndes County,2021-02-06,8,10451,9.1
13185,Lowndes County,2021-02-07,1,10452,9.1
13185,Lowndes County,2021-02-08,73,10525,9.1
13185,Lowndes County,2021-02-09,106,10631,9.2
13185,Lowndes County,2021-02-10,101,10732,9.3
13185,Lowndes County,2021-02-11,117,10849,9.4
13185,Lowndes County,2021-02-12,186,11035,9.6
13185,Lowndes County,2021-02-13,48,11083,9.6
13185,Lowndes County,2021-02-14,21,11104,9.6
13185,Lowndes County,2021-02-15,151,11255,9.8
13185,Lowndes County,2021-02-16,132,11387,9.9
13185,Lowndes County,2021-02-17,204,11591,10
13185,Lowndes County,2021-02-18,184,11775,10.2
13185,Lowndes County,2021-02-19,265,12040,10.4
13185,Lowndes County,2021-02-20,14,12054,10.4
13185,Lowndes County,2021-02-21,2,12056,10.5
13185,Lowndes County,2021-02-22,236,12292,10.7
13185,Lowndes County,2021-02-23,214,12506,10.8
13185,Lowndes County,2021-02-24,280,12786,11.1
13185,Lowndes County,2021-02-25,213,12999,11.3
13185,Lowndes County,2021-02-26,346,13345,11.6
13185,Lowndes County,2021-02-27,13,13358,11.6
13185,Lowndes County,2021-02-28,4,13362,11.6
13185,Lowndes County,2021-03-01,403,13765,11.9
13185,Lowndes County,2021-03-02,287,14052,12.2
13185,Lowndes County,2021-03-03,292,14344,12.4
13185,Lowndes County,2021-03-04,255,14599,12.7
13185,Lowndes County,2021-03-05,334,14933,12.9
13185,Lowndes County,2021-03-06,27,14960,13
13185,Lowndes County,2021-03-07,19,14979,13
13185,Lowndes County,2021-03-08,376,15355,13.3
13185,Lowndes County,2021-03-09,366,15721,13.6
13185,Lowndes County,2021-03-10,308,16029,13.9
13185,Lowndes County,2021-03-11,259,16288,14.1
13185,Lowndes County,2021-03-12,605,16893,14.6
13185,Lowndes County,2021-03-13,186,17079,14.8
13185,Lowndes County,2021-03-14,33,17112,14.8
13185,Lowndes County,2021-03-15,213,17325,15
13185,Lowndes County,2021-03-16,493,17818,15.4
13185,Lowndes County,2021-03-17,511,18329,15.9
13185,Lowndes County,2021-03-18,274,18603,16.1
13185,Lowndes County,2021-03-19,469,19072,16.5
13185,Lowndes County,2021-03-20,282,19354,16.8
13185,Lowndes County,2021-03-21,16,19370,16.8
13185,Lowndes County,2021-03-22,369,19739,17.1
13185,Lowndes County,2021-03-23,287,20026,17.4
13185,Lowndes County,2021-03-24,330,20356,17.6
13185,Lowndes County,2021-03-25,517,20873,18.1
13185,Lowndes County,2021-03-26,439,21312,18.5
13185,Lowndes County,2021-03-27,61,21373,18.5
13185,Lowndes County,2021-03-28,43,21416,18.6
13185,Lowndes County,2021-03-29,404,21820,18.9
13185,Lowndes County,2021-03-30,820,22640,19.6
13185,Lowndes County,2021-03-31,475,23115,20
13185,Lowndes County,2021-04-01,411,23526,20.4
13185,Lowndes County,2021-04-02,324,23850,20.7
13185,Lowndes County,2021-04-03,242,24092,20.9
13185,Lowndes County,2021-04-04,24,24116,20.9
13185,Lowndes County,2021-04-05,594,24710,21.4
13185,Lowndes County,2021-04-06,354,25064,21.7
13185,Lowndes County,2021-04-07,338,25402,22
13185,Lowndes County,2021-04-08,258,25660,22.2
13185,Lowndes County,2021-04-09,481,26141,22.7
13185,Lowndes County,2021-04-10,137,26278,22.8
13185,Lowndes County,2021-04-11,33,26311,22.8
13185,Lowndes County,2021-04-12,293,26604,23.1
13185,Lowndes County,2021-04-13,205,26809,23.2
13185,Lowndes County,2021-04-14,206,27015,23.4
13185,Lowndes County,2021-04-15,152,27167,23.5
13185,Lowndes County,2021-04-16,151,27318,23.7
13185,Lowndes County,2021-04-17,19,27337,23.7
13185,Lowndes County,2021-04-18,12,27349,23.7
13185,Lowndes County,2021-04-19,163,27512,23.8
13185,Lowndes County,2021-04-20,128,27640,24
13185,Lowndes County,2021-04-21,174,27814,24.1
13185,Lowndes County,2021-04-22,192,28006,24.3
13185,Lowndes County,2021-04-23,230,28236,24.5
13185,Lowndes County,2021-04-24,39,28275,24.5
13185,Lowndes County,2021-04-25,21,28296,24.5
13185,Lowndes County,2021-04-26,138,28434,24.6
13185,Lowndes County,2021-04-27,101,28535,24.7
13185,Lowndes County,2021-04-28,184,28719,24.9
13185,Lowndes County,2021-04-29,159,28878,25
13185,Lowndes County,2021-04-30,136,29014,25.1
13185,Lowndes County,2021-05-01,31,29045,25.2
13185,Lowndes County,2021-05-02,10,29055,25.2
13185,Lowndes County,2021-05-03,115,29170,25.3
13185,Lowndes County,2021-05-04,125,29295,25.4
13185,Lowndes County,2021-05-05,147,29442,25.5
13185,Lowndes County,2021-05-06,184,29626,25.7
13185,Lowndes County,2021-05-07,155,29781,25.8
13185,Lowndes County,2021-05-08,62,29843,25.9
13185,Lowndes County,2021-05-09,10,29853,25.9
13185,Lowndes County,2021-05-10,113,29966,26
13185,Lowndes County,2021-05-11,103,30069,26.1
13185,Lowndes County,2021-05-12,110,30179,26.2
13185,Lowndes County,2021-05-13,120,30299,26.3
13185,Lowndes County,2021-05-14,175,30474,26.4
13185,Lowndes County,2021-05-15,83,30557,26.5
13185,Lowndes County,2021-05-16,45,30602,26.5
13185,Lowndes County,2021-05-17,172,30774,26.7
13185,Lowndes County,2021-05-18,141,30915,26.8
13185,Lowndes County,2021-05-19,142,31057,26.9
13185,Lowndes County,2021-05-20,125,31182,27
13185,Lowndes County,2021-05-21,139,31321,27.1
13185,Lowndes County,2021-05-22,46,31367,27.2
13185,Lowndes County,2021-05-23,25,31392,27.2
13185,Lowndes County,2021-05-24,113,31505,27.3
13185,Lowndes County,2021-05-25,117,31622,27.4
13185,Lowndes County,2021-05-26,114,31736,27.5
13185,Lowndes County,2021-05-27,108,31844,27.6
13185,Lowndes County,2021-05-28,82,31926,27.7
13185,Lowndes County,2021-05-29,30,31956,27.7
13185,Lowndes County,2021-05-30,10,31966,27.7
13185,Lowndes County,2021-05-31,6,31972,27.7
13185,Lowndes County,2021-06-01,98,32070,27.8
13185,Lowndes County,2021-06-02,93,32163,27.9
13185,Lowndes County,2021-06-03,122,32285,28
13185,Lowndes County,2021-06-04,83,32368,28.1
13185,Lowndes County,2021-06-05,47,32415,28.1
13185,Lowndes County,2021-06-06,29,32444,28.1
13185,Lowndes County,2021-06-07,88,32532,28.2
13185,Lowndes County,2021-06-08,68,32600,28.3
13185,Lowndes County,2021-06-09,56,32656,28.3
13185,Lowndes County,2021-06-10,91,32747,28.4
13185,Lowndes County,2021-06-11,65,32812,28.4
13185,Lowndes County,2021-06-12,40,32852,28.5
13185,Lowndes County,2021-06-13,13,32865,28.5
13185,Lowndes County,2021-06-14,56,32921,28.5
13185,Lowndes County,2021-06-15,58,32979,28.6
13185,Lowndes County,2021-06-16,71,33050,28.6
13185,Lowndes County,2021-06-17,63,33113,28.7
13185,Lowndes County,2021-06-18,100,33213,28.8
13185,Lowndes County,2021-06-19,14,33227,28.8
13185,Lowndes County,2021-06-20,13,33240,28.8
13185,Lowndes County,2021-06-21,54,33294,28.9
13185,Lowndes County,2021-06-22,49,33343,28.9
13185,Lowndes County,2021-06-23,57,33400,29
13185,Lowndes County,2021-06-24,63,33463,29
13185,Lowndes County,2021-06-25,96,33559,29.1
13185,Lowndes County,2021-06-26,24,33583,29.1
13185,Lowndes County,2021-06-27,15,33598,29.1
13185,Lowndes County,2021-06-28,81,33679,29.2
13185,Lowndes County,2021-06-29,71,33750,29.3
13185,Lowndes County,2021-06-30,58,33808,29.3
13185,Lowndes County,2021-07-01,63,33871,29.4
13185,Lowndes County,2021-07-02,60,33931,29.4
13185,Lowndes County,2021-07-03,21,33952,29.4
13185,Lowndes County,2021-07-04,2,33954,29.4
13185,Lowndes County,2021-07-05,35,33989,29.5
13185,Lowndes County,2021-07-06,80,34069,29.5
13185,Lowndes County,2021-07-07,42,34111,29.6
13185,Lowndes County,2021-07-08,46,34157,29.6
13185,Lowndes County,2021-07-09,88,34245,29.7
13185,Lowndes County,2021-07-10,29,34274,29.7
13185,Lowndes County,2021-07-11,11,34285,29.7
13185,Lowndes County,2021-07-12,74,34359,29.8
13185,Lowndes County,2021-07-13,68,34427,29.8
13185,Lowndes County,2021-07-14,66,34493,29.9
13185,Lowndes County,2021-07-15,71,34564,30
13185,Lowndes County,2021-07-16,86,34650,30
13185,Lowndes County,2021-07-17,42,34692,30.1
13185,Lowndes County,2021-07-18,15,34707,30.1
13185,Lowndes County,2021-07-19,91,34798,30.2
13185,Lowndes County,2021-07-20,91,34889,30.2
13185,Lowndes County,2021-07-21,113,35002,30.3
13185,Lowndes County,2021-07-22,140,35142,30.5
13185,Lowndes County,2021-07-23,173,35315,30.6
13185,Lowndes County,2021-07-24,67,35382,30.7
13185,Lowndes County,2021-07-25,45,35427,30.7
13185,Lowndes County,2021-07-26,179,35606,30.9
13185,Lowndes County,2021-07-27,211,35817,31
13185,Lowndes County,2021-07-28,231,36048,31.2
13185,Lowndes County,2021-07-29,247,36295,31.5
13185,Lowndes County,2021-07-30,281,36576,31.7
13185,Lowndes County,2021-07-31,103,36679,31.8
13185,Lowndes County,2021-08-01,60,36739,31.8
13185,Lowndes County,2021-08-02,308,37047,32.1
13185,Lowndes County,2021-08-03,260,37307,32.3
13185,Lowndes County,2021-08-04,223,37530,32.5
13185,Lowndes County,2021-08-05,221,37751,32.7
13185,Lowndes County,2021-08-06,295,38046,33
13185,Lowndes County,2021-08-07,296,38342,33.2
13185,Lowndes County,2021-08-08,77,38419,33.3
13185,Lowndes County,2021-08-09,235,38654,33.5
13185,Lowndes County,2021-08-10,219,38873,33.7
13185,Lowndes County,2021-08-11,235,39108,33.9
13185,Lowndes County,2021-08-12,276,39384,34.1
13185,Lowndes County,2021-08-13,364,39748,34.5
13185,Lowndes County,2021-08-14,171,39919,34.6
13185,Lowndes County,2021-08-15,75,39994,34.7
13185,Lowndes County,2021-08-16,262,40256,34.9
13185,Lowndes County,2021-08-17,252,40508,35.1
13185,Lowndes County,2021-08-18,245,40753,35.3
13185,Lowndes County,2021-08-19,247,41000,35.5
13185,Lowndes County,2021-08-20,345,41345,35.8
13185,Lowndes County,2021-08-21,82,41427,35.9
13185,Lowndes County,2021-08-22,56,41483,36
13185,Lowndes County,2021-08-23,221,41704,36.1
13185,Lowndes County,2021-08-24,233,41937,36.4
13185,Lowndes County,2021-08-25,222,42159,36.5
13185,Lowndes County,2021-08-26,251,42410,36.8
13185,Lowndes County,2021-08-27,226,42636,37
13185,Lowndes County,2021-08-28,391,43027,37.3
13185,Lowndes County,2021-08-29,35,43062,37.3
13185,Lowndes County,2021-08-30,175,43237,37.5
13185,Lowndes County,2021-08-31,210,43447,37.7
13185,Lowndes County,2021-09-01,132,43579,37.8
13185,Lowndes County,2021-09-02,137,43716,37.9
13185,Lowndes County,2021-09-03,186,43902,38.1
13185,Lowndes County,2021-09-04,56,43958,38.1
13185,Lowndes County,2021-09-05,34,43992,38.1
13185,Lowndes County,2021-09-06,14,44006,38.1
13185,Lowndes County,2021-09-07,96,44102,38.2
13185,Lowndes County,2021-09-08,105,44207,38.3
13185,Lowndes County,2021-09-09,125,44332,38.4
13185,Lowndes County,2021-09-10,153,44485,38.6
13185,Lowndes County,2021-09-11,46,44531,38.6
13185,Lowndes County,2021-09-12,31,44562,38.6
13185,Lowndes County,2021-09-13,101,44663,38.7
13185,Lowndes County,2021-09-14,109,44772,38.8
13185,Lowndes County,2021-09-15,89,44861,38.9
13185,Lowndes County,2021-09-16,74,44935,39
13185,Lowndes County,2021-09-17,89,45024,39
13185,Lowndes County,2021-09-18,92,45116,39.1
13185,Lowndes County,2021-09-19,23,45139,39.1
13185,Lowndes County,2021-09-20,72,45211,39.2
13185,Lowndes County,2021-09-21,54,45265,39.2
13185,Lowndes County,2021-09-22,76,45341,39.3
13185,Lowndes County,2021-09-23,52,45393,39.3
13185,Lowndes County,2021-09-24,64,45457,39.4
13185,Lowndes County,2021-09-25,20,45477,39.4
13185,Lowndes County,2021-09-26,6,45483,39.4
13185,Lowndes County,2021-09-27,27,45510,39.4
13185,Lowndes County,2021-09-28,27,45537,39.5
13185,Lowndes County,2021-09-29,23,45560,39.5
13185,Lowndes County,2021-09-30,36,45596,39.5
13185,Lowndes County,2021-10-01,23,45619,39.5
13185,Lowndes County,2021-10-02,13,45632,39.6
13185,Lowndes County,2021-10-03,4,45636,39.6
13185,Lowndes County,2021-10-04,22,45658,39.6
13185,Lowndes County,2021-10-05,14,45672,39.6
13185,Lowndes County,2021-10-06,26,45698,39.6
13185,Lowndes County,2021-10-07,18,45716,39.6
13187,Lumpkin County,2020-12-15,1,1,0
13187,Lumpkin County,2020-12-17,2,3,0
13187,Lumpkin County,2020-12-18,6,9,0
13187,Lumpkin County,2020-12-19,7,16,0
13187,Lumpkin County,2020-12-20,7,23,0.1
13187,Lumpkin County,2020-12-21,15,38,0.1
13187,Lumpkin County,2020-12-22,13,51,0.2
13187,Lumpkin County,2020-12-23,36,87,0.3
13187,Lumpkin County,2020-12-24,4,91,0.3
13187,Lumpkin County,2020-12-26,6,97,0.3
13187,Lumpkin County,2020-12-27,6,103,0.3
13187,Lumpkin County,2020-12-28,38,141,0.4
13187,Lumpkin County,2020-12-29,47,188,0.6
13187,Lumpkin County,2020-12-30,20,208,0.6
13187,Lumpkin County,2020-12-31,28,236,0.7
13187,Lumpkin County,2021-01-01,14,250,0.8
13187,Lumpkin County,2021-01-02,1,251,0.8
13187,Lumpkin County,2021-01-03,3,254,0.8
13187,Lumpkin County,2021-01-04,24,278,0.9
13187,Lumpkin County,2021-01-05,38,316,1
13187,Lumpkin County,2021-01-06,30,346,1.1
13187,Lumpkin County,2021-01-07,45,391,1.2
13187,Lumpkin County,2021-01-08,25,416,1.3
13187,Lumpkin County,2021-01-09,3,419,1.3
13187,Lumpkin County,2021-01-10,24,443,1.4
13187,Lumpkin County,2021-01-11,71,514,1.6
13187,Lumpkin County,2021-01-12,43,557,1.7
13187,Lumpkin County,2021-01-13,111,668,2.1
13187,Lumpkin County,2021-01-14,109,777,2.4
13187,Lumpkin County,2021-01-15,39,816,2.5
13187,Lumpkin County,2021-01-16,39,855,2.6
13187,Lumpkin County,2021-01-17,14,869,2.7
13187,Lumpkin County,2021-01-18,151,1020,3.1
13187,Lumpkin County,2021-01-19,79,1099,3.4
13187,Lumpkin County,2021-01-20,156,1255,3.9
13187,Lumpkin County,2021-01-21,181,1436,4.4
13187,Lumpkin County,2021-01-22,54,1490,4.6
13187,Lumpkin County,2021-01-23,44,1534,4.7
13187,Lumpkin County,2021-01-24,4,1538,4.7
13187,Lumpkin County,2021-01-25,128,1666,5.1
13187,Lumpkin County,2021-01-26,72,1738,5.4
13187,Lumpkin County,2021-01-27,162,1900,5.9
13187,Lumpkin County,2021-01-28,120,2020,6.2
13187,Lumpkin County,2021-01-29,67,2087,6.4
13187,Lumpkin County,2021-01-30,488,2575,7.9
13187,Lumpkin County,2021-01-31,34,2609,8.1
13187,Lumpkin County,2021-02-01,101,2710,8.4
13187,Lumpkin County,2021-02-02,64,2774,8.6
13187,Lumpkin County,2021-02-03,114,2888,8.9
13187,Lumpkin County,2021-02-04,114,3002,9.3
13187,Lumpkin County,2021-02-05,21,3023,9.3
13187,Lumpkin County,2021-02-06,20,3043,9.4
13187,Lumpkin County,2021-02-07,21,3064,9.5
13187,Lumpkin County,2021-02-08,68,3132,9.7
13187,Lumpkin County,2021-02-09,83,3215,9.9
13187,Lumpkin County,2021-02-10,79,3294,10.2
13187,Lumpkin County,2021-02-11,101,3395,10.5
13187,Lumpkin County,2021-02-12,25,3420,10.6
13187,Lumpkin County,2021-02-13,23,3443,10.6
13187,Lumpkin County,2021-02-14,7,3450,10.6
13187,Lumpkin County,2021-02-15,52,3502,10.8
13187,Lumpkin County,2021-02-16,37,3539,10.9
13187,Lumpkin County,2021-02-17,44,3583,11.1
13187,Lumpkin County,2021-02-18,34,3617,11.2
13187,Lumpkin County,2021-02-19,13,3630,11.2
13187,Lumpkin County,2021-02-20,8,3638,11.2
13187,Lumpkin County,2021-02-21,11,3649,11.3
13187,Lumpkin County,2021-02-22,20,3669,11.3
13187,Lumpkin County,2021-02-23,82,3751,11.6
13187,Lumpkin County,2021-02-24,53,3804,11.7
13187,Lumpkin County,2021-02-25,85,3889,12
13187,Lumpkin County,2021-02-26,39,3928,12.1
13187,Lumpkin County,2021-02-27,7,3935,12.1
13187,Lumpkin County,2021-02-28,32,3967,12.2
13187,Lumpkin County,2021-03-01,83,4050,12.5
13187,Lumpkin County,2021-03-02,68,4118,12.7
13187,Lumpkin County,2021-03-03,60,4178,12.9
13187,Lumpkin County,2021-03-04,118,4296,13.3
13187,Lumpkin County,2021-03-05,65,4361,13.5
13187,Lumpkin County,2021-03-06,15,4376,13.5
13187,Lumpkin County,2021-03-07,18,4394,13.6
13187,Lumpkin County,2021-03-08,76,4470,13.8
13187,Lumpkin County,2021-03-09,96,4566,14.1
13187,Lumpkin County,2021-03-10,109,4675,14.4
13187,Lumpkin County,2021-03-11,132,4807,14.8
13187,Lumpkin County,2021-03-12,219,5026,15.5
13187,Lumpkin County,2021-03-13,54,5080,15.7
13187,Lumpkin County,2021-03-14,37,5117,15.8
13187,Lumpkin County,2021-03-15,190,5307,16.4
13187,Lumpkin County,2021-03-16,154,5461,16.9
13187,Lumpkin County,2021-03-17,154,5615,17.3
13187,Lumpkin County,2021-03-18,163,5778,17.8
13187,Lumpkin County,2021-03-19,101,5879,18.1
13187,Lumpkin County,2021-03-20,21,5900,18.2
13187,Lumpkin County,2021-03-21,49,5949,18.4
13187,Lumpkin County,2021-03-22,110,6059,18.7
13187,Lumpkin County,2021-03-23,137,6196,19.1
13187,Lumpkin County,2021-03-24,129,6325,19.5
13187,Lumpkin County,2021-03-25,122,6447,19.9
13187,Lumpkin County,2021-03-26,92,6539,20.2
13187,Lumpkin County,2021-03-27,75,6614,20.4
13187,Lumpkin County,2021-03-28,14,6628,20.5
13187,Lumpkin County,2021-03-29,149,6777,20.9
13187,Lumpkin County,2021-03-30,150,6927,21.4
13187,Lumpkin County,2021-03-31,154,7081,21.9
13187,Lumpkin County,2021-04-01,169,7250,22.4
13187,Lumpkin County,2021-04-02,60,7310,22.6
13187,Lumpkin County,2021-04-03,22,7332,22.6
13187,Lumpkin County,2021-04-04,20,7352,22.7
13187,Lumpkin County,2021-04-05,116,7468,23
13187,Lumpkin County,2021-04-06,107,7575,23.4
13187,Lumpkin County,2021-04-07,114,7689,23.7
13187,Lumpkin County,2021-04-08,136,7825,24.1
13187,Lumpkin County,2021-04-09,91,7916,24.4
13187,Lumpkin County,2021-04-10,17,7933,24.5
13187,Lumpkin County,2021-04-11,20,7953,24.5
13187,Lumpkin County,2021-04-12,57,8010,24.7
13187,Lumpkin County,2021-04-13,67,8077,24.9
13187,Lumpkin County,2021-04-14,45,8122,25.1
13187,Lumpkin County,2021-04-15,69,8191,25.3
13187,Lumpkin County,2021-04-16,45,8236,25.4
13187,Lumpkin County,2021-04-17,46,8282,25.6
13187,Lumpkin County,2021-04-18,8,8290,25.6
13187,Lumpkin County,2021-04-19,31,8321,25.7
13187,Lumpkin County,2021-04-20,35,8356,25.8
13187,Lumpkin County,2021-04-21,55,8411,26
13187,Lumpkin County,2021-04-22,65,8476,26.2
13187,Lumpkin County,2021-04-23,34,8510,26.3
13187,Lumpkin County,2021-04-24,19,8529,26.3
13187,Lumpkin County,2021-04-25,16,8545,26.4
13187,Lumpkin County,2021-04-26,46,8591,26.5
13187,Lumpkin County,2021-04-27,40,8631,26.6
13187,Lumpkin County,2021-04-28,31,8662,26.7
13187,Lumpkin County,2021-04-29,51,8713,26.9
13187,Lumpkin County,2021-04-30,48,8761,27
13187,Lumpkin County,2021-05-01,15,8776,27.1
13187,Lumpkin County,2021-05-02,11,8787,27.1
13187,Lumpkin County,2021-05-03,35,8822,27.2
13187,Lumpkin County,2021-05-04,71,8893,27.4
13187,Lumpkin County,2021-05-05,39,8932,27.6
13187,Lumpkin County,2021-05-06,38,8970,27.7
13187,Lumpkin County,2021-05-07,27,8997,27.8
13187,Lumpkin County,2021-05-08,11,9008,27.8
13187,Lumpkin County,2021-05-09,7,9015,27.8
13187,Lumpkin County,2021-05-10,37,9052,27.9
13187,Lumpkin County,2021-05-11,31,9083,28
13187,Lumpkin County,2021-05-12,34,9117,28.1
13187,Lumpkin County,2021-05-13,39,9156,28.3
13187,Lumpkin County,2021-05-14,39,9195,28.4
13187,Lumpkin County,2021-05-15,28,9223,28.5
13187,Lumpkin County,2021-05-16,20,9243,28.5
13187,Lumpkin County,2021-05-17,44,9287,28.7
13187,Lumpkin County,2021-05-18,43,9330,28.8
13187,Lumpkin County,2021-05-19,32,9362,28.9
13187,Lumpkin County,2021-05-20,29,9391,29
13187,Lumpkin County,2021-05-21,29,9420,29.1
13187,Lumpkin County,2021-05-22,19,9439,29.1
13187,Lumpkin County,2021-05-23,20,9459,29.2
13187,Lumpkin County,2021-05-24,27,9486,29.3
13187,Lumpkin County,2021-05-25,32,9518,29.4
13187,Lumpkin County,2021-05-26,32,9550,29.5
13187,Lumpkin County,2021-05-27,22,9572,29.5
13187,Lumpkin County,2021-05-28,23,9595,29.6
13187,Lumpkin County,2021-05-29,13,9608,29.7
13187,Lumpkin County,2021-05-30,3,9611,29.7
13187,Lumpkin County,2021-05-31,5,9616,29.7
13187,Lumpkin County,2021-06-01,16,9632,29.7
13187,Lumpkin County,2021-06-02,23,9655,29.8
13187,Lumpkin County,2021-06-03,22,9677,29.9
13187,Lumpkin County,2021-06-04,17,9694,29.9
13187,Lumpkin County,2021-06-05,7,9701,29.9
13187,Lumpkin County,2021-06-06,4,9705,30
13187,Lumpkin County,2021-06-07,18,9723,30
13187,Lumpkin County,2021-06-08,15,9738,30.1
13187,Lumpkin County,2021-06-09,25,9763,30.1
13187,Lumpkin County,2021-06-10,12,9775,30.2
13187,Lumpkin County,2021-06-11,22,9797,30.2
13187,Lumpkin County,2021-06-12,4,9801,30.2
13187,Lumpkin County,2021-06-13,7,9808,30.3
13187,Lumpkin County,2021-06-14,19,9827,30.3
13187,Lumpkin County,2021-06-15,11,9838,30.4
13187,Lumpkin County,2021-06-16,15,9853,30.4
13187,Lumpkin County,2021-06-17,16,9869,30.5
13187,Lumpkin County,2021-06-18,8,9877,30.5
13187,Lumpkin County,2021-06-19,8,9885,30.5
13187,Lumpkin County,2021-06-20,8,9893,30.5
13187,Lumpkin County,2021-06-21,20,9913,30.6
13187,Lumpkin County,2021-06-22,11,9924,30.6
13187,Lumpkin County,2021-06-23,12,9936,30.7
13187,Lumpkin County,2021-06-24,18,9954,30.7
13187,Lumpkin County,2021-06-25,15,9969,30.8
13187,Lumpkin County,2021-06-26,11,9980,30.8
13187,Lumpkin County,2021-06-27,2,9982,30.8
13187,Lumpkin County,2021-06-28,9,9991,30.8
13187,Lumpkin County,2021-06-29,16,10007,30.9
13187,Lumpkin County,2021-06-30,17,10024,30.9
13187,Lumpkin County,2021-07-01,10,10034,31
13187,Lumpkin County,2021-07-02,10,10044,31
13187,Lumpkin County,2021-07-03,11,10055,31
13187,Lumpkin County,2021-07-05,4,10059,31
13187,Lumpkin County,2021-07-06,14,10073,31.1
13187,Lumpkin County,2021-07-07,11,10084,31.1
13187,Lumpkin County,2021-07-08,22,10106,31.2
13187,Lumpkin County,2021-07-09,9,10115,31.2
13187,Lumpkin County,2021-07-10,10,10125,31.2
13187,Lumpkin County,2021-07-11,6,10131,31.3
13187,Lumpkin County,2021-07-12,20,10151,31.3
13187,Lumpkin County,2021-07-13,4,10155,31.3
13187,Lumpkin County,2021-07-14,18,10173,31.4
13187,Lumpkin County,2021-07-15,18,10191,31.5
13187,Lumpkin County,2021-07-16,16,10207,31.5
13187,Lumpkin County,2021-07-17,11,10218,31.5
13187,Lumpkin County,2021-07-18,3,10221,31.5
13187,Lumpkin County,2021-07-19,22,10243,31.6
13187,Lumpkin County,2021-07-20,24,10267,31.7
13187,Lumpkin County,2021-07-21,23,10290,31.8
13187,Lumpkin County,2021-07-22,25,10315,31.8
13187,Lumpkin County,2021-07-23,25,10340,31.9
13187,Lumpkin County,2021-07-24,13,10353,32
13187,Lumpkin County,2021-07-25,9,10362,32
13187,Lumpkin County,2021-07-26,35,10397,32.1
13187,Lumpkin County,2021-07-27,29,10426,32.2
13187,Lumpkin County,2021-07-28,46,10472,32.3
13187,Lumpkin County,2021-07-29,56,10528,32.5
13187,Lumpkin County,2021-07-30,37,10565,32.6
13187,Lumpkin County,2021-07-31,12,10577,32.6
13187,Lumpkin County,2021-08-01,16,10593,32.7
13187,Lumpkin County,2021-08-02,33,10626,32.8
13187,Lumpkin County,2021-08-03,29,10655,32.9
13187,Lumpkin County,2021-08-04,46,10701,33
13187,Lumpkin County,2021-08-05,61,10762,33.2
13187,Lumpkin County,2021-08-06,47,10809,33.4
13187,Lumpkin County,2021-08-07,26,10835,33.4
13187,Lumpkin County,2021-08-08,16,10851,33.5
13187,Lumpkin County,2021-08-09,42,10893,33.6
13187,Lumpkin County,2021-08-10,43,10936,33.8
13187,Lumpkin County,2021-08-11,44,10980,33.9
13187,Lumpkin County,2021-08-12,54,11034,34.1
13187,Lumpkin County,2021-08-13,46,11080,34.2
13187,Lumpkin County,2021-08-14,22,11102,34.3
13187,Lumpkin County,2021-08-15,26,11128,34.3
13187,Lumpkin County,2021-08-16,42,11170,34.5
13187,Lumpkin County,2021-08-17,61,11231,34.7
13187,Lumpkin County,2021-08-18,59,11290,34.8
13187,Lumpkin County,2021-08-19,30,11320,34.9
13187,Lumpkin County,2021-08-20,50,11370,35.1
13187,Lumpkin County,2021-08-21,25,11395,35.2
13187,Lumpkin County,2021-08-22,29,11424,35.3
13187,Lumpkin County,2021-08-23,47,11471,35.4
13187,Lumpkin County,2021-08-24,53,11524,35.6
13187,Lumpkin County,2021-08-25,52,11576,35.7
13187,Lumpkin County,2021-08-26,65,11641,35.9
13187,Lumpkin County,2021-08-27,61,11702,36.1
13187,Lumpkin County,2021-08-28,25,11727,36.2
13187,Lumpkin County,2021-08-29,13,11740,36.2
13187,Lumpkin County,2021-08-30,49,11789,36.4
13187,Lumpkin County,2021-08-31,38,11827,36.5
13187,Lumpkin County,2021-09-01,41,11868,36.6
13187,Lumpkin County,2021-09-02,58,11926,36.8
13187,Lumpkin County,2021-09-03,45,11971,36.9
13187,Lumpkin County,2021-09-04,26,11997,37
13187,Lumpkin County,2021-09-05,21,12018,37.1
13187,Lumpkin County,2021-09-06,6,12024,37.1
13187,Lumpkin County,2021-09-07,24,12048,37.2
13187,Lumpkin County,2021-09-08,35,12083,37.3
13187,Lumpkin County,2021-09-09,44,12127,37.4
13187,Lumpkin County,2021-09-10,43,12170,37.6
13187,Lumpkin County,2021-09-11,12,12182,37.6
13187,Lumpkin County,2021-09-12,8,12190,37.6
13187,Lumpkin County,2021-09-13,18,12208,37.7
13187,Lumpkin County,2021-09-14,31,12239,37.8
13187,Lumpkin County,2021-09-15,31,12270,37.9
13187,Lumpkin County,2021-09-16,34,12304,38
13187,Lumpkin County,2021-09-17,30,12334,38.1
13187,Lumpkin County,2021-09-18,23,12357,38.1
13187,Lumpkin County,2021-09-19,9,12366,38.2
13187,Lumpkin County,2021-09-20,15,12381,38.2
13187,Lumpkin County,2021-09-21,16,12397,38.3
13187,Lumpkin County,2021-09-22,20,12417,38.3
13187,Lumpkin County,2021-09-23,16,12433,38.4
13187,Lumpkin County,2021-09-24,15,12448,38.4
13187,Lumpkin County,2021-09-25,7,12455,38.4
13187,Lumpkin County,2021-09-26,3,12458,38.4
13187,Lumpkin County,2021-09-27,7,12465,38.5
13187,Lumpkin County,2021-09-28,8,12473,38.5
13187,Lumpkin County,2021-09-29,19,12492,38.6
13187,Lumpkin County,2021-09-30,11,12503,38.6
13187,Lumpkin County,2021-10-01,8,12511,38.6
13187,Lumpkin County,2021-10-03,5,12516,38.6
13187,Lumpkin County,2021-10-04,7,12523,38.6
13187,Lumpkin County,2021-10-05,4,12527,38.7
13187,Lumpkin County,2021-10-06,13,12540,38.7
13187,Lumpkin County,2021-10-07,6,12546,38.7
13189,McDuffie County,2020-12-16,1,1,0
13189,McDuffie County,2020-12-18,3,4,0
13189,McDuffie County,2020-12-19,4,8,0
13189,McDuffie County,2020-12-20,1,9,0
13189,McDuffie County,2020-12-21,1,10,0
13189,McDuffie County,2020-12-22,25,35,0.2
13189,McDuffie County,2020-12-23,36,71,0.3
13189,McDuffie County,2020-12-24,10,81,0.4
13189,McDuffie County,2020-12-26,1,82,0.4
13189,McDuffie County,2020-12-27,1,83,0.4
13189,McDuffie County,2020-12-28,35,118,0.5
13189,McDuffie County,2020-12-29,30,148,0.7
13189,McDuffie County,2020-12-30,32,180,0.8
13189,McDuffie County,2020-12-31,9,189,0.9
13189,McDuffie County,2021-01-02,58,247,1.2
13189,McDuffie County,2021-01-03,2,249,1.2
13189,McDuffie County,2021-01-04,59,308,1.4
13189,McDuffie County,2021-01-05,31,339,1.6
13189,McDuffie County,2021-01-06,50,389,1.8
13189,McDuffie County,2021-01-07,32,421,2
13189,McDuffie County,2021-01-08,22,443,2.1
13189,McDuffie County,2021-01-09,19,462,2.2
13189,McDuffie County,2021-01-10,8,470,2.2
13189,McDuffie County,2021-01-11,87,557,2.6
13189,McDuffie County,2021-01-12,17,574,2.7
13189,McDuffie County,2021-01-13,51,625,2.9
13189,McDuffie County,2021-01-14,231,856,4
13189,McDuffie County,2021-01-15,14,870,4.1
13189,McDuffie County,2021-01-16,62,932,4.3
13189,McDuffie County,2021-01-17,1,933,4.3
13189,McDuffie County,2021-01-18,52,985,4.6
13189,McDuffie County,2021-01-19,47,1032,4.8
13189,McDuffie County,2021-01-20,150,1182,5.5
13189,McDuffie County,2021-01-21,49,1231,5.7
13189,McDuffie County,2021-01-22,94,1325,6.2
13189,McDuffie County,2021-01-23,51,1376,6.4
13189,McDuffie County,2021-01-24,3,1379,6.4
13189,McDuffie County,2021-01-25,53,1432,6.7
13189,McDuffie County,2021-01-26,280,1712,8
13189,McDuffie County,2021-01-27,45,1757,8.2
13189,McDuffie County,2021-01-28,53,1810,8.4
13189,McDuffie County,2021-01-29,15,1825,8.5
13189,McDuffie County,2021-01-30,14,1839,8.6
13189,McDuffie County,2021-01-31,2,1841,8.6
13189,McDuffie County,2021-02-01,38,1879,8.8
13189,McDuffie County,2021-02-02,28,1907,8.9
13189,McDuffie County,2021-02-03,31,1938,9
13189,McDuffie County,2021-02-04,31,1969,9.2
13189,McDuffie County,2021-02-05,25,1994,9.3
13189,McDuffie County,2021-02-06,3,1997,9.3
13189,McDuffie County,2021-02-08,38,2035,9.5
13189,McDuffie County,2021-02-09,235,2270,10.6
13189,McDuffie County,2021-02-10,28,2298,10.7
13189,McDuffie County,2021-02-11,29,2327,10.8
13189,McDuffie County,2021-02-12,48,2375,11.1
13189,McDuffie County,2021-02-13,20,2395,11.2
13189,McDuffie County,2021-02-14,7,2402,11.2
13189,McDuffie County,2021-02-15,20,2422,11.3
13189,McDuffie County,2021-02-16,41,2463,11.5
13189,McDuffie County,2021-02-17,56,2519,11.7
13189,McDuffie County,2021-02-18,23,2542,11.8
13189,McDuffie County,2021-02-19,11,2553,11.9
13189,McDuffie County,2021-02-20,4,2557,11.9
13189,McDuffie County,2021-02-21,2,2559,11.9
13189,McDuffie County,2021-02-22,11,2570,12
13189,McDuffie County,2021-02-23,4,2574,12
13189,McDuffie County,2021-02-24,5,2579,12
13189,McDuffie County,2021-02-25,32,2611,12.2
13189,McDuffie County,2021-02-26,10,2621,12.2
13189,McDuffie County,2021-02-27,8,2629,12.3
13189,McDuffie County,2021-02-28,1,2630,12.3
13189,McDuffie County,2021-03-01,27,2657,12.4
13189,McDuffie County,2021-03-02,55,2712,12.6
13189,McDuffie County,2021-03-03,47,2759,12.9
13189,McDuffie County,2021-03-04,71,2830,13.2
13189,McDuffie County,2021-03-05,17,2847,13.3
13189,McDuffie County,2021-03-06,8,2855,13.3
13189,McDuffie County,2021-03-07,12,2867,13.4
13189,McDuffie County,2021-03-08,48,2915,13.6
13189,McDuffie County,2021-03-09,57,2972,13.9
13189,McDuffie County,2021-03-10,58,3030,14.1
13189,McDuffie County,2021-03-11,147,3177,14.8
13189,McDuffie County,2021-03-12,100,3277,15.3
13189,McDuffie County,2021-03-13,38,3315,15.5
13189,McDuffie County,2021-03-14,1,3316,15.5
13189,McDuffie County,2021-03-15,82,3398,15.8
13189,McDuffie County,2021-03-16,126,3524,16.4
13189,McDuffie County,2021-03-17,110,3634,16.9
13189,McDuffie County,2021-03-18,62,3696,17.2
13189,McDuffie County,2021-03-19,73,3769,17.6
13189,McDuffie County,2021-03-20,13,3782,17.6
13189,McDuffie County,2021-03-21,11,3793,17.7
13189,McDuffie County,2021-03-22,147,3940,18.4
13189,McDuffie County,2021-03-23,176,4116,19.2
13189,McDuffie County,2021-03-24,75,4191,19.5
13189,McDuffie County,2021-03-25,155,4346,20.3
13189,McDuffie County,2021-03-26,47,4393,20.5
13189,McDuffie County,2021-03-27,39,4432,20.7
13189,McDuffie County,2021-03-28,12,4444,20.7
13189,McDuffie County,2021-03-29,87,4531,21.1
13189,McDuffie County,2021-03-30,176,4707,21.9
13189,McDuffie County,2021-03-31,97,4804,22.4
13189,McDuffie County,2021-04-01,129,4933,23
13189,McDuffie County,2021-04-02,49,4982,23.2
13189,McDuffie County,2021-04-03,12,4994,23.3
13189,McDuffie County,2021-04-04,21,5015,23.4
13189,McDuffie County,2021-04-05,66,5081,23.7
13189,McDuffie County,2021-04-06,140,5221,24.3
13189,McDuffie County,2021-04-07,89,5310,24.7
13189,McDuffie County,2021-04-08,91,5401,25.2
13189,McDuffie County,2021-04-09,54,5455,25.4
13189,McDuffie County,2021-04-10,21,5476,25.5
13189,McDuffie County,2021-04-11,18,5494,25.6
13189,McDuffie County,2021-04-12,89,5583,26
13189,McDuffie County,2021-04-13,83,5666,26.4
13189,McDuffie County,2021-04-14,70,5736,26.7
13189,McDuffie County,2021-04-15,50,5786,27
13189,McDuffie County,2021-04-16,27,5813,27.1
13189,McDuffie County,2021-04-17,7,5820,27.1
13189,McDuffie County,2021-04-18,8,5828,27.2
13189,McDuffie County,2021-04-19,42,5870,27.4
13189,McDuffie County,2021-04-20,55,5925,27.6
13189,McDuffie County,2021-04-21,65,5990,27.9
13189,McDuffie County,2021-04-22,70,6060,28.2
13189,McDuffie County,2021-04-23,37,6097,28.4
13189,McDuffie County,2021-04-24,13,6110,28.5
13189,McDuffie County,2021-04-25,8,6118,28.5
13189,McDuffie County,2021-04-26,31,6149,28.7
13189,McDuffie County,2021-04-27,45,6194,28.9
13189,McDuffie County,2021-04-28,50,6244,29.1
13189,McDuffie County,2021-04-29,39,6283,29.3
13189,McDuffie County,2021-04-30,31,6314,29.4
13189,McDuffie County,2021-05-01,18,6332,29.5
13189,McDuffie County,2021-05-02,7,6339,29.5
13189,McDuffie County,2021-05-03,31,6370,29.7
13189,McDuffie County,2021-05-04,40,6410,29.9
13189,McDuffie County,2021-05-05,29,6439,30
13189,McDuffie County,2021-05-06,59,6498,30.3
13189,McDuffie County,2021-05-07,26,6524,30.4
13189,McDuffie County,2021-05-08,11,6535,30.5
13189,McDuffie County,2021-05-09,4,6539,30.5
13189,McDuffie County,2021-05-10,19,6558,30.6
13189,McDuffie County,2021-05-11,36,6594,30.7
13189,McDuffie County,2021-05-12,24,6618,30.8
13189,McDuffie County,2021-05-13,45,6663,31.1
13189,McDuffie County,2021-05-14,35,6698,31.2
13189,McDuffie County,2021-05-15,17,6715,31.3
13189,McDuffie County,2021-05-16,15,6730,31.4
13189,McDuffie County,2021-05-17,34,6764,31.5
13189,McDuffie County,2021-05-18,37,6801,31.7
13189,McDuffie County,2021-05-19,49,6850,31.9
13189,McDuffie County,2021-05-20,44,6894,32.1
13189,McDuffie County,2021-05-21,20,6914,32.2
13189,McDuffie County,2021-05-22,22,6936,32.3
13189,McDuffie County,2021-05-23,7,6943,32.4
13189,McDuffie County,2021-05-24,18,6961,32.4
13189,McDuffie County,2021-05-25,32,6993,32.6
13189,McDuffie County,2021-05-26,24,7017,32.7
13189,McDuffie County,2021-05-27,25,7042,32.8
13189,McDuffie County,2021-05-28,20,7062,32.9
13189,McDuffie County,2021-05-29,15,7077,33
13189,McDuffie County,2021-05-30,13,7090,33
13189,McDuffie County,2021-05-31,4,7094,33.1
13189,McDuffie County,2021-06-01,25,7119,33.2
13189,McDuffie County,2021-06-02,23,7142,33.3
13189,McDuffie County,2021-06-03,37,7179,33.5
13189,McDuffie County,2021-06-04,16,7195,33.5
13189,McDuffie County,2021-06-05,8,7203,33.6
13189,McDuffie County,2021-06-06,10,7213,33.6
13189,McDuffie County,2021-06-07,20,7233,33.7
13189,McDuffie County,2021-06-08,19,7252,33.8
13189,McDuffie County,2021-06-09,27,7279,33.9
13189,McDuffie County,2021-06-10,14,7293,34
13189,McDuffie County,2021-06-11,17,7310,34.1
13189,McDuffie County,2021-06-12,11,7321,34.1
13189,McDuffie County,2021-06-13,6,7327,34.2
13189,McDuffie County,2021-06-14,17,7344,34.2
13189,McDuffie County,2021-06-15,19,7363,34.3
13189,McDuffie County,2021-06-16,8,7371,34.4
13189,McDuffie County,2021-06-17,17,7388,34.4
13189,McDuffie County,2021-06-18,12,7400,34.5
13189,McDuffie County,2021-06-19,11,7411,34.5
13189,McDuffie County,2021-06-20,4,7415,34.6
13189,McDuffie County,2021-06-21,15,7430,34.6
13189,McDuffie County,2021-06-22,11,7441,34.7
13189,McDuffie County,2021-06-23,18,7459,34.8
13189,McDuffie County,2021-06-24,24,7483,34.9
13189,McDuffie County,2021-06-25,21,7504,35
13189,McDuffie County,2021-06-26,5,7509,35
13189,McDuffie County,2021-06-27,3,7512,35
13189,McDuffie County,2021-06-28,17,7529,35.1
13189,McDuffie County,2021-06-29,16,7545,35.2
13189,McDuffie County,2021-06-30,22,7567,35.3
13189,McDuffie County,2021-07-01,20,7587,35.4
13189,McDuffie County,2021-07-02,19,7606,35.5
13189,McDuffie County,2021-07-03,6,7612,35.5
13189,McDuffie County,2021-07-04,2,7614,35.5
13189,McDuffie County,2021-07-05,12,7626,35.5
13189,McDuffie County,2021-07-06,13,7639,35.6
13189,McDuffie County,2021-07-07,15,7654,35.7
13189,McDuffie County,2021-07-08,21,7675,35.8
13189,McDuffie County,2021-07-09,16,7691,35.8
13189,McDuffie County,2021-07-10,9,7700,35.9
13189,McDuffie County,2021-07-11,4,7704,35.9
13189,McDuffie County,2021-07-12,23,7727,36
13189,McDuffie County,2021-07-13,18,7745,36.1
13189,McDuffie County,2021-07-14,11,7756,36.2
13189,McDuffie County,2021-07-15,13,7769,36.2
13189,McDuffie County,2021-07-16,17,7786,36.3
13189,McDuffie County,2021-07-17,10,7796,36.3
13189,McDuffie County,2021-07-18,9,7805,36.4
13189,McDuffie County,2021-07-19,18,7823,36.5
13189,McDuffie County,2021-07-20,22,7845,36.6
13189,McDuffie County,2021-07-21,13,7858,36.6
13189,McDuffie County,2021-07-22,28,7886,36.8
13189,McDuffie County,2021-07-23,34,7920,36.9
13189,McDuffie County,2021-07-24,18,7938,37
13189,McDuffie County,2021-07-25,10,7948,37
13189,McDuffie County,2021-07-26,25,7973,37.2
13189,McDuffie County,2021-07-27,37,8010,37.3
13189,McDuffie County,2021-07-28,67,8077,37.6
13189,McDuffie County,2021-07-29,53,8130,37.9
13189,McDuffie County,2021-07-30,45,8175,38.1
13189,McDuffie County,2021-07-31,37,8212,38.3
13189,McDuffie County,2021-08-01,12,8224,38.3
13189,McDuffie County,2021-08-02,40,8264,38.5
13189,McDuffie County,2021-08-03,62,8326,38.8
13189,McDuffie County,2021-08-04,50,8376,39
13189,McDuffie County,2021-08-05,41,8417,39.2
13189,McDuffie County,2021-08-06,52,8469,39.5
13189,McDuffie County,2021-08-07,24,8493,39.6
13189,McDuffie County,2021-08-08,25,8518,39.7
13189,McDuffie County,2021-08-09,51,8569,39.9
13189,McDuffie County,2021-08-10,44,8613,40.1
13189,McDuffie County,2021-08-11,40,8653,40.3
13189,McDuffie County,2021-08-12,48,8701,40.6
13189,McDuffie County,2021-08-13,38,8739,40.7
13189,McDuffie County,2021-08-14,28,8767,40.9
13189,McDuffie County,2021-08-15,23,8790,41
13189,McDuffie County,2021-08-16,48,8838,41.2
13189,McDuffie County,2021-08-17,49,8887,41.4
13189,McDuffie County,2021-08-18,39,8926,41.6
13189,McDuffie County,2021-08-19,39,8965,41.8
13189,McDuffie County,2021-08-20,37,9002,42
13189,McDuffie County,2021-08-21,26,9028,42.1
13189,McDuffie County,2021-08-22,6,9034,42.1
13189,McDuffie County,2021-08-23,42,9076,42.3
13189,McDuffie County,2021-08-24,55,9131,42.6
13189,McDuffie County,2021-08-25,47,9178,42.8
13189,McDuffie County,2021-08-26,38,9216,43
13189,McDuffie County,2021-08-27,38,9254,43.1
13189,McDuffie County,2021-08-28,24,9278,43.2
13189,McDuffie County,2021-08-29,7,9285,43.3
13189,McDuffie County,2021-08-30,37,9322,43.4
13189,McDuffie County,2021-08-31,50,9372,43.7
13189,McDuffie County,2021-09-01,28,9400,43.8
13189,McDuffie County,2021-09-02,32,9432,44
13189,McDuffie County,2021-09-03,53,9485,44.2
13189,McDuffie County,2021-09-04,19,9504,44.3
13189,McDuffie County,2021-09-05,19,9523,44.4
13189,McDuffie County,2021-09-06,5,9528,44.4
13189,McDuffie County,2021-09-07,35,9563,44.6
13189,McDuffie County,2021-09-08,15,9578,44.6
13189,McDuffie County,2021-09-09,31,9609,44.8
13189,McDuffie County,2021-09-10,30,9639,44.9
13189,McDuffie County,2021-09-11,23,9662,45
13189,McDuffie County,2021-09-12,11,9673,45.1
13189,McDuffie County,2021-09-13,24,9697,45.2
13189,McDuffie County,2021-09-14,34,9731,45.4
13189,McDuffie County,2021-09-15,29,9760,45.5
13189,McDuffie County,2021-09-16,25,9785,45.6
13189,McDuffie County,2021-09-17,21,9806,45.7
13189,McDuffie County,2021-09-18,15,9821,45.8
13189,McDuffie County,2021-09-19,8,9829,45.8
13189,McDuffie County,2021-09-20,20,9849,45.9
13189,McDuffie County,2021-09-21,21,9870,46
13189,McDuffie County,2021-09-22,20,9890,46.1
13189,McDuffie County,2021-09-23,14,9904,46.2
13189,McDuffie County,2021-09-24,12,9916,46.2
13189,McDuffie County,2021-09-25,12,9928,46.3
13189,McDuffie County,2021-09-26,9,9937,46.3
13189,McDuffie County,2021-09-27,10,9947,46.4
13189,McDuffie County,2021-09-28,21,9968,46.5
13189,McDuffie County,2021-09-29,10,9978,46.5
13189,McDuffie County,2021-09-30,5,9983,46.5
13189,McDuffie County,2021-10-01,10,9993,46.6
13189,McDuffie County,2021-10-02,1,9994,46.6
13189,McDuffie County,2021-10-03,7,10001,46.6
13189,McDuffie County,2021-10-04,2,10003,46.6
13189,McDuffie County,2021-10-05,5,10008,46.6
13189,McDuffie County,2021-10-06,13,10021,46.7
13189,McDuffie County,2021-10-07,10,10031,46.8
13191,McIntosh County,2020-12-16,1,1,0
13191,McIntosh County,2020-12-17,8,9,0.1
13191,McIntosh County,2020-12-18,12,21,0.1
13191,McIntosh County,2020-12-21,3,24,0.2
13191,McIntosh County,2020-12-22,7,31,0.2
13191,McIntosh County,2020-12-23,12,43,0.3
13191,McIntosh County,2020-12-28,3,46,0.3
13191,McIntosh County,2020-12-29,6,52,0.4
13191,McIntosh County,2020-12-30,12,64,0.5
13191,McIntosh County,2020-12-31,6,70,0.5
13191,McIntosh County,2021-01-03,1,71,0.5
13191,McIntosh County,2021-01-04,7,78,0.6
13191,McIntosh County,2021-01-05,24,102,0.7
13191,McIntosh County,2021-01-06,13,115,0.8
13191,McIntosh County,2021-01-07,7,122,0.9
13191,McIntosh County,2021-01-08,18,140,1
13191,McIntosh County,2021-01-09,4,144,1
13191,McIntosh County,2021-01-10,1,145,1
13191,McIntosh County,2021-01-11,50,195,1.4
13191,McIntosh County,2021-01-12,39,234,1.7
13191,McIntosh County,2021-01-13,26,260,1.8
13191,McIntosh County,2021-01-14,113,373,2.6
13191,McIntosh County,2021-01-15,24,397,2.8
13191,McIntosh County,2021-01-16,40,437,3.1
13191,McIntosh County,2021-01-17,2,439,3.1
13191,McIntosh County,2021-01-18,110,549,3.9
13191,McIntosh County,2021-01-19,38,587,4.1
13191,McIntosh County,2021-01-20,46,633,4.5
13191,McIntosh County,2021-01-21,145,778,5.5
13191,McIntosh County,2021-01-22,57,835,5.9
13191,McIntosh County,2021-01-23,18,853,6
13191,McIntosh County,2021-01-24,8,861,6.1
13191,McIntosh County,2021-01-25,96,957,6.8
13191,McIntosh County,2021-01-26,39,996,7
13191,McIntosh County,2021-01-27,20,1016,7.2
13191,McIntosh County,2021-01-28,134,1150,8.1
13191,McIntosh County,2021-01-29,44,1194,8.4
13191,McIntosh County,2021-01-30,45,1239,8.7
13191,McIntosh County,2021-01-31,4,1243,8.8
13191,McIntosh County,2021-02-01,64,1307,9.2
13191,McIntosh County,2021-02-02,63,1370,9.7
13191,McIntosh County,2021-02-03,18,1388,9.8
13191,McIntosh County,2021-02-04,91,1479,10.4
13191,McIntosh County,2021-02-05,13,1492,10.5
13191,McIntosh County,2021-02-06,11,1503,10.6
13191,McIntosh County,2021-02-08,51,1554,11
13191,McIntosh County,2021-02-09,107,1661,11.7
13191,McIntosh County,2021-02-10,22,1683,11.9
13191,McIntosh County,2021-02-11,25,1708,12.1
13191,McIntosh County,2021-02-12,11,1719,12.1
13191,McIntosh County,2021-02-13,7,1726,12.2
13191,McIntosh County,2021-02-14,2,1728,12.2
13191,McIntosh County,2021-02-15,81,1809,12.8
13191,McIntosh County,2021-02-16,83,1892,13.3
13191,McIntosh County,2021-02-17,39,1931,13.6
13191,McIntosh County,2021-02-18,29,1960,13.8
13191,McIntosh County,2021-02-19,23,1983,14
13191,McIntosh County,2021-02-20,23,2006,14.2
13191,McIntosh County,2021-02-21,4,2010,14.2
13191,McIntosh County,2021-02-22,84,2094,14.8
13191,McIntosh County,2021-02-23,77,2171,15.3
13191,McIntosh County,2021-02-24,49,2220,15.7
13191,McIntosh County,2021-02-25,16,2236,15.8
13191,McIntosh County,2021-02-26,10,2246,15.8
13191,McIntosh County,2021-02-27,28,2274,16
13191,McIntosh County,2021-02-28,1,2275,16.1
13191,McIntosh County,2021-03-01,68,2343,16.5
13191,McIntosh County,2021-03-02,28,2371,16.7
13191,McIntosh County,2021-03-03,18,2389,16.9
13191,McIntosh County,2021-03-04,15,2404,17
13191,McIntosh County,2021-03-05,8,2412,17
13191,McIntosh County,2021-03-06,122,2534,17.9
13191,McIntosh County,2021-03-07,1,2535,17.9
13191,McIntosh County,2021-03-08,44,2579,18.2
13191,McIntosh County,2021-03-09,41,2620,18.5
13191,McIntosh County,2021-03-10,84,2704,19.1
13191,McIntosh County,2021-03-11,15,2719,19.2
13191,McIntosh County,2021-03-12,16,2735,19.3
13191,McIntosh County,2021-03-13,28,2763,19.5
13191,McIntosh County,2021-03-14,2,2765,19.5
13191,McIntosh County,2021-03-15,83,2848,20.1
13191,McIntosh County,2021-03-16,85,2933,20.7
13191,McIntosh County,2021-03-17,37,2970,21
13191,McIntosh County,2021-03-18,31,3001,21.2
13191,McIntosh County,2021-03-19,26,3027,21.4
13191,McIntosh County,2021-03-20,16,3043,21.5
13191,McIntosh County,2021-03-21,5,3048,21.5
13191,McIntosh County,2021-03-22,82,3130,22.1
13191,McIntosh County,2021-03-23,72,3202,22.6
13191,McIntosh County,2021-03-24,21,3223,22.7
13191,McIntosh County,2021-03-25,52,3275,23.1
13191,McIntosh County,2021-03-26,28,3303,23.3
13191,McIntosh County,2021-03-27,30,3333,23.5
13191,McIntosh County,2021-03-28,5,3338,23.6
13191,McIntosh County,2021-03-29,79,3417,24.1
13191,McIntosh County,2021-03-30,67,3484,24.6
13191,McIntosh County,2021-03-31,44,3528,24.9
13191,McIntosh County,2021-04-01,45,3573,25.2
13191,McIntosh County,2021-04-02,25,3598,25.4
13191,McIntosh County,2021-04-03,17,3615,25.5
13191,McIntosh County,2021-04-04,1,3616,25.5
13191,McIntosh County,2021-04-05,50,3666,25.9
13191,McIntosh County,2021-04-06,71,3737,26.4
13191,McIntosh County,2021-04-07,31,3768,26.6
13191,McIntosh County,2021-04-08,43,3811,26.9
13191,McIntosh County,2021-04-09,20,3831,27
13191,McIntosh County,2021-04-10,20,3851,27.2
13191,McIntosh County,2021-04-12,45,3896,27.5
13191,McIntosh County,2021-04-13,20,3916,27.6
13191,McIntosh County,2021-04-14,21,3937,27.8
13191,McIntosh County,2021-04-15,15,3952,27.9
13191,McIntosh County,2021-04-16,27,3979,28.1
13191,McIntosh County,2021-04-17,10,3989,28.1
13191,McIntosh County,2021-04-18,4,3993,28.2
13191,McIntosh County,2021-04-19,31,4024,28.4
13191,McIntosh County,2021-04-20,17,4041,28.5
13191,McIntosh County,2021-04-21,14,4055,28.6
13191,McIntosh County,2021-04-22,13,4068,28.7
13191,McIntosh County,2021-04-23,16,4084,28.8
13191,McIntosh County,2021-04-24,7,4091,28.9
13191,McIntosh County,2021-04-25,1,4092,28.9
13191,McIntosh County,2021-04-26,16,4108,29
13191,McIntosh County,2021-04-27,9,4117,29
13191,McIntosh County,2021-04-28,13,4130,29.1
13191,McIntosh County,2021-04-29,28,4158,29.3
13191,McIntosh County,2021-04-30,11,4169,29.4
13191,McIntosh County,2021-05-01,2,4171,29.4
13191,McIntosh County,2021-05-02,5,4176,29.5
13191,McIntosh County,2021-05-03,24,4200,29.6
13191,McIntosh County,2021-05-04,5,4205,29.7
13191,McIntosh County,2021-05-05,22,4227,29.8
13191,McIntosh County,2021-05-06,36,4263,30.1
13191,McIntosh County,2021-05-07,8,4271,30.1
13191,McIntosh County,2021-05-08,10,4281,30.2
13191,McIntosh County,2021-05-10,10,4291,30.3
13191,McIntosh County,2021-05-11,17,4308,30.4
13191,McIntosh County,2021-05-12,9,4317,30.5
13191,McIntosh County,2021-05-13,20,4337,30.6
13191,McIntosh County,2021-05-14,20,4357,30.7
13191,McIntosh County,2021-05-15,11,4368,30.8
13191,McIntosh County,2021-05-16,2,4370,30.8
13191,McIntosh County,2021-05-17,12,4382,30.9
13191,McIntosh County,2021-05-18,19,4401,31
13191,McIntosh County,2021-05-19,19,4420,31.2
13191,McIntosh County,2021-05-20,23,4443,31.3
13191,McIntosh County,2021-05-21,9,4452,31.4
13191,McIntosh County,2021-05-22,6,4458,31.5
13191,McIntosh County,2021-05-23,1,4459,31.5
13191,McIntosh County,2021-05-24,10,4469,31.5
13191,McIntosh County,2021-05-25,17,4486,31.6
13191,McIntosh County,2021-05-26,19,4505,31.8
13191,McIntosh County,2021-05-27,16,4521,31.9
13191,McIntosh County,2021-05-28,5,4526,31.9
13191,McIntosh County,2021-05-29,3,4529,32
13191,McIntosh County,2021-05-30,1,4530,32
13191,McIntosh County,2021-06-01,7,4537,32
13191,McIntosh County,2021-06-02,8,4545,32.1
13191,McIntosh County,2021-06-03,18,4563,32.2
13191,McIntosh County,2021-06-04,2,4565,32.2
13191,McIntosh County,2021-06-05,9,4574,32.3
13191,McIntosh County,2021-06-06,2,4576,32.3
13191,McIntosh County,2021-06-07,6,4582,32.3
13191,McIntosh County,2021-06-08,7,4589,32.4
13191,McIntosh County,2021-06-09,9,4598,32.4
13191,McIntosh County,2021-06-10,12,4610,32.5
13191,McIntosh County,2021-06-11,5,4615,32.6
13191,McIntosh County,2021-06-12,4,4619,32.6
13191,McIntosh County,2021-06-14,3,4622,32.6
13191,McIntosh County,2021-06-15,3,4625,32.6
13191,McIntosh County,2021-06-16,1,4626,32.6
13191,McIntosh County,2021-06-17,9,4635,32.7
13191,McIntosh County,2021-06-18,1,4636,32.7
13191,McIntosh County,2021-06-19,3,4639,32.7
13191,McIntosh County,2021-06-20,1,4640,32.7
13191,McIntosh County,2021-06-21,7,4647,32.8
13191,McIntosh County,2021-06-22,3,4650,32.8
13191,McIntosh County,2021-06-23,23,4673,33
13191,McIntosh County,2021-06-24,10,4683,33
13191,McIntosh County,2021-06-25,5,4688,33.1
13191,McIntosh County,2021-06-26,1,4689,33.1
13191,McIntosh County,2021-06-27,1,4690,33.1
13191,McIntosh County,2021-06-28,3,4693,33.1
13191,McIntosh County,2021-06-29,4,4697,33.1
13191,McIntosh County,2021-06-30,2,4699,33.2
13191,McIntosh County,2021-07-01,9,4708,33.2
13191,McIntosh County,2021-07-02,3,4711,33.2
13191,McIntosh County,2021-07-03,4,4715,33.3
13191,McIntosh County,2021-07-05,2,4717,33.3
13191,McIntosh County,2021-07-06,9,4726,33.3
13191,McIntosh County,2021-07-07,1,4727,33.3
13191,McIntosh County,2021-07-08,9,4736,33.4
13191,McIntosh County,2021-07-09,2,4738,33.4
13191,McIntosh County,2021-07-10,1,4739,33.4
13191,McIntosh County,2021-07-11,1,4740,33.4
13191,McIntosh County,2021-07-12,3,4743,33.5
13191,McIntosh County,2021-07-13,7,4750,33.5
13191,McIntosh County,2021-07-14,8,4758,33.6
13191,McIntosh County,2021-07-15,13,4771,33.7
13191,McIntosh County,2021-07-16,4,4775,33.7
13191,McIntosh County,2021-07-17,1,4776,33.7
13191,McIntosh County,2021-07-18,1,4777,33.7
13191,McIntosh County,2021-07-19,4,4781,33.7
13191,McIntosh County,2021-07-20,8,4789,33.8
13191,McIntosh County,2021-07-21,9,4798,33.9
13191,McIntosh County,2021-07-22,21,4819,34
13191,McIntosh County,2021-07-23,13,4832,34.1
13191,McIntosh County,2021-07-24,5,4837,34.1
13191,McIntosh County,2021-07-25,3,4840,34.1
13191,McIntosh County,2021-07-26,11,4851,34.2
13191,McIntosh County,2021-07-27,25,4876,34.4
13191,McIntosh County,2021-07-28,16,4892,34.5
13191,McIntosh County,2021-07-29,34,4926,34.8
13191,McIntosh County,2021-07-30,14,4940,34.9
13191,McIntosh County,2021-07-31,6,4946,34.9
13191,McIntosh County,2021-08-01,4,4950,34.9
13191,McIntosh County,2021-08-02,19,4969,35.1
13191,McIntosh County,2021-08-03,48,5017,35.4
13191,McIntosh County,2021-08-04,23,5040,35.6
13191,McIntosh County,2021-08-05,58,5098,36
13191,McIntosh County,2021-08-06,20,5118,36.1
13191,McIntosh County,2021-08-07,16,5134,36.2
13191,McIntosh County,2021-08-08,3,5137,36.2
13191,McIntosh County,2021-08-09,14,5151,36.3
13191,McIntosh County,2021-08-10,32,5183,36.6
13191,McIntosh County,2021-08-11,23,5206,36.7
13191,McIntosh County,2021-08-12,62,5268,37.2
13191,McIntosh County,2021-08-13,12,5280,37.3
13191,McIntosh County,2021-08-14,9,5289,37.3
13191,McIntosh County,2021-08-15,12,5301,37.4
13191,McIntosh County,2021-08-16,20,5321,37.5
13191,McIntosh County,2021-08-17,67,5388,38
13191,McIntosh County,2021-08-18,25,5413,38.2
13191,McIntosh County,2021-08-19,56,5469,38.6
13191,McIntosh County,2021-08-20,33,5502,38.8
13191,McIntosh County,2021-08-21,8,5510,38.9
13191,McIntosh County,2021-08-22,1,5511,38.9
13191,McIntosh County,2021-08-23,20,5531,39
13191,McIntosh County,2021-08-24,26,5557,39.2
13191,McIntosh County,2021-08-25,13,5570,39.3
13191,McIntosh County,2021-08-26,40,5610,39.6
13191,McIntosh County,2021-08-27,20,5630,39.7
13191,McIntosh County,2021-08-28,4,5634,39.7
13191,McIntosh County,2021-08-29,1,5635,39.8
13191,McIntosh County,2021-08-30,8,5643,39.8
13191,McIntosh County,2021-08-31,24,5667,40
13191,McIntosh County,2021-09-01,15,5682,40.1
13191,McIntosh County,2021-09-02,48,5730,40.4
13191,McIntosh County,2021-09-03,26,5756,40.6
13191,McIntosh County,2021-09-04,7,5763,40.7
13191,McIntosh County,2021-09-05,4,5767,40.7
13191,McIntosh County,2021-09-06,6,5773,40.7
13191,McIntosh County,2021-09-07,10,5783,40.8
13191,McIntosh County,2021-09-08,14,5797,40.9
13191,McIntosh County,2021-09-09,28,5825,41.1
13191,McIntosh County,2021-09-10,9,5834,41.2
13191,McIntosh County,2021-09-11,9,5843,41.2
13191,McIntosh County,2021-09-12,2,5845,41.2
13191,McIntosh County,2021-09-13,7,5852,41.3
13191,McIntosh County,2021-09-14,27,5879,41.5
13191,McIntosh County,2021-09-15,10,5889,41.5
13191,McIntosh County,2021-09-16,26,5915,41.7
13191,McIntosh County,2021-09-17,15,5930,41.8
13191,McIntosh County,2021-09-18,3,5933,41.9
13191,McIntosh County,2021-09-19,4,5937,41.9
13191,McIntosh County,2021-09-20,4,5941,41.9
13191,McIntosh County,2021-09-21,14,5955,42
13191,McIntosh County,2021-09-22,2,5957,42
13191,McIntosh County,2021-09-23,30,5987,42.2
13191,McIntosh County,2021-09-24,6,5993,42.3
13191,McIntosh County,2021-09-25,4,5997,42.3
13191,McIntosh County,2021-09-26,1,5998,42.3
13191,McIntosh County,2021-09-27,2,6000,42.3
13191,McIntosh County,2021-09-28,3,6003,42.4
13191,McIntosh County,2021-09-29,4,6007,42.4
13191,McIntosh County,2021-09-30,12,6019,42.5
13191,McIntosh County,2021-10-01,5,6024,42.5
13191,McIntosh County,2021-10-02,4,6028,42.5
13191,McIntosh County,2021-10-03,1,6029,42.5
13191,McIntosh County,2021-10-04,1,6030,42.5
13191,McIntosh County,2021-10-05,6,6036,42.6
13191,McIntosh County,2021-10-06,5,6041,42.6
13191,McIntosh County,2021-10-07,3,6044,42.6
13193,Macon County,2020-12-17,1,1,0
13193,Macon County,2020-12-19,1,2,0
13193,Macon County,2020-12-20,1,3,0
13193,Macon County,2020-12-22,1,4,0
13193,Macon County,2020-12-23,8,12,0.1
13193,Macon County,2020-12-24,3,15,0.1
13193,Macon County,2020-12-26,6,21,0.2
13193,Macon County,2020-12-28,12,33,0.2
13193,Macon County,2020-12-29,37,70,0.5
13193,Macon County,2020-12-30,15,85,0.6
13193,Macon County,2020-12-31,8,93,0.7
13193,Macon County,2021-01-01,3,96,0.7
13193,Macon County,2021-01-03,115,211,1.6
13193,Macon County,2021-01-04,14,225,1.7
13193,Macon County,2021-01-05,13,238,1.8
13193,Macon County,2021-01-06,9,247,1.9
13193,Macon County,2021-01-07,17,264,2
13193,Macon County,2021-01-08,8,272,2
13193,Macon County,2021-01-09,3,275,2.1
13193,Macon County,2021-01-10,2,277,2.1
13193,Macon County,2021-01-11,19,296,2.2
13193,Macon County,2021-01-12,29,325,2.4
13193,Macon County,2021-01-13,75,400,3
13193,Macon County,2021-01-14,47,447,3.4
13193,Macon County,2021-01-15,145,592,4.4
13193,Macon County,2021-01-16,8,600,4.5
13193,Macon County,2021-01-17,7,607,4.6
13193,Macon County,2021-01-18,55,662,5
13193,Macon County,2021-01-19,23,685,5.1
13193,Macon County,2021-01-20,43,728,5.5
13193,Macon County,2021-01-21,26,754,5.7
13193,Macon County,2021-01-22,56,810,6.1
13193,Macon County,2021-01-23,11,821,6.2
13193,Macon County,2021-01-24,27,848,6.4
13193,Macon County,2021-01-25,179,1027,7.7
13193,Macon County,2021-01-26,25,1052,7.9
13193,Macon County,2021-01-27,37,1089,8.2
13193,Macon County,2021-01-28,31,1120,8.4
13193,Macon County,2021-01-29,24,1144,8.6
13193,Macon County,2021-01-30,2,1146,8.6
13193,Macon County,2021-01-31,2,1148,8.6
13193,Macon County,2021-02-01,7,1155,8.7
13193,Macon County,2021-02-02,18,1173,8.8
13193,Macon County,2021-02-03,32,1205,9.1
13193,Macon County,2021-02-04,29,1234,9.3
13193,Macon County,2021-02-05,92,1326,10
13193,Macon County,2021-02-06,2,1328,10
13193,Macon County,2021-02-08,22,1350,10.1
13193,Macon County,2021-02-09,12,1362,10.2
13193,Macon County,2021-02-10,12,1374,10.3
13193,Macon County,2021-02-11,9,1383,10.4
13193,Macon County,2021-02-12,21,1404,10.6
13193,Macon County,2021-02-13,7,1411,10.6
13193,Macon County,2021-02-14,2,1413,10.6
13193,Macon County,2021-02-15,13,1426,10.7
13193,Macon County,2021-02-16,8,1434,10.8
13193,Macon County,2021-02-17,18,1452,10.9
13193,Macon County,2021-02-18,11,1463,11
13193,Macon County,2021-02-19,5,1468,11
13193,Macon County,2021-02-20,1,1469,11
13193,Macon County,2021-02-22,14,1483,11.1
13193,Macon County,2021-02-23,20,1503,11.3
13193,Macon County,2021-02-24,14,1517,11.4
13193,Macon County,2021-02-25,19,1536,11.5
13193,Macon County,2021-02-26,32,1568,11.8
13193,Macon County,2021-02-27,4,1572,11.8
13193,Macon County,2021-02-28,5,1577,11.9
13193,Macon County,2021-03-01,45,1622,12.2
13193,Macon County,2021-03-02,20,1642,12.3
13193,Macon County,2021-03-03,33,1675,12.6
13193,Macon County,2021-03-04,17,1692,12.7
13193,Macon County,2021-03-05,28,1720,12.9
13193,Macon County,2021-03-06,5,1725,13
13193,Macon County,2021-03-07,3,1728,13
13193,Macon County,2021-03-08,47,1775,13.3
13193,Macon County,2021-03-09,26,1801,13.5
13193,Macon County,2021-03-10,37,1838,13.8
13193,Macon County,2021-03-11,39,1877,14.1
13193,Macon County,2021-03-12,98,1975,14.8
13193,Macon County,2021-03-13,11,1986,14.9
13193,Macon County,2021-03-14,7,1993,15
13193,Macon County,2021-03-15,187,2180,16.4
13193,Macon County,2021-03-16,29,2209,16.6
13193,Macon County,2021-03-17,43,2252,16.9
13193,Macon County,2021-03-18,28,2280,17.1
13193,Macon County,2021-03-19,88,2368,17.8
13193,Macon County,2021-03-20,5,2373,17.8
13193,Macon County,2021-03-21,3,2376,17.9
13193,Macon County,2021-03-22,172,2548,19.2
13193,Macon County,2021-03-23,33,2581,19.4
13193,Macon County,2021-03-24,40,2621,19.7
13193,Macon County,2021-03-25,64,2685,20.2
13193,Macon County,2021-03-26,32,2717,20.4
13193,Macon County,2021-03-27,9,2726,20.5
13193,Macon County,2021-03-28,11,2737,20.6
13193,Macon County,2021-03-29,74,2811,21.1
13193,Macon County,2021-03-30,38,2849,21.4
13193,Macon County,2021-03-31,46,2895,21.8
13193,Macon County,2021-04-01,156,3051,22.9
13193,Macon County,2021-04-02,28,3079,23.1
13193,Macon County,2021-04-03,5,3084,23.2
13193,Macon County,2021-04-04,3,3087,23.2
13193,Macon County,2021-04-05,32,3119,23.4
13193,Macon County,2021-04-06,36,3155,23.7
13193,Macon County,2021-04-07,36,3191,24
13193,Macon County,2021-04-08,71,3262,24.5
13193,Macon County,2021-04-09,46,3308,24.9
13193,Macon County,2021-04-10,8,3316,24.9
13193,Macon County,2021-04-11,6,3322,25
13193,Macon County,2021-04-12,24,3346,25.1
13193,Macon County,2021-04-13,38,3384,25.4
13193,Macon County,2021-04-14,25,3409,25.6
13193,Macon County,2021-04-15,58,3467,26.1
13193,Macon County,2021-04-16,17,3484,26.2
13193,Macon County,2021-04-17,6,3490,26.2
13193,Macon County,2021-04-18,3,3493,26.3
13193,Macon County,2021-04-19,28,3521,26.5
13193,Macon County,2021-04-20,24,3545,26.6
13193,Macon County,2021-04-21,11,3556,26.7
13193,Macon County,2021-04-22,36,3592,27
13193,Macon County,2021-04-23,30,3622,27.2
13193,Macon County,2021-04-24,6,3628,27.3
13193,Macon County,2021-04-25,25,3653,27.5
13193,Macon County,2021-04-26,27,3680,27.7
13193,Macon County,2021-04-27,23,3703,27.8
13193,Macon County,2021-04-28,15,3718,27.9
13193,Macon County,2021-04-29,16,3734,28.1
13193,Macon County,2021-04-30,23,3757,28.2
13193,Macon County,2021-05-01,4,3761,28.3
13193,Macon County,2021-05-02,2,3763,28.3
13193,Macon County,2021-05-03,14,3777,28.4
13193,Macon County,2021-05-04,21,3798,28.5
13193,Macon County,2021-05-05,18,3816,28.7
13193,Macon County,2021-05-06,15,3831,28.8
13193,Macon County,2021-05-07,22,3853,29
13193,Macon County,2021-05-08,7,3860,29
13193,Macon County,2021-05-10,10,3870,29.1
13193,Macon County,2021-05-11,25,3895,29.3
13193,Macon County,2021-05-12,15,3910,29.4
13193,Macon County,2021-05-13,19,3929,29.5
13193,Macon County,2021-05-14,19,3948,29.7
13193,Macon County,2021-05-15,7,3955,29.7
13193,Macon County,2021-05-16,8,3963,29.8
13193,Macon County,2021-05-17,13,3976,29.9
13193,Macon County,2021-05-18,30,4006,30.1
13193,Macon County,2021-05-19,35,4041,30.4
13193,Macon County,2021-05-20,20,4061,30.5
13193,Macon County,2021-05-21,19,4080,30.7
13193,Macon County,2021-05-22,9,4089,30.7
13193,Macon County,2021-05-23,12,4101,30.8
13193,Macon County,2021-05-24,19,4120,31
13193,Macon County,2021-05-25,22,4142,31.1
13193,Macon County,2021-05-26,13,4155,31.2
13193,Macon County,2021-05-27,9,4164,31.3
13193,Macon County,2021-05-28,8,4172,31.4
13193,Macon County,2021-05-29,4,4176,31.4
13193,Macon County,2021-05-30,5,4181,31.4
13193,Macon County,2021-05-31,1,4182,31.4
13193,Macon County,2021-06-01,9,4191,31.5
13193,Macon County,2021-06-02,11,4202,31.6
13193,Macon County,2021-06-03,9,4211,31.6
13193,Macon County,2021-06-04,9,4220,31.7
13193,Macon County,2021-06-05,1,4221,31.7
13193,Macon County,2021-06-06,3,4224,31.7
13193,Macon County,2021-06-07,14,4238,31.9
13193,Macon County,2021-06-08,18,4256,32
13193,Macon County,2021-06-09,9,4265,32.1
13193,Macon County,2021-06-10,12,4277,32.1
13193,Macon County,2021-06-11,11,4288,32.2
13193,Macon County,2021-06-12,5,4293,32.3
13193,Macon County,2021-06-14,6,4299,32.3
13193,Macon County,2021-06-15,4,4303,32.3
13193,Macon County,2021-06-16,13,4316,32.4
13193,Macon County,2021-06-17,9,4325,32.5
13193,Macon County,2021-06-18,16,4341,32.6
13193,Macon County,2021-06-19,3,4344,32.6
13193,Macon County,2021-06-21,6,4350,32.7
13193,Macon County,2021-06-22,6,4356,32.7
13193,Macon County,2021-06-23,8,4364,32.8
13193,Macon County,2021-06-24,14,4378,32.9
13193,Macon County,2021-06-25,7,4385,33
13193,Macon County,2021-06-26,5,4390,33
13193,Macon County,2021-06-27,2,4392,33
13193,Macon County,2021-06-28,10,4402,33.1
13193,Macon County,2021-06-29,8,4410,33.1
13193,Macon County,2021-06-30,2,4412,33.2
13193,Macon County,2021-07-01,9,4421,33.2
13193,Macon County,2021-07-02,6,4427,33.3
13193,Macon County,2021-07-03,1,4428,33.3
13193,Macon County,2021-07-05,3,4431,33.3
13193,Macon County,2021-07-06,7,4438,33.4
13193,Macon County,2021-07-07,6,4444,33.4
13193,Macon County,2021-07-08,9,4453,33.5
13193,Macon County,2021-07-09,10,4463,33.5
13193,Macon County,2021-07-10,9,4472,33.6
13193,Macon County,2021-07-11,2,4474,33.6
13193,Macon County,2021-07-12,7,4481,33.7
13193,Macon County,2021-07-13,6,4487,33.7
13193,Macon County,2021-07-14,5,4492,33.8
13193,Macon County,2021-07-15,24,4516,33.9
13193,Macon County,2021-07-16,12,4528,34
13193,Macon County,2021-07-17,3,4531,34.1
13193,Macon County,2021-07-18,3,4534,34.1
13193,Macon County,2021-07-19,7,4541,34.1
13193,Macon County,2021-07-20,14,4555,34.2
13193,Macon County,2021-07-21,18,4573,34.4
13193,Macon County,2021-07-22,9,4582,34.4
13193,Macon County,2021-07-23,22,4604,34.6
13193,Macon County,2021-07-24,3,4607,34.6
13193,Macon County,2021-07-25,6,4613,34.7
13193,Macon County,2021-07-26,9,4622,34.7
13193,Macon County,2021-07-27,22,4644,34.9
13193,Macon County,2021-07-28,13,4657,35
13193,Macon County,2021-07-29,19,4676,35.1
13193,Macon County,2021-07-30,24,4700,35.3
13193,Macon County,2021-07-31,12,4712,35.4
13193,Macon County,2021-08-01,7,4719,35.5
13193,Macon County,2021-08-02,16,4735,35.6
13193,Macon County,2021-08-03,22,4757,35.8
13193,Macon County,2021-08-04,13,4770,35.9
13193,Macon County,2021-08-05,26,4796,36
13193,Macon County,2021-08-06,24,4820,36.2
13193,Macon County,2021-08-07,11,4831,36.3
13193,Macon County,2021-08-08,9,4840,36.4
13193,Macon County,2021-08-09,19,4859,36.5
13193,Macon County,2021-08-10,32,4891,36.8
13193,Macon County,2021-08-11,19,4910,36.9
13193,Macon County,2021-08-12,22,4932,37.1
13193,Macon County,2021-08-13,36,4968,37.3
13193,Macon County,2021-08-14,20,4988,37.5
13193,Macon County,2021-08-15,10,4998,37.6
13193,Macon County,2021-08-16,28,5026,37.8
13193,Macon County,2021-08-17,31,5057,38
13193,Macon County,2021-08-18,16,5073,38.1
13193,Macon County,2021-08-19,33,5106,38.4
13193,Macon County,2021-08-20,31,5137,38.6
13193,Macon County,2021-08-21,15,5152,38.7
13193,Macon County,2021-08-22,6,5158,38.8
13193,Macon County,2021-08-23,23,5181,38.9
13193,Macon County,2021-08-24,22,5203,39.1
13193,Macon County,2021-08-25,44,5247,39.4
13193,Macon County,2021-08-26,48,5295,39.8
13193,Macon County,2021-08-27,34,5329,40.1
13193,Macon County,2021-08-28,3,5332,40.1
13193,Macon County,2021-08-29,11,5343,40.2
13193,Macon County,2021-08-30,23,5366,40.3
13193,Macon County,2021-08-31,21,5387,40.5
13193,Macon County,2021-09-01,27,5414,40.7
13193,Macon County,2021-09-02,19,5433,40.8
13193,Macon County,2021-09-03,30,5463,41.1
13193,Macon County,2021-09-04,10,5473,41.1
13193,Macon County,2021-09-05,6,5479,41.2
13193,Macon County,2021-09-07,24,5503,41.4
13193,Macon County,2021-09-08,17,5520,41.5
13193,Macon County,2021-09-09,29,5549,41.7
13193,Macon County,2021-09-10,50,5599,42.1
13193,Macon County,2021-09-11,12,5611,42.2
13193,Macon County,2021-09-12,7,5618,42.2
13193,Macon County,2021-09-13,23,5641,42.4
13193,Macon County,2021-09-14,24,5665,42.6
13193,Macon County,2021-09-15,22,5687,42.7
13193,Macon County,2021-09-16,14,5701,42.8
13193,Macon County,2021-09-17,23,5724,43
13193,Macon County,2021-09-18,8,5732,43.1
13193,Macon County,2021-09-19,4,5736,43.1
13193,Macon County,2021-09-20,17,5753,43.2
13193,Macon County,2021-09-21,9,5762,43.3
13193,Macon County,2021-09-22,15,5777,43.4
13193,Macon County,2021-09-23,17,5794,43.5
13193,Macon County,2021-09-24,7,5801,43.6
13193,Macon County,2021-09-25,4,5805,43.6
13193,Macon County,2021-09-26,2,5807,43.6
13193,Macon County,2021-09-27,8,5815,43.7
13193,Macon County,2021-09-28,11,5826,43.8
13193,Macon County,2021-09-29,5,5831,43.8
13193,Macon County,2021-09-30,6,5837,43.9
13193,Macon County,2021-10-01,11,5848,44
13193,Macon County,2021-10-04,4,5852,44
13193,Macon County,2021-10-05,8,5860,44
13193,Macon County,2021-10-06,4,5864,44.1
13195,Madison County,2020-12-18,7,7,0
13195,Madison County,2020-12-19,5,12,0
13195,Madison County,2020-12-20,2,14,0
13195,Madison County,2020-12-21,7,21,0.1
13195,Madison County,2020-12-22,23,44,0.2
13195,Madison County,2020-12-23,42,86,0.3
13195,Madison County,2020-12-24,11,97,0.3
13195,Madison County,2020-12-26,7,104,0.4
13195,Madison County,2020-12-27,1,105,0.4
13195,Madison County,2020-12-28,57,162,0.6
13195,Madison County,2020-12-29,61,223,0.8
13195,Madison County,2020-12-30,33,256,0.9
13195,Madison County,2020-12-31,41,297,1
13195,Madison County,2021-01-01,2,299,1
13195,Madison County,2021-01-02,9,308,1.1
13195,Madison County,2021-01-03,4,312,1.1
13195,Madison County,2021-01-04,133,445,1.5
13195,Madison County,2021-01-05,28,473,1.6
13195,Madison County,2021-01-06,43,516,1.8
13195,Madison County,2021-01-07,46,562,1.9
13195,Madison County,2021-01-08,51,613,2.1
13195,Madison County,2021-01-09,9,622,2.1
13195,Madison County,2021-01-10,9,631,2.2
13195,Madison County,2021-01-11,36,667,2.3
13195,Madison County,2021-01-12,61,728,2.5
13195,Madison County,2021-01-13,59,787,2.7
13195,Madison County,2021-01-14,76,863,3
13195,Madison County,2021-01-15,119,982,3.4
13195,Madison County,2021-01-16,55,1037,3.5
13195,Madison County,2021-01-17,11,1048,3.6
13195,Madison County,2021-01-18,57,1105,3.8
13195,Madison County,2021-01-19,92,1197,4.1
13195,Madison County,2021-01-20,73,1270,4.3
13195,Madison County,2021-01-21,131,1401,4.8
13195,Madison County,2021-01-22,61,1462,5
13195,Madison County,2021-01-23,50,1512,5.2
13195,Madison County,2021-01-24,34,1546,5.3
13195,Madison County,2021-01-25,162,1708,5.8
13195,Madison County,2021-01-26,145,1853,6.3
13195,Madison County,2021-01-27,70,1923,6.6
13195,Madison County,2021-01-28,61,1984,6.8
13195,Madison County,2021-01-29,71,2055,7
13195,Madison County,2021-01-30,8,2063,7.1
13195,Madison County,2021-01-31,5,2068,7.1
13195,Madison County,2021-02-01,38,2106,7.2
13195,Madison County,2021-02-02,113,2219,7.6
13195,Madison County,2021-02-03,78,2297,7.9
13195,Madison County,2021-02-04,59,2356,8.1
13195,Madison County,2021-02-05,58,2414,8.3
13195,Madison County,2021-02-06,13,2427,8.3
13195,Madison County,2021-02-07,8,2435,8.3
13195,Madison County,2021-02-08,45,2480,8.5
13195,Madison County,2021-02-09,142,2622,9
13195,Madison County,2021-02-10,78,2700,9.2
13195,Madison County,2021-02-11,34,2734,9.4
13195,Madison County,2021-02-12,56,2790,9.5
13195,Madison County,2021-02-13,10,2800,9.6
13195,Madison County,2021-02-14,5,2805,9.6
13195,Madison County,2021-02-15,36,2841,9.7
13195,Madison County,2021-02-16,156,2997,10.3
13195,Madison County,2021-02-17,40,3037,10.4
13195,Madison County,2021-02-18,40,3077,10.5
13195,Madison County,2021-02-19,48,3125,10.7
13195,Madison County,2021-02-20,6,3131,10.7
13195,Madison County,2021-02-21,2,3133,10.7
13195,Madison County,2021-02-22,60,3193,10.9
13195,Madison County,2021-02-23,67,3260,11.2
13195,Madison County,2021-02-24,62,3322,11.4
13195,Madison County,2021-02-25,49,3371,11.5
13195,Madison County,2021-02-26,52,3423,11.7
13195,Madison County,2021-02-27,31,3454,11.8
13195,Madison County,2021-02-28,25,3479,11.9
13195,Madison County,2021-03-01,85,3564,12.2
13195,Madison County,2021-03-02,70,3634,12.4
13195,Madison County,2021-03-03,52,3686,12.6
13195,Madison County,2021-03-04,78,3764,12.9
13195,Madison County,2021-03-05,89,3853,13.2
13195,Madison County,2021-03-06,26,3879,13.3
13195,Madison County,2021-03-07,24,3903,13.4
13195,Madison County,2021-03-08,79,3982,13.6
13195,Madison County,2021-03-09,72,4054,13.9
13195,Madison County,2021-03-10,164,4218,14.4
13195,Madison County,2021-03-11,150,4368,14.9
13195,Madison County,2021-03-12,340,4708,16.1
13195,Madison County,2021-03-13,94,4802,16.4
13195,Madison County,2021-03-14,37,4839,16.6
13195,Madison County,2021-03-15,131,4970,17
13195,Madison County,2021-03-16,138,5108,17.5
13195,Madison County,2021-03-17,187,5295,18.1
13195,Madison County,2021-03-18,126,5421,18.6
13195,Madison County,2021-03-19,138,5559,19
13195,Madison County,2021-03-20,162,5721,19.6
13195,Madison County,2021-03-21,22,5743,19.7
13195,Madison County,2021-03-22,207,5950,20.4
13195,Madison County,2021-03-23,241,6191,21.2
13195,Madison County,2021-03-24,154,6345,21.7
13195,Madison County,2021-03-25,184,6529,22.3
13195,Madison County,2021-03-26,215,6744,23.1
13195,Madison County,2021-03-27,33,6777,23.2
13195,Madison County,2021-03-28,25,6802,23.3
13195,Madison County,2021-03-29,139,6941,23.8
13195,Madison County,2021-03-30,149,7090,24.3
13195,Madison County,2021-03-31,162,7252,24.8
13195,Madison County,2021-04-01,146,7398,25.3
13195,Madison County,2021-04-02,147,7545,25.8
13195,Madison County,2021-04-03,31,7576,25.9
13195,Madison County,2021-04-04,28,7604,26
13195,Madison County,2021-04-05,121,7725,26.4
13195,Madison County,2021-04-06,134,7859,26.9
13195,Madison County,2021-04-07,118,7977,27.3
13195,Madison County,2021-04-08,112,8089,27.7
13195,Madison County,2021-04-09,167,8256,28.3
13195,Madison County,2021-04-10,62,8318,28.5
13195,Madison County,2021-04-11,20,8338,28.5
13195,Madison County,2021-04-12,61,8399,28.7
13195,Madison County,2021-04-13,95,8494,29.1
13195,Madison County,2021-04-14,59,8553,29.3
13195,Madison County,2021-04-15,54,8607,29.5
13195,Madison County,2021-04-16,74,8681,29.7
13195,Madison County,2021-04-17,43,8724,29.9
13195,Madison County,2021-04-18,17,8741,29.9
13195,Madison County,2021-04-19,40,8781,30.1
13195,Madison County,2021-04-20,52,8833,30.2
13195,Madison County,2021-04-21,50,8883,30.4
13195,Madison County,2021-04-22,49,8932,30.6
13195,Madison County,2021-04-23,65,8997,30.8
13195,Madison County,2021-04-24,17,9014,30.9
13195,Madison County,2021-04-25,6,9020,30.9
13195,Madison County,2021-04-26,30,9050,31
13195,Madison County,2021-04-27,52,9102,31.2
13195,Madison County,2021-04-28,63,9165,31.4
13195,Madison County,2021-04-29,54,9219,31.6
13195,Madison County,2021-04-30,85,9304,31.8
13195,Madison County,2021-05-01,16,9320,31.9
13195,Madison County,2021-05-02,11,9331,31.9
13195,Madison County,2021-05-03,42,9373,32.1
13195,Madison County,2021-05-04,44,9417,32.2
13195,Madison County,2021-05-05,37,9454,32.4
13195,Madison County,2021-05-06,49,9503,32.5
13195,Madison County,2021-05-07,52,9555,32.7
13195,Madison County,2021-05-08,22,9577,32.8
13195,Madison County,2021-05-09,3,9580,32.8
13195,Madison County,2021-05-10,43,9623,32.9
13195,Madison County,2021-05-11,36,9659,33.1
13195,Madison County,2021-05-12,38,9697,33.2
13195,Madison County,2021-05-13,49,9746,33.4
13195,Madison County,2021-05-14,62,9808,33.6
13195,Madison County,2021-05-15,33,9841,33.7
13195,Madison County,2021-05-16,8,9849,33.7
13195,Madison County,2021-05-17,40,9889,33.8
13195,Madison County,2021-05-18,45,9934,34
13195,Madison County,2021-05-19,52,9986,34.2
13195,Madison County,2021-05-20,31,10017,34.3
13195,Madison County,2021-05-21,44,10061,34.4
13195,Madison County,2021-05-22,27,10088,34.5
13195,Madison County,2021-05-23,15,10103,34.6
13195,Madison County,2021-05-24,28,10131,34.7
13195,Madison County,2021-05-25,23,10154,34.8
13195,Madison County,2021-05-26,37,10191,34.9
13195,Madison County,2021-05-27,15,10206,34.9
13195,Madison County,2021-05-28,65,10271,35.2
13195,Madison County,2021-05-29,12,10283,35.2
13195,Madison County,2021-05-30,10,10293,35.2
13195,Madison County,2021-05-31,6,10299,35.2
13195,Madison County,2021-06-01,32,10331,35.4
13195,Madison County,2021-06-02,32,10363,35.5
13195,Madison County,2021-06-03,19,10382,35.5
13195,Madison County,2021-06-04,29,10411,35.6
13195,Madison County,2021-06-05,11,10422,35.7
13195,Madison County,2021-06-06,7,10429,35.7
13195,Madison County,2021-06-07,14,10443,35.7
13195,Madison County,2021-06-08,13,10456,35.8
13195,Madison County,2021-06-09,27,10483,35.9
13195,Madison County,2021-06-10,25,10508,36
13195,Madison County,2021-06-11,19,10527,36
13195,Madison County,2021-06-12,18,10545,36.1
13195,Madison County,2021-06-13,4,10549,36.1
13195,Madison County,2021-06-14,21,10570,36.2
13195,Madison County,2021-06-15,21,10591,36.2
13195,Madison County,2021-06-16,15,10606,36.3
13195,Madison County,2021-06-17,21,10627,36.4
13195,Madison County,2021-06-18,22,10649,36.4
13195,Madison County,2021-06-19,14,10663,36.5
13195,Madison County,2021-06-20,5,10668,36.5
13195,Madison County,2021-06-21,11,10679,36.5
13195,Madison County,2021-06-22,16,10695,36.6
13195,Madison County,2021-06-23,23,10718,36.7
13195,Madison County,2021-06-24,12,10730,36.7
13195,Madison County,2021-06-25,28,10758,36.8
13195,Madison County,2021-06-26,11,10769,36.9
13195,Madison County,2021-06-27,1,10770,36.9
13195,Madison County,2021-06-28,15,10785,36.9
13195,Madison County,2021-06-29,18,10803,37
13195,Madison County,2021-06-30,11,10814,37
13195,Madison County,2021-07-01,10,10824,37
13195,Madison County,2021-07-02,18,10842,37.1
13195,Madison County,2021-07-03,5,10847,37.1
13195,Madison County,2021-07-04,2,10849,37.1
13195,Madison County,2021-07-05,4,10853,37.1
13195,Madison County,2021-07-06,9,10862,37.2
13195,Madison County,2021-07-07,21,10883,37.2
13195,Madison County,2021-07-08,14,10897,37.3
13195,Madison County,2021-07-09,14,10911,37.3
13195,Madison County,2021-07-10,11,10922,37.4
13195,Madison County,2021-07-11,5,10927,37.4
13195,Madison County,2021-07-12,14,10941,37.4
13195,Madison County,2021-07-13,11,10952,37.5
13195,Madison County,2021-07-14,19,10971,37.5
13195,Madison County,2021-07-15,12,10983,37.6
13195,Madison County,2021-07-16,30,11013,37.7
13195,Madison County,2021-07-17,6,11019,37.7
13195,Madison County,2021-07-18,10,11029,37.7
13195,Madison County,2021-07-19,18,11047,37.8
13195,Madison County,2021-07-20,16,11063,37.9
13195,Madison County,2021-07-21,25,11088,37.9
13195,Madison County,2021-07-22,22,11110,38
13195,Madison County,2021-07-23,23,11133,38.1
13195,Madison County,2021-07-24,15,11148,38.2
13195,Madison County,2021-07-25,9,11157,38.2
13195,Madison County,2021-07-26,28,11185,38.3
13195,Madison County,2021-07-27,23,11208,38.4
13195,Madison County,2021-07-28,28,11236,38.5
13195,Madison County,2021-07-29,37,11273,38.6
13195,Madison County,2021-07-30,38,11311,38.7
13195,Madison County,2021-07-31,18,11329,38.8
13195,Madison County,2021-08-01,7,11336,38.8
13195,Madison County,2021-08-02,44,11380,38.9
13195,Madison County,2021-08-03,43,11423,39.1
13195,Madison County,2021-08-04,51,11474,39.3
13195,Madison County,2021-08-05,46,11520,39.4
13195,Madison County,2021-08-06,69,11589,39.7
13195,Madison County,2021-08-07,35,11624,39.8
13195,Madison County,2021-08-08,19,11643,39.8
13195,Madison County,2021-08-09,51,11694,40
13195,Madison County,2021-08-10,37,11731,40.1
13195,Madison County,2021-08-11,47,11778,40.3
13195,Madison County,2021-08-12,43,11821,40.5
13195,Madison County,2021-08-13,65,11886,40.7
13195,Madison County,2021-08-14,29,11915,40.8
13195,Madison County,2021-08-15,23,11938,40.9
13195,Madison County,2021-08-16,49,11987,41
13195,Madison County,2021-08-17,43,12030,41.2
13195,Madison County,2021-08-18,37,12067,41.3
13195,Madison County,2021-08-19,49,12116,41.5
13195,Madison County,2021-08-20,61,12177,41.7
13195,Madison County,2021-08-21,41,12218,41.8
13195,Madison County,2021-08-22,22,12240,41.9
13195,Madison County,2021-08-23,40,12280,42
13195,Madison County,2021-08-24,53,12333,42.2
13195,Madison County,2021-08-25,57,12390,42.4
13195,Madison County,2021-08-26,66,12456,42.6
13195,Madison County,2021-08-27,58,12514,42.8
13195,Madison County,2021-08-28,24,12538,42.9
13195,Madison County,2021-08-29,16,12554,43
13195,Madison County,2021-08-30,48,12602,43.1
13195,Madison County,2021-08-31,55,12657,43.3
13195,Madison County,2021-09-01,52,12709,43.5
13195,Madison County,2021-09-02,53,12762,43.7
13195,Madison County,2021-09-03,65,12827,43.9
13195,Madison County,2021-09-04,26,12853,44
13195,Madison County,2021-09-05,14,12867,44
13195,Madison County,2021-09-06,3,12870,44
13195,Madison County,2021-09-07,49,12919,44.2
13195,Madison County,2021-09-08,41,12960,44.4
13195,Madison County,2021-09-09,30,12990,44.5
13195,Madison County,2021-09-10,47,13037,44.6
13195,Madison County,2021-09-11,18,13055,44.7
13195,Madison County,2021-09-12,21,13076,44.8
13195,Madison County,2021-09-13,37,13113,44.9
13195,Madison County,2021-09-14,36,13149,45
13195,Madison County,2021-09-15,26,13175,45.1
13195,Madison County,2021-09-16,32,13207,45.2
13195,Madison County,2021-09-17,31,13238,45.3
13195,Madison County,2021-09-18,13,13251,45.4
13195,Madison County,2021-09-19,10,13261,45.4
13195,Madison County,2021-09-20,25,13286,45.5
13195,Madison County,2021-09-21,14,13300,45.5
13195,Madison County,2021-09-22,15,13315,45.6
13195,Madison County,2021-09-23,16,13331,45.6
13195,Madison County,2021-09-24,14,13345,45.7
13195,Madison County,2021-09-25,21,13366,45.7
13195,Madison County,2021-09-26,5,13371,45.8
13195,Madison County,2021-09-27,15,13386,45.8
13195,Madison County,2021-09-28,8,13394,45.8
13195,Madison County,2021-09-29,15,13409,45.9
13195,Madison County,2021-09-30,17,13426,46
13195,Madison County,2021-10-01,17,13443,46
13195,Madison County,2021-10-02,8,13451,46
13195,Madison County,2021-10-04,12,13463,46.1
13195,Madison County,2021-10-05,6,13469,46.1
13195,Madison County,2021-10-06,12,13481,46.1
13195,Madison County,2021-10-07,3,13484,46.1
13197,Marion County,2020-12-12,1,1,0
13197,Marion County,2020-12-14,1,2,0
13197,Marion County,2020-12-18,3,5,0.1
13197,Marion County,2020-12-19,1,6,0.1
13197,Marion County,2020-12-20,1,7,0.1
13197,Marion County,2020-12-21,5,12,0.1
13197,Marion County,2020-12-22,2,14,0.2
13197,Marion County,2020-12-23,6,20,0.2
13197,Marion County,2020-12-24,1,21,0.2
13197,Marion County,2020-12-26,1,22,0.3
13197,Marion County,2020-12-27,1,23,0.3
13197,Marion County,2020-12-28,5,28,0.3
13197,Marion County,2020-12-29,6,34,0.4
13197,Marion County,2020-12-30,4,38,0.5
13197,Marion County,2020-12-31,4,42,0.5
13197,Marion County,2021-01-03,1,43,0.5
13197,Marion County,2021-01-04,33,76,0.9
13197,Marion County,2021-01-05,8,84,1
13197,Marion County,2021-01-06,11,95,1.1
13197,Marion County,2021-01-07,9,104,1.2
13197,Marion County,2021-01-08,8,112,1.3
13197,Marion County,2021-01-09,3,115,1.4
13197,Marion County,2021-01-10,2,117,1.4
13197,Marion County,2021-01-11,54,171,2
13197,Marion County,2021-01-12,18,189,2.2
13197,Marion County,2021-01-13,135,324,3.8
13197,Marion County,2021-01-14,97,421,5
13197,Marion County,2021-01-15,101,522,6.2
13197,Marion County,2021-01-16,8,530,6.3
13197,Marion County,2021-01-17,2,532,6.3
13197,Marion County,2021-01-18,17,549,6.5
13197,Marion County,2021-01-19,15,564,6.7
13197,Marion County,2021-01-20,57,621,7.4
13197,Marion County,2021-01-21,11,632,7.5
13197,Marion County,2021-01-22,45,677,8
13197,Marion County,2021-01-23,1,678,8
13197,Marion County,2021-01-24,2,680,8.1
13197,Marion County,2021-01-25,16,696,8.3
13197,Marion County,2021-01-26,8,704,8.3
13197,Marion County,2021-01-27,9,713,8.5
13197,Marion County,2021-01-28,14,727,8.6
13197,Marion County,2021-01-29,15,742,8.8
13197,Marion County,2021-02-01,5,747,8.9
13197,Marion County,2021-02-02,3,750,8.9
13197,Marion County,2021-02-03,7,757,9
13197,Marion County,2021-02-04,8,765,9.1
13197,Marion County,2021-02-05,6,771,9.1
13197,Marion County,2021-02-06,1,772,9.2
13197,Marion County,2021-02-07,1,773,9.2
13197,Marion County,2021-02-08,7,780,9.3
13197,Marion County,2021-02-09,8,788,9.3
13197,Marion County,2021-02-10,13,801,9.5
13197,Marion County,2021-02-11,13,814,9.7
13197,Marion County,2021-02-12,7,821,9.7
13197,Marion County,2021-02-13,3,824,9.8
13197,Marion County,2021-02-15,16,840,10
13197,Marion County,2021-02-16,10,850,10.1
13197,Marion County,2021-02-17,15,865,10.3
13197,Marion County,2021-02-18,10,875,10.4
13197,Marion County,2021-02-19,9,884,10.5
13197,Marion County,2021-02-20,1,885,10.5
13197,Marion County,2021-02-22,100,985,11.7
13197,Marion County,2021-02-23,9,994,11.8
13197,Marion County,2021-02-24,83,1077,12.8
13197,Marion County,2021-02-25,3,1080,12.8
13197,Marion County,2021-02-26,64,1144,13.6
13197,Marion County,2021-02-28,1,1145,13.6
13197,Marion County,2021-03-01,8,1153,13.7
13197,Marion County,2021-03-02,4,1157,13.7
13197,Marion County,2021-03-03,64,1221,14.5
13197,Marion County,2021-03-04,14,1235,14.6
13197,Marion County,2021-03-05,17,1252,14.8
13197,Marion County,2021-03-06,3,1255,14.9
13197,Marion County,2021-03-07,1,1256,14.9
13197,Marion County,2021-03-08,5,1261,15
13197,Marion County,2021-03-09,7,1268,15
13197,Marion County,2021-03-10,77,1345,16
13197,Marion County,2021-03-11,23,1368,16.2
13197,Marion County,2021-03-12,41,1409,16.7
13197,Marion County,2021-03-13,1,1410,16.7
13197,Marion County,2021-03-14,4,1414,16.8
13197,Marion County,2021-03-15,16,1430,17
13197,Marion County,2021-03-16,15,1445,17.1
13197,Marion County,2021-03-17,67,1512,17.9
13197,Marion County,2021-03-18,15,1527,18.1
13197,Marion County,2021-03-19,40,1567,18.6
13197,Marion County,2021-03-20,6,1573,18.7
13197,Marion County,2021-03-21,2,1575,18.7
13197,Marion County,2021-03-22,22,1597,18.9
13197,Marion County,2021-03-23,17,1614,19.1
13197,Marion County,2021-03-24,46,1660,19.7
13197,Marion County,2021-03-25,26,1686,20
13197,Marion County,2021-03-26,54,1740,20.6
13197,Marion County,2021-03-27,9,1749,20.7
13197,Marion County,2021-03-28,6,1755,20.8
13197,Marion County,2021-03-29,18,1773,21
13197,Marion County,2021-03-30,13,1786,21.2
13197,Marion County,2021-03-31,36,1822,21.6
13197,Marion County,2021-04-01,25,1847,21.9
13197,Marion County,2021-04-02,18,1865,22.1
13197,Marion County,2021-04-03,8,1873,22.2
13197,Marion County,2021-04-04,7,1880,22.3
13197,Marion County,2021-04-05,23,1903,22.6
13197,Marion County,2021-04-06,23,1926,22.8
13197,Marion County,2021-04-07,28,1954,23.2
13197,Marion County,2021-04-08,45,1999,23.7
13197,Marion County,2021-04-09,30,2029,24.1
13197,Marion County,2021-04-10,11,2040,24.2
13197,Marion County,2021-04-11,4,2044,24.2
13197,Marion County,2021-04-12,28,2072,24.6
13197,Marion County,2021-04-13,11,2083,24.7
13197,Marion County,2021-04-14,23,2106,25
13197,Marion County,2021-04-15,18,2124,25.2
13197,Marion County,2021-04-16,30,2154,25.5
13197,Marion County,2021-04-17,5,2159,25.6
13197,Marion County,2021-04-18,3,2162,25.6
13197,Marion County,2021-04-19,14,2176,25.8
13197,Marion County,2021-04-20,17,2193,26
13197,Marion County,2021-04-21,17,2210,26.2
13197,Marion County,2021-04-22,24,2234,26.5
13197,Marion County,2021-04-23,16,2250,26.7
13197,Marion County,2021-04-24,3,2253,26.7
13197,Marion County,2021-04-25,1,2254,26.7
13197,Marion County,2021-04-26,11,2265,26.9
13197,Marion County,2021-04-27,6,2271,26.9
13197,Marion County,2021-04-28,15,2286,27.1
13197,Marion County,2021-04-29,25,2311,27.4
13197,Marion County,2021-04-30,15,2326,27.6
13197,Marion County,2021-05-01,5,2331,27.6
13197,Marion County,2021-05-02,1,2332,27.7
13197,Marion County,2021-05-03,6,2338,27.7
13197,Marion County,2021-05-04,5,2343,27.8
13197,Marion County,2021-05-05,6,2349,27.9
13197,Marion County,2021-05-06,20,2369,28.1
13197,Marion County,2021-05-07,10,2379,28.2
13197,Marion County,2021-05-08,3,2382,28.2
13197,Marion County,2021-05-10,3,2385,28.3
13197,Marion County,2021-05-11,8,2393,28.4
13197,Marion County,2021-05-12,10,2403,28.5
13197,Marion County,2021-05-13,18,2421,28.7
13197,Marion County,2021-05-14,11,2432,28.8
13197,Marion County,2021-05-15,12,2444,29
13197,Marion County,2021-05-16,3,2447,29
13197,Marion County,2021-05-17,5,2452,29.1
13197,Marion County,2021-05-18,19,2471,29.3
13197,Marion County,2021-05-19,19,2490,29.5
13197,Marion County,2021-05-20,16,2506,29.7
13197,Marion County,2021-05-21,13,2519,29.9
13197,Marion County,2021-05-22,6,2525,29.9
13197,Marion County,2021-05-23,4,2529,30
13197,Marion County,2021-05-24,10,2539,30.1
13197,Marion County,2021-05-25,8,2547,30.2
13197,Marion County,2021-05-26,16,2563,30.4
13197,Marion County,2021-05-27,12,2575,30.5
13197,Marion County,2021-05-28,5,2580,30.6
13197,Marion County,2021-05-29,4,2584,30.6
13197,Marion County,2021-05-30,2,2586,30.7
13197,Marion County,2021-05-31,1,2587,30.7
13197,Marion County,2021-06-01,5,2592,30.7
13197,Marion County,2021-06-02,17,2609,30.9
13197,Marion County,2021-06-03,6,2615,31
13197,Marion County,2021-06-04,5,2620,31.1
13197,Marion County,2021-06-05,10,2630,31.2
13197,Marion County,2021-06-07,4,2634,31.2
13197,Marion County,2021-06-08,9,2643,31.3
13197,Marion County,2021-06-09,14,2657,31.5
13197,Marion County,2021-06-10,10,2667,31.6
13197,Marion County,2021-06-11,7,2674,31.7
13197,Marion County,2021-06-12,3,2677,31.7
13197,Marion County,2021-06-13,1,2678,31.8
13197,Marion County,2021-06-14,5,2683,31.8
13197,Marion County,2021-06-15,7,2690,31.9
13197,Marion County,2021-06-16,6,2696,32
13197,Marion County,2021-06-17,11,2707,32.1
13197,Marion County,2021-06-18,2,2709,32.1
13197,Marion County,2021-06-21,2,2711,32.2
13197,Marion County,2021-06-22,6,2717,32.2
13197,Marion County,2021-06-23,8,2725,32.3
13197,Marion County,2021-06-24,9,2734,32.4
13197,Marion County,2021-06-25,9,2743,32.5
13197,Marion County,2021-06-26,4,2747,32.6
13197,Marion County,2021-06-27,1,2748,32.6
13197,Marion County,2021-06-28,4,2752,32.6
13197,Marion County,2021-06-29,3,2755,32.7
13197,Marion County,2021-06-30,6,2761,32.7
13197,Marion County,2021-07-01,10,2771,32.9
13197,Marion County,2021-07-02,3,2774,32.9
13197,Marion County,2021-07-03,1,2775,32.9
13197,Marion County,2021-07-04,1,2776,32.9
13197,Marion County,2021-07-05,1,2777,32.9
13197,Marion County,2021-07-06,4,2781,33
13197,Marion County,2021-07-07,6,2787,33.1
13197,Marion County,2021-07-08,3,2790,33.1
13197,Marion County,2021-07-09,2,2792,33.1
13197,Marion County,2021-07-11,1,2793,33.1
13197,Marion County,2021-07-12,2,2795,33.1
13197,Marion County,2021-07-13,4,2799,33.2
13197,Marion County,2021-07-14,2,2801,33.2
13197,Marion County,2021-07-15,6,2807,33.3
13197,Marion County,2021-07-16,3,2810,33.3
13197,Marion County,2021-07-17,5,2815,33.4
13197,Marion County,2021-07-18,2,2817,33.4
13197,Marion County,2021-07-19,11,2828,33.5
13197,Marion County,2021-07-20,9,2837,33.6
13197,Marion County,2021-07-21,9,2846,33.8
13197,Marion County,2021-07-22,30,2876,34.1
13197,Marion County,2021-07-23,9,2885,34.2
13197,Marion County,2021-07-24,7,2892,34.3
13197,Marion County,2021-07-25,1,2893,34.3
13197,Marion County,2021-07-26,20,2913,34.5
13197,Marion County,2021-07-27,4,2917,34.6
13197,Marion County,2021-07-28,17,2934,34.8
13197,Marion County,2021-07-29,29,2963,35.1
13197,Marion County,2021-07-30,12,2975,35.3
13197,Marion County,2021-07-31,8,2983,35.4
13197,Marion County,2021-08-01,5,2988,35.4
13197,Marion County,2021-08-02,7,2995,35.5
13197,Marion County,2021-08-03,5,3000,35.6
13197,Marion County,2021-08-04,12,3012,35.7
13197,Marion County,2021-08-05,22,3034,36
13197,Marion County,2021-08-06,9,3043,36.1
13197,Marion County,2021-08-07,42,3085,36.6
13197,Marion County,2021-08-09,8,3093,36.7
13197,Marion County,2021-08-10,11,3104,36.8
13197,Marion County,2021-08-11,11,3115,36.9
13197,Marion County,2021-08-12,10,3125,37.1
13197,Marion County,2021-08-13,17,3142,37.3
13197,Marion County,2021-08-14,13,3155,37.4
13197,Marion County,2021-08-15,4,3159,37.5
13197,Marion County,2021-08-16,7,3166,37.5
13197,Marion County,2021-08-17,5,3171,37.6
13197,Marion County,2021-08-18,21,3192,37.9
13197,Marion County,2021-08-19,26,3218,38.2
13197,Marion County,2021-08-20,9,3227,38.3
13197,Marion County,2021-08-21,3,3230,38.3
13197,Marion County,2021-08-22,2,3232,38.3
13197,Marion County,2021-08-23,14,3246,38.5
13197,Marion County,2021-08-24,10,3256,38.6
13197,Marion County,2021-08-25,5,3261,38.7
13197,Marion County,2021-08-26,39,3300,39.1
13197,Marion County,2021-08-27,13,3313,39.3
13197,Marion County,2021-08-28,18,3331,39.5
13197,Marion County,2021-08-29,3,3334,39.5
13197,Marion County,2021-08-30,11,3345,39.7
13197,Marion County,2021-08-31,14,3359,39.8
13197,Marion County,2021-09-01,11,3370,40
13197,Marion County,2021-09-02,26,3396,40.3
13197,Marion County,2021-09-03,14,3410,40.4
13197,Marion County,2021-09-04,8,3418,40.5
13197,Marion County,2021-09-05,3,3421,40.6
13197,Marion County,2021-09-06,1,3422,40.6
13197,Marion County,2021-09-07,9,3431,40.7
13197,Marion County,2021-09-08,5,3436,40.7
13197,Marion County,2021-09-09,20,3456,41
13197,Marion County,2021-09-10,15,3471,41.2
13197,Marion County,2021-09-11,3,3474,41.2
13197,Marion County,2021-09-13,8,3482,41.3
13197,Marion County,2021-09-14,6,3488,41.4
13197,Marion County,2021-09-15,10,3498,41.5
13197,Marion County,2021-09-16,8,3506,41.6
13197,Marion County,2021-09-17,12,3518,41.7
13197,Marion County,2021-09-18,7,3525,41.8
13197,Marion County,2021-09-19,4,3529,41.9
13197,Marion County,2021-09-20,10,3539,42
13197,Marion County,2021-09-21,2,3541,42
13197,Marion County,2021-09-22,4,3545,42
13197,Marion County,2021-09-23,12,3557,42.2
13197,Marion County,2021-09-24,7,3564,42.3
13197,Marion County,2021-09-25,1,3565,42.3
13197,Marion County,2021-09-26,1,3566,42.3
13197,Marion County,2021-09-27,2,3568,42.3
13197,Marion County,2021-09-28,2,3570,42.3
13197,Marion County,2021-09-29,3,3573,42.4
13197,Marion County,2021-09-30,4,3577,42.4
13197,Marion County,2021-10-01,8,3585,42.5
13197,Marion County,2021-10-02,1,3586,42.5
13197,Marion County,2021-10-04,5,3591,42.6
13197,Marion County,2021-10-05,6,3597,42.7
13197,Marion County,2021-10-06,6,3603,42.7
13197,Marion County,2021-10-07,4,3607,42.8
13199,Meriwether County,2020-12-19,1,1,0
13199,Meriwether County,2020-12-21,2,3,0
13199,Meriwether County,2020-12-22,6,9,0
13199,Meriwether County,2020-12-23,8,17,0.1
13199,Meriwether County,2020-12-24,1,18,0.1
13199,Meriwether County,2020-12-26,4,22,0.1
13199,Meriwether County,2020-12-27,2,24,0.1
13199,Meriwether County,2020-12-28,18,42,0.2
13199,Meriwether County,2020-12-29,28,70,0.3
13199,Meriwether County,2020-12-30,48,118,0.6
13199,Meriwether County,2020-12-31,11,129,0.6
13199,Meriwether County,2021-01-01,3,132,0.6
13199,Meriwether County,2021-01-02,1,133,0.6
13199,Meriwether County,2021-01-03,2,135,0.6
13199,Meriwether County,2021-01-04,35,170,0.8
13199,Meriwether County,2021-01-05,20,190,0.9
13199,Meriwether County,2021-01-06,16,206,1
13199,Meriwether County,2021-01-07,38,244,1.2
13199,Meriwether County,2021-01-08,14,258,1.2
13199,Meriwether County,2021-01-09,5,263,1.2
13199,Meriwether County,2021-01-10,5,268,1.3
13199,Meriwether County,2021-01-11,25,293,1.4
13199,Meriwether County,2021-01-12,146,439,2.1
13199,Meriwether County,2021-01-13,42,481,2.3
13199,Meriwether County,2021-01-14,52,533,2.5
13199,Meriwether County,2021-01-15,52,585,2.8
13199,Meriwether County,2021-01-16,13,598,2.8
13199,Meriwether County,2021-01-17,26,624,3
13199,Meriwether County,2021-01-18,70,694,3.3
13199,Meriwether County,2021-01-19,80,774,3.7
13199,Meriwether County,2021-01-20,93,867,4.1
13199,Meriwether County,2021-01-21,59,926,4.4
13199,Meriwether County,2021-01-22,78,1004,4.8
13199,Meriwether County,2021-01-23,15,1019,4.8
13199,Meriwether County,2021-01-24,7,1026,4.9
13199,Meriwether County,2021-01-25,40,1066,5.1
13199,Meriwether County,2021-01-26,78,1144,5.4
13199,Meriwether County,2021-01-27,57,1201,5.7
13199,Meriwether County,2021-01-28,47,1248,5.9
13199,Meriwether County,2021-01-29,122,1370,6.5
13199,Meriwether County,2021-01-30,9,1379,6.5
13199,Meriwether County,2021-01-31,2,1381,6.5
13199,Meriwether County,2021-02-01,28,1409,6.7
13199,Meriwether County,2021-02-02,43,1452,6.9
13199,Meriwether County,2021-02-03,51,1503,7.1
13199,Meriwether County,2021-02-04,114,1617,7.7
13199,Meriwether County,2021-02-05,5,1622,7.7
13199,Meriwether County,2021-02-06,3,1625,7.7
13199,Meriwether County,2021-02-07,19,1644,7.8
13199,Meriwether County,2021-02-08,20,1664,7.9
13199,Meriwether County,2021-02-09,31,1695,8
13199,Meriwether County,2021-02-10,68,1763,8.4
13199,Meriwether County,2021-02-11,114,1877,8.9
13199,Meriwether County,2021-02-12,19,1896,9
13199,Meriwether County,2021-02-13,4,1900,9
13199,Meriwether County,2021-02-14,9,1909,9
13199,Meriwether County,2021-02-15,7,1916,9.1
13199,Meriwether County,2021-02-16,25,1941,9.2
13199,Meriwether County,2021-02-17,39,1980,9.4
13199,Meriwether County,2021-02-18,155,2135,10.1
13199,Meriwether County,2021-02-19,17,2152,10.2
13199,Meriwether County,2021-02-20,3,2155,10.2
13199,Meriwether County,2021-02-22,32,2187,10.4
13199,Meriwether County,2021-02-23,48,2235,10.6
13199,Meriwether County,2021-02-24,41,2276,10.8
13199,Meriwether County,2021-02-25,61,2337,11.1
13199,Meriwether County,2021-02-26,40,2377,11.3
13199,Meriwether County,2021-02-27,7,2384,11.3
13199,Meriwether County,2021-02-28,8,2392,11.3
13199,Meriwether County,2021-03-01,22,2414,11.4
13199,Meriwether County,2021-03-02,47,2461,11.7
13199,Meriwether County,2021-03-03,71,2532,12
13199,Meriwether County,2021-03-04,56,2588,12.3
13199,Meriwether County,2021-03-05,66,2654,12.6
13199,Meriwether County,2021-03-06,7,2661,12.6
13199,Meriwether County,2021-03-07,8,2669,12.6
13199,Meriwether County,2021-03-08,62,2731,12.9
13199,Meriwether County,2021-03-09,73,2804,13.3
13199,Meriwether County,2021-03-10,64,2868,13.6
13199,Meriwether County,2021-03-11,92,2960,14
13199,Meriwether County,2021-03-12,83,3043,14.4
13199,Meriwether County,2021-03-13,11,3054,14.5
13199,Meriwether County,2021-03-14,5,3059,14.5
13199,Meriwether County,2021-03-15,83,3142,14.9
13199,Meriwether County,2021-03-16,83,3225,15.3
13199,Meriwether County,2021-03-17,93,3318,15.7
13199,Meriwether County,2021-03-18,166,3484,16.5
13199,Meriwether County,2021-03-19,152,3636,17.2
13199,Meriwether County,2021-03-20,13,3649,17.3
13199,Meriwether County,2021-03-21,13,3662,17.4
13199,Meriwether County,2021-03-22,48,3710,17.6
13199,Meriwether County,2021-03-23,70,3780,17.9
13199,Meriwether County,2021-03-24,89,3869,18.3
13199,Meriwether County,2021-03-25,159,4028,19.1
13199,Meriwether County,2021-03-26,73,4101,19.4
13199,Meriwether County,2021-03-27,50,4151,19.7
13199,Meriwether County,2021-03-28,16,4167,19.7
13199,Meriwether County,2021-03-29,49,4216,20
13199,Meriwether County,2021-03-30,59,4275,20.3
13199,Meriwether County,2021-03-31,88,4363,20.7
13199,Meriwether County,2021-04-01,185,4548,21.5
13199,Meriwether County,2021-04-02,46,4594,21.8
13199,Meriwether County,2021-04-03,18,4612,21.9
13199,Meriwether County,2021-04-04,14,4626,21.9
13199,Meriwether County,2021-04-05,44,4670,22.1
13199,Meriwether County,2021-04-06,72,4742,22.5
13199,Meriwether County,2021-04-07,109,4851,23
13199,Meriwether County,2021-04-08,105,4956,23.5
13199,Meriwether County,2021-04-09,94,5050,23.9
13199,Meriwether County,2021-04-10,31,5081,24.1
13199,Meriwether County,2021-04-11,18,5099,24.2
13199,Meriwether County,2021-04-12,47,5146,24.4
13199,Meriwether County,2021-04-13,38,5184,24.6
13199,Meriwether County,2021-04-14,63,5247,24.9
13199,Meriwether County,2021-04-15,46,5293,25.1
13199,Meriwether County,2021-04-16,30,5323,25.2
13199,Meriwether County,2021-04-17,10,5333,25.3
13199,Meriwether County,2021-04-18,10,5343,25.3
13199,Meriwether County,2021-04-19,38,5381,25.5
13199,Meriwether County,2021-04-20,52,5433,25.7
13199,Meriwether County,2021-04-21,58,5491,26
13199,Meriwether County,2021-04-22,54,5545,26.3
13199,Meriwether County,2021-04-23,69,5614,26.6
13199,Meriwether County,2021-04-24,9,5623,26.6
13199,Meriwether County,2021-04-25,3,5626,26.7
13199,Meriwether County,2021-04-26,22,5648,26.8
13199,Meriwether County,2021-04-27,25,5673,26.9
13199,Meriwether County,2021-04-28,36,5709,27
13199,Meriwether County,2021-04-29,104,5813,27.5
13199,Meriwether County,2021-04-30,28,5841,27.7
13199,Meriwether County,2021-05-01,20,5861,27.8
13199,Meriwether County,2021-05-02,6,5867,27.8
13199,Meriwether County,2021-05-03,21,5888,27.9
13199,Meriwether County,2021-05-04,37,5925,28.1
13199,Meriwether County,2021-05-05,57,5982,28.3
13199,Meriwether County,2021-05-06,55,6037,28.6
13199,Meriwether County,2021-05-07,49,6086,28.8
13199,Meriwether County,2021-05-08,16,6102,28.9
13199,Meriwether County,2021-05-09,8,6110,28.9
13199,Meriwether County,2021-05-10,25,6135,29.1
13199,Meriwether County,2021-05-11,39,6174,29.3
13199,Meriwether County,2021-05-12,25,6199,29.4
13199,Meriwether County,2021-05-13,27,6226,29.5
13199,Meriwether County,2021-05-14,30,6256,29.6
13199,Meriwether County,2021-05-15,14,6270,29.7
13199,Meriwether County,2021-05-16,14,6284,29.8
13199,Meriwether County,2021-05-17,26,6310,29.9
13199,Meriwether County,2021-05-18,41,6351,30.1
13199,Meriwether County,2021-05-19,28,6379,30.2
13199,Meriwether County,2021-05-20,76,6455,30.6
13199,Meriwether County,2021-05-21,32,6487,30.7
13199,Meriwether County,2021-05-22,15,6502,30.8
13199,Meriwether County,2021-05-23,18,6520,30.9
13199,Meriwether County,2021-05-24,26,6546,31
13199,Meriwether County,2021-05-25,16,6562,31.1
13199,Meriwether County,2021-05-26,30,6592,31.2
13199,Meriwether County,2021-05-27,25,6617,31.4
13199,Meriwether County,2021-05-28,13,6630,31.4
13199,Meriwether County,2021-05-29,6,6636,31.4
13199,Meriwether County,2021-05-30,1,6637,31.4
13199,Meriwether County,2021-05-31,2,6639,31.5
13199,Meriwether County,2021-06-01,15,6654,31.5
13199,Meriwether County,2021-06-02,19,6673,31.6
13199,Meriwether County,2021-06-03,29,6702,31.8
13199,Meriwether County,2021-06-04,25,6727,31.9
13199,Meriwether County,2021-06-05,10,6737,31.9
13199,Meriwether County,2021-06-06,5,6742,31.9
13199,Meriwether County,2021-06-07,18,6760,32
13199,Meriwether County,2021-06-08,18,6778,32.1
13199,Meriwether County,2021-06-09,15,6793,32.2
13199,Meriwether County,2021-06-10,21,6814,32.3
13199,Meriwether County,2021-06-11,30,6844,32.4
13199,Meriwether County,2021-06-12,15,6859,32.5
13199,Meriwether County,2021-06-13,4,6863,32.5
13199,Meriwether County,2021-06-14,11,6874,32.6
13199,Meriwether County,2021-06-15,19,6893,32.7
13199,Meriwether County,2021-06-16,13,6906,32.7
13199,Meriwether County,2021-06-17,17,6923,32.8
13199,Meriwether County,2021-06-18,20,6943,32.9
13199,Meriwether County,2021-06-19,10,6953,32.9
13199,Meriwether County,2021-06-20,3,6956,33
13199,Meriwether County,2021-06-21,14,6970,33
13199,Meriwether County,2021-06-22,9,6979,33.1
13199,Meriwether County,2021-06-23,10,6989,33.1
13199,Meriwether County,2021-06-24,6,6995,33.1
13199,Meriwether County,2021-06-25,24,7019,33.3
13199,Meriwether County,2021-06-26,1,7020,33.3
13199,Meriwether County,2021-06-27,1,7021,33.3
13199,Meriwether County,2021-06-28,5,7026,33.3
13199,Meriwether County,2021-06-29,8,7034,33.3
13199,Meriwether County,2021-06-30,8,7042,33.4
13199,Meriwether County,2021-07-01,22,7064,33.5
13199,Meriwether County,2021-07-02,13,7077,33.5
13199,Meriwether County,2021-07-03,2,7079,33.5
13199,Meriwether County,2021-07-05,6,7085,33.6
13199,Meriwether County,2021-07-06,13,7098,33.6
13199,Meriwether County,2021-07-07,10,7108,33.7
13199,Meriwether County,2021-07-08,17,7125,33.8
13199,Meriwether County,2021-07-09,11,7136,33.8
13199,Meriwether County,2021-07-10,6,7142,33.8
13199,Meriwether County,2021-07-11,5,7147,33.9
13199,Meriwether County,2021-07-12,10,7157,33.9
13199,Meriwether County,2021-07-13,19,7176,34
13199,Meriwether County,2021-07-14,14,7190,34.1
13199,Meriwether County,2021-07-15,7,7197,34.1
13199,Meriwether County,2021-07-16,13,7210,34.2
13199,Meriwether County,2021-07-17,13,7223,34.2
13199,Meriwether County,2021-07-18,6,7229,34.3
13199,Meriwether County,2021-07-19,18,7247,34.3
13199,Meriwether County,2021-07-20,11,7258,34.4
13199,Meriwether County,2021-07-21,19,7277,34.5
13199,Meriwether County,2021-07-22,18,7295,34.6
13199,Meriwether County,2021-07-23,26,7321,34.7
13199,Meriwether County,2021-07-24,23,7344,34.8
13199,Meriwether County,2021-07-25,15,7359,34.9
13199,Meriwether County,2021-07-26,21,7380,35
13199,Meriwether County,2021-07-27,17,7397,35
13199,Meriwether County,2021-07-28,25,7422,35.2
13199,Meriwether County,2021-07-29,24,7446,35.3
13199,Meriwether County,2021-07-30,31,7477,35.4
13199,Meriwether County,2021-07-31,11,7488,35.5
13199,Meriwether County,2021-08-01,8,7496,35.5
13199,Meriwether County,2021-08-02,35,7531,35.7
13199,Meriwether County,2021-08-03,36,7567,35.9
13199,Meriwether County,2021-08-04,45,7612,36.1
13199,Meriwether County,2021-08-05,27,7639,36.2
13199,Meriwether County,2021-08-06,51,7690,36.4
13199,Meriwether County,2021-08-07,17,7707,36.5
13199,Meriwether County,2021-08-08,14,7721,36.6
13199,Meriwether County,2021-08-09,43,7764,36.8
13199,Meriwether County,2021-08-10,44,7808,37
13199,Meriwether County,2021-08-11,46,7854,37.2
13199,Meriwether County,2021-08-12,23,7877,37.3
13199,Meriwether County,2021-08-13,43,7920,37.5
13199,Meriwether County,2021-08-14,13,7933,37.6
13199,Meriwether County,2021-08-15,9,7942,37.6
13199,Meriwether County,2021-08-16,38,7980,37.8
13199,Meriwether County,2021-08-17,35,8015,38
13199,Meriwether County,2021-08-18,39,8054,38.2
13199,Meriwether County,2021-08-19,22,8076,38.3
13199,Meriwether County,2021-08-20,51,8127,38.5
13199,Meriwether County,2021-08-21,22,8149,38.6
13199,Meriwether County,2021-08-22,21,8170,38.7
13199,Meriwether County,2021-08-23,32,8202,38.9
13199,Meriwether County,2021-08-24,37,8239,39
13199,Meriwether County,2021-08-25,50,8289,39.3
13199,Meriwether County,2021-08-26,43,8332,39.5
13199,Meriwether County,2021-08-27,57,8389,39.7
13199,Meriwether County,2021-08-28,36,8425,39.9
13199,Meriwether County,2021-08-29,9,8434,40
13199,Meriwether County,2021-08-30,35,8469,40.1
13199,Meriwether County,2021-08-31,32,8501,40.3
13199,Meriwether County,2021-09-01,35,8536,40.4
13199,Meriwether County,2021-09-02,38,8574,40.6
13199,Meriwether County,2021-09-03,42,8616,40.8
13199,Meriwether County,2021-09-04,20,8636,40.9
13199,Meriwether County,2021-09-05,15,8651,41
13199,Meriwether County,2021-09-06,2,8653,41
13199,Meriwether County,2021-09-07,40,8693,41.2
13199,Meriwether County,2021-09-08,35,8728,41.4
13199,Meriwether County,2021-09-09,49,8777,41.6
13199,Meriwether County,2021-09-10,44,8821,41.8
13199,Meriwether County,2021-09-11,22,8843,41.9
13199,Meriwether County,2021-09-12,17,8860,42
13199,Meriwether County,2021-09-13,56,8916,42.2
13199,Meriwether County,2021-09-14,26,8942,42.4
13199,Meriwether County,2021-09-15,36,8978,42.5
13199,Meriwether County,2021-09-16,25,9003,42.7
13199,Meriwether County,2021-09-17,38,9041,42.8
13199,Meriwether County,2021-09-18,30,9071,43
13199,Meriwether County,2021-09-19,18,9089,43.1
13199,Meriwether County,2021-09-20,26,9115,43.2
13199,Meriwether County,2021-09-21,19,9134,43.3
13199,Meriwether County,2021-09-22,25,9159,43.4
13199,Meriwether County,2021-09-23,27,9186,43.5
13199,Meriwether County,2021-09-24,21,9207,43.6
13199,Meriwether County,2021-09-25,8,9215,43.7
13199,Meriwether County,2021-09-26,4,9219,43.7
13199,Meriwether County,2021-09-27,15,9234,43.8
13199,Meriwether County,2021-09-28,11,9245,43.8
13199,Meriwether County,2021-09-29,13,9258,43.9
13199,Meriwether County,2021-09-30,9,9267,43.9
13199,Meriwether County,2021-10-01,12,9279,44
13199,Meriwether County,2021-10-02,7,9286,44
13199,Meriwether County,2021-10-03,3,9289,44
13199,Meriwether County,2021-10-04,7,9296,44
13199,Meriwether County,2021-10-05,6,9302,44.1
13199,Meriwether County,2021-10-06,5,9307,44.1
13199,Meriwether County,2021-10-07,7,9314,44.1
13201,Miller County,2020-12-18,1,1,0
13201,Miller County,2020-12-21,1,2,0
13201,Miller County,2020-12-22,3,5,0.1
13201,Miller County,2020-12-23,19,24,0.4
13201,Miller County,2020-12-24,2,26,0.4
13201,Miller County,2020-12-26,1,27,0.5
13201,Miller County,2020-12-27,8,35,0.6
13201,Miller County,2020-12-28,65,100,1.7
13201,Miller County,2020-12-29,46,146,2.5
13201,Miller County,2020-12-30,23,169,2.9
13201,Miller County,2020-12-31,15,184,3.2
13201,Miller County,2021-01-01,8,192,3.3
13201,Miller County,2021-01-04,32,224,3.9
13201,Miller County,2021-01-05,28,252,4.4
13201,Miller County,2021-01-06,14,266,4.6
13201,Miller County,2021-01-07,29,295,5.1
13201,Miller County,2021-01-08,11,306,5.3
13201,Miller County,2021-01-09,1,307,5.3
13201,Miller County,2021-01-11,89,396,6.8
13201,Miller County,2021-01-12,113,509,8.8
13201,Miller County,2021-01-13,106,615,10.6
13201,Miller County,2021-01-14,109,724,12.5
13201,Miller County,2021-01-15,45,769,13.3
13201,Miller County,2021-01-16,1,770,13.3
13201,Miller County,2021-01-18,85,855,14.8
13201,Miller County,2021-01-19,50,905,15.6
13201,Miller County,2021-01-20,13,918,15.9
13201,Miller County,2021-01-21,59,977,16.9
13201,Miller County,2021-01-22,10,987,17.1
13201,Miller County,2021-01-23,2,989,17.1
13201,Miller County,2021-01-25,21,1010,17.5
13201,Miller County,2021-01-26,16,1026,17.7
13201,Miller County,2021-01-27,30,1056,18.2
13201,Miller County,2021-01-28,29,1085,18.7
13201,Miller County,2021-01-29,7,1092,18.9
13201,Miller County,2021-02-01,20,1112,19.2
13201,Miller County,2021-02-02,26,1138,19.7
13201,Miller County,2021-02-03,13,1151,19.9
13201,Miller County,2021-02-04,8,1159,20
13201,Miller County,2021-02-05,3,1162,20.1
13201,Miller County,2021-02-06,1,1163,20.1
13201,Miller County,2021-02-08,18,1181,20.4
13201,Miller County,2021-02-09,12,1193,20.6
13201,Miller County,2021-02-10,14,1207,20.9
13201,Miller County,2021-02-11,7,1214,21
13201,Miller County,2021-02-12,5,1219,21.1
13201,Miller County,2021-02-15,14,1233,21.3
13201,Miller County,2021-02-16,16,1249,21.6
13201,Miller County,2021-02-17,15,1264,21.8
13201,Miller County,2021-02-18,23,1287,22.2
13201,Miller County,2021-02-22,18,1305,22.6
13201,Miller County,2021-02-23,9,1314,22.7
13201,Miller County,2021-02-24,13,1327,22.9
13201,Miller County,2021-02-25,16,1343,23.2
13201,Miller County,2021-02-26,5,1348,23.3
13201,Miller County,2021-02-27,4,1352,23.4
13201,Miller County,2021-02-28,2,1354,23.4
13201,Miller County,2021-03-01,8,1362,23.5
13201,Miller County,2021-03-02,7,1369,23.7
13201,Miller County,2021-03-03,7,1376,23.8
13201,Miller County,2021-03-04,10,1386,24
13201,Miller County,2021-03-05,3,1389,24
13201,Miller County,2021-03-06,2,1391,24
13201,Miller County,2021-03-07,1,1392,24.1
13201,Miller County,2021-03-08,24,1416,24.5
13201,Miller County,2021-03-09,32,1448,25
13201,Miller County,2021-03-10,17,1465,25.3
13201,Miller County,2021-03-11,24,1489,25.7
13201,Miller County,2021-03-12,32,1521,26.3
13201,Miller County,2021-03-13,1,1522,26.3
13201,Miller County,2021-03-14,1,1523,26.3
13201,Miller County,2021-03-15,31,1554,26.9
13201,Miller County,2021-03-16,21,1575,27.2
13201,Miller County,2021-03-17,29,1604,27.7
13201,Miller County,2021-03-18,22,1626,28.1
13201,Miller County,2021-03-19,20,1646,28.4
13201,Miller County,2021-03-20,4,1650,28.5
13201,Miller County,2021-03-21,3,1653,28.6
13201,Miller County,2021-03-22,24,1677,29
13201,Miller County,2021-03-23,18,1695,29.3
13201,Miller County,2021-03-24,15,1710,29.5
13201,Miller County,2021-03-25,37,1747,30.2
13201,Miller County,2021-03-26,6,1753,30.3
13201,Miller County,2021-03-27,4,1757,30.4
13201,Miller County,2021-03-28,2,1759,30.4
13201,Miller County,2021-03-29,32,1791,30.9
13201,Miller County,2021-03-30,14,1805,31.2
13201,Miller County,2021-03-31,66,1871,32.3
13201,Miller County,2021-04-01,12,1883,32.5
13201,Miller County,2021-04-02,6,1889,32.6
13201,Miller County,2021-04-03,1,1890,32.7
13201,Miller County,2021-04-04,3,1893,32.7
13201,Miller County,2021-04-05,15,1908,33
13201,Miller County,2021-04-06,7,1915,33.1
13201,Miller County,2021-04-07,13,1928,33.3
13201,Miller County,2021-04-08,9,1937,33.5
13201,Miller County,2021-04-09,9,1946,33.6
13201,Miller County,2021-04-10,2,1948,33.7
13201,Miller County,2021-04-11,2,1950,33.7
13201,Miller County,2021-04-12,12,1962,33.9
13201,Miller County,2021-04-13,15,1977,34.2
13201,Miller County,2021-04-14,11,1988,34.4
13201,Miller County,2021-04-15,14,2002,34.6
13201,Miller County,2021-04-16,7,2009,34.7
13201,Miller County,2021-04-17,2,2011,34.8
13201,Miller County,2021-04-18,1,2012,34.8
13201,Miller County,2021-04-19,6,2018,34.9
13201,Miller County,2021-04-20,11,2029,35.1
13201,Miller County,2021-04-21,8,2037,35.2
13201,Miller County,2021-04-22,4,2041,35.3
13201,Miller County,2021-04-23,6,2047,35.4
13201,Miller County,2021-04-24,2,2049,35.4
13201,Miller County,2021-04-26,5,2054,35.5
13201,Miller County,2021-04-27,11,2065,35.7
13201,Miller County,2021-04-28,8,2073,35.8
13201,Miller County,2021-04-29,9,2082,36
13201,Miller County,2021-04-30,2,2084,36
13201,Miller County,2021-05-01,2,2086,36
13201,Miller County,2021-05-02,2,2088,36.1
13201,Miller County,2021-05-03,4,2092,36.1
13201,Miller County,2021-05-04,9,2101,36.3
13201,Miller County,2021-05-05,9,2110,36.5
13201,Miller County,2021-05-06,6,2116,36.6
13201,Miller County,2021-05-07,7,2123,36.7
13201,Miller County,2021-05-08,1,2124,36.7
13201,Miller County,2021-05-10,8,2132,36.8
13201,Miller County,2021-05-11,2,2134,36.9
13201,Miller County,2021-05-12,4,2138,36.9
13201,Miller County,2021-05-13,11,2149,37.1
13201,Miller County,2021-05-14,3,2152,37.2
13201,Miller County,2021-05-15,2,2154,37.2
13201,Miller County,2021-05-17,7,2161,37.3
13201,Miller County,2021-05-18,15,2176,37.6
13201,Miller County,2021-05-19,8,2184,37.7
13201,Miller County,2021-05-20,5,2189,37.8
13201,Miller County,2021-05-21,2,2191,37.9
13201,Miller County,2021-05-22,3,2194,37.9
13201,Miller County,2021-05-23,4,2198,38
13201,Miller County,2021-05-24,10,2208,38.2
13201,Miller County,2021-05-25,17,2225,38.4
13201,Miller County,2021-05-27,6,2231,38.6
13201,Miller County,2021-05-28,2,2233,38.6
13201,Miller County,2021-05-30,1,2234,38.6
13201,Miller County,2021-06-01,5,2239,38.7
13201,Miller County,2021-06-02,7,2246,38.8
13201,Miller County,2021-06-03,6,2252,38.9
13201,Miller County,2021-06-05,5,2257,39
13201,Miller County,2021-06-06,3,2260,39.1
13201,Miller County,2021-06-07,4,2264,39.1
13201,Miller County,2021-06-08,6,2270,39.2
13201,Miller County,2021-06-09,1,2271,39.2
13201,Miller County,2021-06-10,2,2273,39.3
13201,Miller County,2021-06-11,5,2278,39.4
13201,Miller County,2021-06-12,2,2280,39.4
13201,Miller County,2021-06-14,4,2284,39.5
13201,Miller County,2021-06-15,4,2288,39.5
13201,Miller County,2021-06-16,2,2290,39.6
13201,Miller County,2021-06-17,2,2292,39.6
13201,Miller County,2021-06-18,2,2294,39.6
13201,Miller County,2021-06-19,2,2296,39.7
13201,Miller County,2021-06-21,6,2302,39.8
13201,Miller County,2021-06-22,5,2307,39.9
13201,Miller County,2021-06-23,3,2310,39.9
13201,Miller County,2021-06-24,5,2315,40
13201,Miller County,2021-06-25,2,2317,40
13201,Miller County,2021-06-28,3,2320,40.1
13201,Miller County,2021-06-29,5,2325,40.2
13201,Miller County,2021-06-30,7,2332,40.3
13201,Miller County,2021-07-01,2,2334,40.3
13201,Miller County,2021-07-02,1,2335,40.3
13201,Miller County,2021-07-03,1,2336,40.4
13201,Miller County,2021-07-06,4,2340,40.4
13201,Miller County,2021-07-07,2,2342,40.5
13201,Miller County,2021-07-08,4,2346,40.5
13201,Miller County,2021-07-09,4,2350,40.6
13201,Miller County,2021-07-10,3,2353,40.7
13201,Miller County,2021-07-11,1,2354,40.7
13201,Miller County,2021-07-12,3,2357,40.7
13201,Miller County,2021-07-13,4,2361,40.8
13201,Miller County,2021-07-14,6,2367,40.9
13201,Miller County,2021-07-15,3,2370,41
13201,Miller County,2021-07-16,4,2374,41
13201,Miller County,2021-07-17,2,2376,41.1
13201,Miller County,2021-07-18,1,2377,41.1
13201,Miller County,2021-07-19,6,2383,41.2
13201,Miller County,2021-07-20,11,2394,41.4
13201,Miller County,2021-07-21,5,2399,41.5
13201,Miller County,2021-07-22,12,2411,41.7
13201,Miller County,2021-07-23,7,2418,41.8
13201,Miller County,2021-07-24,5,2423,41.9
13201,Miller County,2021-07-25,1,2424,41.9
13201,Miller County,2021-07-26,12,2436,42.1
13201,Miller County,2021-07-27,17,2453,42.4
13201,Miller County,2021-07-28,15,2468,42.6
13201,Miller County,2021-07-29,12,2480,42.9
13201,Miller County,2021-07-30,15,2495,43.1
13201,Miller County,2021-07-31,6,2501,43.2
13201,Miller County,2021-08-02,33,2534,43.8
13201,Miller County,2021-08-03,25,2559,44.2
13201,Miller County,2021-08-04,19,2578,44.5
13201,Miller County,2021-08-05,21,2599,44.9
13201,Miller County,2021-08-06,19,2618,45.2
13201,Miller County,2021-08-07,7,2625,45.4
13201,Miller County,2021-08-08,3,2628,45.4
13201,Miller County,2021-08-09,19,2647,45.7
13201,Miller County,2021-08-10,28,2675,46.2
13201,Miller County,2021-08-11,19,2694,46.6
13201,Miller County,2021-08-12,39,2733,47.2
13201,Miller County,2021-08-13,26,2759,47.7
13201,Miller County,2021-08-14,2,2761,47.7
13201,Miller County,2021-08-15,2,2763,47.7
13201,Miller County,2021-08-16,31,2794,48.3
13201,Miller County,2021-08-17,31,2825,48.8
13201,Miller County,2021-08-18,28,2853,49.3
13201,Miller County,2021-08-19,16,2869,49.6
13201,Miller County,2021-08-20,27,2896,50
13201,Miller County,2021-08-21,11,2907,50.2
13201,Miller County,2021-08-23,25,2932,50.7
13201,Miller County,2021-08-24,16,2948,50.9
13201,Miller County,2021-08-25,25,2973,51.4
13201,Miller County,2021-08-26,16,2989,51.7
13201,Miller County,2021-08-27,14,3003,51.9
13201,Miller County,2021-08-28,7,3010,52
13201,Miller County,2021-08-29,5,3015,52.1
13201,Miller County,2021-08-30,20,3035,52.4
13201,Miller County,2021-08-31,18,3053,52.8
13201,Miller County,2021-09-01,10,3063,52.9
13201,Miller County,2021-09-02,18,3081,53.2
13201,Miller County,2021-09-03,20,3101,53.6
13201,Miller County,2021-09-04,3,3104,53.6
13201,Miller County,2021-09-05,6,3110,53.7
13201,Miller County,2021-09-07,10,3120,53.9
13201,Miller County,2021-09-08,9,3129,54.1
13201,Miller County,2021-09-09,20,3149,54.4
13201,Miller County,2021-09-10,8,3157,54.6
13201,Miller County,2021-09-11,2,3159,54.6
13201,Miller County,2021-09-12,2,3161,54.6
13201,Miller County,2021-09-13,10,3171,54.8
13201,Miller County,2021-09-14,8,3179,54.9
13201,Miller County,2021-09-15,3,3182,55
13201,Miller County,2021-09-16,6,3188,55.1
13201,Miller County,2021-09-17,5,3193,55.2
13201,Miller County,2021-09-18,1,3194,55.2
13201,Miller County,2021-09-19,2,3196,55.2
13201,Miller County,2021-09-20,12,3208,55.4
13201,Miller County,2021-09-21,7,3215,55.6
13201,Miller County,2021-09-22,6,3221,55.7
13201,Miller County,2021-09-23,6,3227,55.8
13201,Miller County,2021-09-24,3,3230,55.8
13201,Miller County,2021-09-25,2,3232,55.8
13201,Miller County,2021-09-26,2,3234,55.9
13201,Miller County,2021-09-27,2,3236,55.9
13201,Miller County,2021-09-28,3,3239,56
13201,Miller County,2021-09-29,3,3242,56
13201,Miller County,2021-09-30,7,3249,56.1
13201,Miller County,2021-10-01,3,3252,56.2
13201,Miller County,2021-10-04,1,3253,56.2
13201,Miller County,2021-10-05,3,3256,56.3
13201,Miller County,2021-10-06,1,3257,56.3
13201,Miller County,2021-10-07,1,3258,56.3
13205,Mitchell County,2020-12-16,1,1,0
13205,Mitchell County,2020-12-17,5,6,0
13205,Mitchell County,2020-12-18,13,19,0.1
13205,Mitchell County,2020-12-19,6,25,0.1
13205,Mitchell County,2020-12-20,3,28,0.1
13205,Mitchell County,2020-12-21,12,40,0.2
13205,Mitchell County,2020-12-22,30,70,0.3
13205,Mitchell County,2020-12-23,106,176,0.8
13205,Mitchell County,2020-12-24,2,178,0.8
13205,Mitchell County,2020-12-25,1,179,0.8
13205,Mitchell County,2020-12-28,35,214,1
13205,Mitchell County,2020-12-29,19,233,1
13205,Mitchell County,2020-12-30,30,263,1.2
13205,Mitchell County,2020-12-31,9,272,1.2
13205,Mitchell County,2021-01-01,3,275,1.2
13205,Mitchell County,2021-01-04,39,314,1.4
13205,Mitchell County,2021-01-05,42,356,1.6
13205,Mitchell County,2021-01-06,25,381,1.7
13205,Mitchell County,2021-01-07,36,417,1.9
13205,Mitchell County,2021-01-08,40,457,2.1
13205,Mitchell County,2021-01-09,4,461,2.1
13205,Mitchell County,2021-01-10,2,463,2.1
13205,Mitchell County,2021-01-11,87,550,2.5
13205,Mitchell County,2021-01-12,96,646,2.9
13205,Mitchell County,2021-01-13,117,763,3.4
13205,Mitchell County,2021-01-14,118,881,4
13205,Mitchell County,2021-01-15,137,1018,4.6
13205,Mitchell County,2021-01-16,19,1037,4.7
13205,Mitchell County,2021-01-17,1,1038,4.7
13205,Mitchell County,2021-01-18,109,1147,5.2
13205,Mitchell County,2021-01-19,151,1298,5.8
13205,Mitchell County,2021-01-20,107,1405,6.3
13205,Mitchell County,2021-01-21,155,1560,7
13205,Mitchell County,2021-01-22,113,1673,7.5
13205,Mitchell County,2021-01-23,58,1731,7.8
13205,Mitchell County,2021-01-25,155,1886,8.5
13205,Mitchell County,2021-01-26,136,2022,9.1
13205,Mitchell County,2021-01-27,103,2125,9.6
13205,Mitchell County,2021-01-28,138,2263,10.2
13205,Mitchell County,2021-01-29,105,2368,10.6
13205,Mitchell County,2021-01-30,6,2374,10.7
13205,Mitchell County,2021-02-01,111,2485,11.2
13205,Mitchell County,2021-02-02,99,2584,11.6
13205,Mitchell County,2021-02-03,107,2691,12.1
13205,Mitchell County,2021-02-04,130,2821,12.7
13205,Mitchell County,2021-02-05,80,2901,13
13205,Mitchell County,2021-02-08,44,2945,13.2
13205,Mitchell County,2021-02-09,78,3023,13.6
13205,Mitchell County,2021-02-10,96,3119,14
13205,Mitchell County,2021-02-11,55,3174,14.3
13205,Mitchell County,2021-02-12,50,3224,14.5
13205,Mitchell County,2021-02-13,14,3238,14.6
13205,Mitchell County,2021-02-14,6,3244,14.6
13205,Mitchell County,2021-02-15,37,3281,14.8
13205,Mitchell County,2021-02-16,62,3343,15
13205,Mitchell County,2021-02-17,45,3388,15.2
13205,Mitchell County,2021-02-18,44,3432,15.4
13205,Mitchell County,2021-02-19,17,3449,15.5
13205,Mitchell County,2021-02-20,10,3459,15.6
13205,Mitchell County,2021-02-21,9,3468,15.6
13205,Mitchell County,2021-02-22,18,3486,15.7
13205,Mitchell County,2021-02-23,33,3519,15.8
13205,Mitchell County,2021-02-24,19,3538,15.9
13205,Mitchell County,2021-02-25,63,3601,16.2
13205,Mitchell County,2021-02-26,23,3624,16.3
13205,Mitchell County,2021-02-27,12,3636,16.3
13205,Mitchell County,2021-02-28,13,3649,16.4
13205,Mitchell County,2021-03-01,56,3705,16.7
13205,Mitchell County,2021-03-02,49,3754,16.9
13205,Mitchell County,2021-03-03,27,3781,17
13205,Mitchell County,2021-03-04,39,3820,17.2
13205,Mitchell County,2021-03-05,20,3840,17.3
13205,Mitchell County,2021-03-06,11,3851,17.3
13205,Mitchell County,2021-03-07,10,3861,17.4
13205,Mitchell County,2021-03-08,85,3946,17.7
13205,Mitchell County,2021-03-09,84,4030,18.1
13205,Mitchell County,2021-03-10,88,4118,18.5
13205,Mitchell County,2021-03-11,85,4203,18.9
13205,Mitchell County,2021-03-12,62,4265,19.2
13205,Mitchell County,2021-03-13,22,4287,19.3
13205,Mitchell County,2021-03-14,16,4303,19.3
13205,Mitchell County,2021-03-15,61,4364,19.6
13205,Mitchell County,2021-03-16,107,4471,20.1
13205,Mitchell County,2021-03-17,103,4574,20.6
13205,Mitchell County,2021-03-18,78,4652,20.9
13205,Mitchell County,2021-03-19,99,4751,21.4
13205,Mitchell County,2021-03-20,12,4763,21.4
13205,Mitchell County,2021-03-21,7,4770,21.4
13205,Mitchell County,2021-03-22,82,4852,21.8
13205,Mitchell County,2021-03-23,62,4914,22.1
13205,Mitchell County,2021-03-24,98,5012,22.5
13205,Mitchell County,2021-03-25,114,5126,23
13205,Mitchell County,2021-03-26,50,5176,23.3
13205,Mitchell County,2021-03-27,7,5183,23.3
13205,Mitchell County,2021-03-28,11,5194,23.4
13205,Mitchell County,2021-03-29,51,5245,23.6
13205,Mitchell County,2021-03-30,109,5354,24.1
13205,Mitchell County,2021-03-31,83,5437,24.4
13205,Mitchell County,2021-04-01,116,5553,25
13205,Mitchell County,2021-04-02,164,5717,25.7
13205,Mitchell County,2021-04-03,26,5743,25.8
13205,Mitchell County,2021-04-04,3,5746,25.8
13205,Mitchell County,2021-04-05,61,5807,26.1
13205,Mitchell County,2021-04-06,73,5880,26.4
13205,Mitchell County,2021-04-07,64,5944,26.7
13205,Mitchell County,2021-04-08,88,6032,27.1
13205,Mitchell County,2021-04-09,31,6063,27.3
13205,Mitchell County,2021-04-10,18,6081,27.3
13205,Mitchell County,2021-04-11,9,6090,27.4
13205,Mitchell County,2021-04-12,27,6117,27.5
13205,Mitchell County,2021-04-13,59,6176,27.8
13205,Mitchell County,2021-04-14,57,6233,28
13205,Mitchell County,2021-04-15,66,6299,28.3
13205,Mitchell County,2021-04-16,24,6323,28.4
13205,Mitchell County,2021-04-17,5,6328,28.4
13205,Mitchell County,2021-04-18,1,6329,28.5
13205,Mitchell County,2021-04-19,22,6351,28.6
13205,Mitchell County,2021-04-20,49,6400,28.8
13205,Mitchell County,2021-04-21,33,6433,28.9
13205,Mitchell County,2021-04-22,40,6473,29.1
13205,Mitchell County,2021-04-23,19,6492,29.2
13205,Mitchell County,2021-04-24,9,6501,29.2
13205,Mitchell County,2021-04-25,2,6503,29.2
13205,Mitchell County,2021-04-26,16,6519,29.3
13205,Mitchell County,2021-04-27,20,6539,29.4
13205,Mitchell County,2021-04-28,21,6560,29.5
13205,Mitchell County,2021-04-29,28,6588,29.6
13205,Mitchell County,2021-04-30,15,6603,29.7
13205,Mitchell County,2021-05-01,6,6609,29.7
13205,Mitchell County,2021-05-02,3,6612,29.7
13205,Mitchell County,2021-05-03,14,6626,29.8
13205,Mitchell County,2021-05-04,40,6666,30
13205,Mitchell County,2021-05-05,32,6698,30.1
13205,Mitchell County,2021-05-06,48,6746,30.3
13205,Mitchell County,2021-05-07,39,6785,30.5
13205,Mitchell County,2021-05-08,10,6795,30.5
13205,Mitchell County,2021-05-09,3,6798,30.6
13205,Mitchell County,2021-05-10,21,6819,30.7
13205,Mitchell County,2021-05-11,37,6856,30.8
13205,Mitchell County,2021-05-12,21,6877,30.9
13205,Mitchell County,2021-05-13,28,6905,31
13205,Mitchell County,2021-05-14,29,6934,31.2
13205,Mitchell County,2021-05-15,14,6948,31.2
13205,Mitchell County,2021-05-16,5,6953,31.3
13205,Mitchell County,2021-05-17,25,6978,31.4
13205,Mitchell County,2021-05-18,26,7004,31.5
13205,Mitchell County,2021-05-19,34,7038,31.6
13205,Mitchell County,2021-05-20,38,7076,31.8
13205,Mitchell County,2021-05-21,18,7094,31.9
13205,Mitchell County,2021-05-22,10,7104,31.9
13205,Mitchell County,2021-05-23,3,7107,32
13205,Mitchell County,2021-05-24,13,7120,32
13205,Mitchell County,2021-05-25,17,7137,32.1
13205,Mitchell County,2021-05-26,19,7156,32.2
13205,Mitchell County,2021-05-27,32,7188,32.3
13205,Mitchell County,2021-05-28,8,7196,32.4
13205,Mitchell County,2021-05-29,4,7200,32.4
13205,Mitchell County,2021-05-30,3,7203,32.4
13205,Mitchell County,2021-06-01,16,7219,32.5
13205,Mitchell County,2021-06-02,19,7238,32.5
13205,Mitchell County,2021-06-03,17,7255,32.6
13205,Mitchell County,2021-06-04,15,7270,32.7
13205,Mitchell County,2021-06-05,3,7273,32.7
13205,Mitchell County,2021-06-06,1,7274,32.7
13205,Mitchell County,2021-06-07,14,7288,32.8
13205,Mitchell County,2021-06-08,15,7303,32.8
13205,Mitchell County,2021-06-09,20,7323,32.9
13205,Mitchell County,2021-06-10,17,7340,33
13205,Mitchell County,2021-06-11,11,7351,33
13205,Mitchell County,2021-06-12,9,7360,33.1
13205,Mitchell County,2021-06-14,13,7373,33.1
13205,Mitchell County,2021-06-15,28,7401,33.3
13205,Mitchell County,2021-06-16,8,7409,33.3
13205,Mitchell County,2021-06-17,15,7424,33.4
13205,Mitchell County,2021-06-18,14,7438,33.4
13205,Mitchell County,2021-06-19,4,7442,33.5
13205,Mitchell County,2021-06-20,2,7444,33.5
13205,Mitchell County,2021-06-21,5,7449,33.5
13205,Mitchell County,2021-06-22,9,7458,33.5
13205,Mitchell County,2021-06-23,9,7467,33.6
13205,Mitchell County,2021-06-24,16,7483,33.6
13205,Mitchell County,2021-06-25,12,7495,33.7
13205,Mitchell County,2021-06-26,2,7497,33.7
13205,Mitchell County,2021-06-28,5,7502,33.7
13205,Mitchell County,2021-06-29,10,7512,33.8
13205,Mitchell County,2021-06-30,4,7516,33.8
13205,Mitchell County,2021-07-01,24,7540,33.9
13205,Mitchell County,2021-07-02,20,7560,34
13205,Mitchell County,2021-07-03,2,7562,34
13205,Mitchell County,2021-07-04,2,7564,34
13205,Mitchell County,2021-07-05,4,7568,34
13205,Mitchell County,2021-07-06,17,7585,34.1
13205,Mitchell County,2021-07-07,7,7592,34.1
13205,Mitchell County,2021-07-08,14,7606,34.2
13205,Mitchell County,2021-07-09,15,7621,34.3
13205,Mitchell County,2021-07-10,16,7637,34.3
13205,Mitchell County,2021-07-11,1,7638,34.3
13205,Mitchell County,2021-07-12,13,7651,34.4
13205,Mitchell County,2021-07-13,13,7664,34.5
13205,Mitchell County,2021-07-14,7,7671,34.5
13205,Mitchell County,2021-07-15,8,7679,34.5
13205,Mitchell County,2021-07-16,22,7701,34.6
13205,Mitchell County,2021-07-17,12,7713,34.7
13205,Mitchell County,2021-07-18,7,7720,34.7
13205,Mitchell County,2021-07-19,7,7727,34.7
13205,Mitchell County,2021-07-20,16,7743,34.8
13205,Mitchell County,2021-07-21,25,7768,34.9
13205,Mitchell County,2021-07-22,31,7799,35.1
13205,Mitchell County,2021-07-23,53,7852,35.3
13205,Mitchell County,2021-07-24,18,7870,35.4
13205,Mitchell County,2021-07-25,9,7879,35.4
13205,Mitchell County,2021-07-26,33,7912,35.6
13205,Mitchell County,2021-07-27,46,7958,35.8
13205,Mitchell County,2021-07-28,58,8016,36
13205,Mitchell County,2021-07-29,68,8084,36.3
13205,Mitchell County,2021-07-30,67,8151,36.6
13205,Mitchell County,2021-07-31,17,8168,36.7
13205,Mitchell County,2021-08-01,17,8185,36.8
13205,Mitchell County,2021-08-02,41,8226,37
13205,Mitchell County,2021-08-03,53,8279,37.2
13205,Mitchell County,2021-08-04,70,8349,37.5
13205,Mitchell County,2021-08-05,62,8411,37.8
13205,Mitchell County,2021-08-06,79,8490,38.2
13205,Mitchell County,2021-08-07,40,8530,38.3
13205,Mitchell County,2021-08-08,20,8550,38.4
13205,Mitchell County,2021-08-09,77,8627,38.8
13205,Mitchell County,2021-08-10,61,8688,39.1
13205,Mitchell County,2021-08-11,68,8756,39.4
13205,Mitchell County,2021-08-12,63,8819,39.6
13205,Mitchell County,2021-08-13,183,9002,40.5
13205,Mitchell County,2021-08-14,33,9035,40.6
13205,Mitchell County,2021-08-15,30,9065,40.8
13205,Mitchell County,2021-08-16,62,9127,41
13205,Mitchell County,2021-08-17,95,9222,41.5
13205,Mitchell County,2021-08-18,102,9324,41.9
13205,Mitchell County,2021-08-19,78,9402,42.3
13205,Mitchell County,2021-08-20,114,9516,42.8
13205,Mitchell County,2021-08-21,31,9547,42.9
13205,Mitchell County,2021-08-22,26,9573,43
13205,Mitchell County,2021-08-23,53,9626,43.3
13205,Mitchell County,2021-08-24,47,9673,43.5
13205,Mitchell County,2021-08-25,68,9741,43.8
13205,Mitchell County,2021-08-26,59,9800,44.1
13205,Mitchell County,2021-08-27,62,9862,44.3
13205,Mitchell County,2021-08-28,31,9893,44.5
13205,Mitchell County,2021-08-29,15,9908,44.5
13205,Mitchell County,2021-08-30,43,9951,44.7
13205,Mitchell County,2021-08-31,36,9987,44.9
13205,Mitchell County,2021-09-01,60,10047,45.2
13205,Mitchell County,2021-09-02,53,10100,45.4
13205,Mitchell County,2021-09-03,54,10154,45.6
13205,Mitchell County,2021-09-04,8,10162,45.7
13205,Mitchell County,2021-09-05,5,10167,45.7
13205,Mitchell County,2021-09-06,8,10175,45.7
13205,Mitchell County,2021-09-07,30,10205,45.9
13205,Mitchell County,2021-09-08,42,10247,46.1
13205,Mitchell County,2021-09-09,34,10281,46.2
13205,Mitchell County,2021-09-10,53,10334,46.5
13205,Mitchell County,2021-09-11,12,10346,46.5
13205,Mitchell County,2021-09-12,8,10354,46.5
13205,Mitchell County,2021-09-13,32,10386,46.7
13205,Mitchell County,2021-09-14,28,10414,46.8
13205,Mitchell County,2021-09-15,26,10440,46.9
13205,Mitchell County,2021-09-16,23,10463,47
13205,Mitchell County,2021-09-17,33,10496,47.2
13205,Mitchell County,2021-09-18,14,10510,47.2
13205,Mitchell County,2021-09-19,3,10513,47.3
13205,Mitchell County,2021-09-20,14,10527,47.3
13205,Mitchell County,2021-09-21,18,10545,47.4
13205,Mitchell County,2021-09-22,28,10573,47.5
13205,Mitchell County,2021-09-23,29,10602,47.7
13205,Mitchell County,2021-09-24,22,10624,47.8
13205,Mitchell County,2021-09-25,10,10634,47.8
13205,Mitchell County,2021-09-26,2,10636,47.8
13205,Mitchell County,2021-09-27,17,10653,47.9
13205,Mitchell County,2021-09-28,15,10668,48
13205,Mitchell County,2021-09-29,9,10677,48
13205,Mitchell County,2021-09-30,14,10691,48.1
13205,Mitchell County,2021-10-01,17,10708,48.1
13205,Mitchell County,2021-10-02,4,10712,48.2
13205,Mitchell County,2021-10-03,3,10715,48.2
13205,Mitchell County,2021-10-04,2,10717,48.2
13205,Mitchell County,2021-10-05,18,10735,48.3
13205,Mitchell County,2021-10-06,16,10751,48.3
13205,Mitchell County,2021-10-07,11,10762,48.4
13207,Monroe County,2020-12-18,2,2,0
13207,Monroe County,2020-12-19,1,3,0
13207,Monroe County,2020-12-20,1,4,0
13207,Monroe County,2020-12-21,7,11,0
13207,Monroe County,2020-12-22,19,30,0.1
13207,Monroe County,2020-12-23,31,61,0.2
13207,Monroe County,2020-12-24,24,85,0.3
13207,Monroe County,2020-12-26,21,106,0.4
13207,Monroe County,2020-12-27,2,108,0.4
13207,Monroe County,2020-12-28,105,213,0.8
13207,Monroe County,2020-12-29,113,326,1.2
13207,Monroe County,2020-12-30,73,399,1.5
13207,Monroe County,2020-12-31,23,422,1.6
13207,Monroe County,2021-01-01,2,424,1.6
13207,Monroe County,2021-01-02,2,426,1.6
13207,Monroe County,2021-01-03,50,476,1.8
13207,Monroe County,2021-01-04,44,520,1.9
13207,Monroe County,2021-01-05,52,572,2.1
13207,Monroe County,2021-01-06,40,612,2.3
13207,Monroe County,2021-01-07,85,697,2.6
13207,Monroe County,2021-01-08,56,753,2.8
13207,Monroe County,2021-01-09,13,766,2.8
13207,Monroe County,2021-01-10,5,771,2.8
13207,Monroe County,2021-01-11,57,828,3
13207,Monroe County,2021-01-12,53,881,3.2
13207,Monroe County,2021-01-13,89,970,3.6
13207,Monroe County,2021-01-14,48,1018,3.7
13207,Monroe County,2021-01-15,141,1159,4.3
13207,Monroe County,2021-01-16,28,1187,4.4
13207,Monroe County,2021-01-17,42,1229,4.5
13207,Monroe County,2021-01-18,144,1373,5.1
13207,Monroe County,2021-01-19,101,1474,5.4
13207,Monroe County,2021-01-20,133,1607,5.9
13207,Monroe County,2021-01-21,123,1730,6.4
13207,Monroe County,2021-01-22,190,1920,7.1
13207,Monroe County,2021-01-23,10,1930,7.1
13207,Monroe County,2021-01-24,29,1959,7.2
13207,Monroe County,2021-01-25,82,2041,7.5
13207,Monroe County,2021-01-26,43,2084,7.7
13207,Monroe County,2021-01-27,100,2184,8
13207,Monroe County,2021-01-28,106,2290,8.4
13207,Monroe County,2021-01-29,171,2461,9.1
13207,Monroe County,2021-01-30,24,2485,9.1
13207,Monroe County,2021-01-31,1,2486,9.1
13207,Monroe County,2021-02-01,60,2546,9.4
13207,Monroe County,2021-02-02,40,2586,9.5
13207,Monroe County,2021-02-03,75,2661,9.8
13207,Monroe County,2021-02-04,48,2709,10
13207,Monroe County,2021-02-05,104,2813,10.4
13207,Monroe County,2021-02-06,10,2823,10.4
13207,Monroe County,2021-02-07,10,2833,10.4
13207,Monroe County,2021-02-08,62,2895,10.7
13207,Monroe County,2021-02-09,46,2941,10.8
13207,Monroe County,2021-02-10,65,3006,11.1
13207,Monroe County,2021-02-11,16,3022,11.1
13207,Monroe County,2021-02-12,46,3068,11.3
13207,Monroe County,2021-02-13,19,3087,11.4
13207,Monroe County,2021-02-14,5,3092,11.4
13207,Monroe County,2021-02-15,57,3149,11.6
13207,Monroe County,2021-02-16,34,3183,11.7
13207,Monroe County,2021-02-17,47,3230,11.9
13207,Monroe County,2021-02-18,75,3305,12.2
13207,Monroe County,2021-02-19,21,3326,12.2
13207,Monroe County,2021-02-20,22,3348,12.3
13207,Monroe County,2021-02-21,2,3350,12.3
13207,Monroe County,2021-02-22,83,3433,12.6
13207,Monroe County,2021-02-23,68,3501,12.9
13207,Monroe County,2021-02-24,55,3556,13.1
13207,Monroe County,2021-02-25,72,3628,13.4
13207,Monroe County,2021-02-26,79,3707,13.6
13207,Monroe County,2021-02-27,28,3735,13.7
13207,Monroe County,2021-02-28,7,3742,13.8
13207,Monroe County,2021-03-01,133,3875,14.3
13207,Monroe County,2021-03-02,72,3947,14.5
13207,Monroe County,2021-03-03,80,4027,14.8
13207,Monroe County,2021-03-04,111,4138,15.2
13207,Monroe County,2021-03-05,93,4231,15.6
13207,Monroe County,2021-03-06,11,4242,15.6
13207,Monroe County,2021-03-07,16,4258,15.7
13207,Monroe County,2021-03-08,212,4470,16.5
13207,Monroe County,2021-03-09,88,4558,16.8
13207,Monroe County,2021-03-10,112,4670,17.2
13207,Monroe County,2021-03-11,118,4788,17.6
13207,Monroe County,2021-03-12,186,4974,18.3
13207,Monroe County,2021-03-13,43,5017,18.5
13207,Monroe County,2021-03-14,31,5048,18.6
13207,Monroe County,2021-03-15,215,5263,19.4
13207,Monroe County,2021-03-16,94,5357,19.7
13207,Monroe County,2021-03-17,128,5485,20.2
13207,Monroe County,2021-03-18,122,5607,20.6
13207,Monroe County,2021-03-19,254,5861,21.6
13207,Monroe County,2021-03-20,24,5885,21.7
13207,Monroe County,2021-03-21,9,5894,21.7
13207,Monroe County,2021-03-22,97,5991,22
13207,Monroe County,2021-03-23,88,6079,22.4
13207,Monroe County,2021-03-24,94,6173,22.7
13207,Monroe County,2021-03-25,127,6300,23.2
13207,Monroe County,2021-03-26,168,6468,23.8
13207,Monroe County,2021-03-27,21,6489,23.9
13207,Monroe County,2021-03-28,8,6497,23.9
13207,Monroe County,2021-03-29,150,6647,24.5
13207,Monroe County,2021-03-30,97,6744,24.8
13207,Monroe County,2021-03-31,127,6871,25.3
13207,Monroe County,2021-04-01,155,7026,25.9
13207,Monroe County,2021-04-02,111,7137,26.3
13207,Monroe County,2021-04-03,25,7162,26.4
13207,Monroe County,2021-04-04,11,7173,26.4
13207,Monroe County,2021-04-05,108,7281,26.8
13207,Monroe County,2021-04-06,76,7357,27.1
13207,Monroe County,2021-04-07,96,7453,27.4
13207,Monroe County,2021-04-08,113,7566,27.8
13207,Monroe County,2021-04-09,169,7735,28.5
13207,Monroe County,2021-04-10,27,7762,28.6
13207,Monroe County,2021-04-11,22,7784,28.6
13207,Monroe County,2021-04-12,53,7837,28.8
13207,Monroe County,2021-04-13,42,7879,29
13207,Monroe County,2021-04-14,45,7924,29.2
13207,Monroe County,2021-04-15,81,8005,29.5
13207,Monroe County,2021-04-16,78,8083,29.7
13207,Monroe County,2021-04-17,7,8090,29.8
13207,Monroe County,2021-04-18,11,8101,29.8
13207,Monroe County,2021-04-19,35,8136,29.9
13207,Monroe County,2021-04-20,55,8191,30.1
13207,Monroe County,2021-04-21,70,8261,30.4
13207,Monroe County,2021-04-22,77,8338,30.7
13207,Monroe County,2021-04-23,81,8419,31
13207,Monroe County,2021-04-24,10,8429,31
13207,Monroe County,2021-04-25,10,8439,31.1
13207,Monroe County,2021-04-26,46,8485,31.2
13207,Monroe County,2021-04-27,27,8512,31.3
13207,Monroe County,2021-04-28,54,8566,31.5
13207,Monroe County,2021-04-29,76,8642,31.8
13207,Monroe County,2021-04-30,91,8733,32.1
13207,Monroe County,2021-05-01,24,8757,32.2
13207,Monroe County,2021-05-02,15,8772,32.3
13207,Monroe County,2021-05-03,32,8804,32.4
13207,Monroe County,2021-05-04,48,8852,32.6
13207,Monroe County,2021-05-05,62,8914,32.8
13207,Monroe County,2021-05-06,63,8977,33
13207,Monroe County,2021-05-07,65,9042,33.3
13207,Monroe County,2021-05-08,47,9089,33.5
13207,Monroe County,2021-05-09,4,9093,33.5
13207,Monroe County,2021-05-10,26,9119,33.6
13207,Monroe County,2021-05-11,30,9149,33.7
13207,Monroe County,2021-05-12,29,9178,33.8
13207,Monroe County,2021-05-13,36,9214,33.9
13207,Monroe County,2021-05-14,62,9276,34.1
13207,Monroe County,2021-05-15,20,9296,34.2
13207,Monroe County,2021-05-16,24,9320,34.3
13207,Monroe County,2021-05-17,32,9352,34.4
13207,Monroe County,2021-05-18,51,9403,34.6
13207,Monroe County,2021-05-19,41,9444,34.8
13207,Monroe County,2021-05-20,39,9483,34.9
13207,Monroe County,2021-05-21,45,9528,35.1
13207,Monroe County,2021-05-22,27,9555,35.2
13207,Monroe County,2021-05-23,10,9565,35.2
13207,Monroe County,2021-05-24,30,9595,35.3
13207,Monroe County,2021-05-25,24,9619,35.4
13207,Monroe County,2021-05-26,34,9653,35.5
13207,Monroe County,2021-05-27,29,9682,35.6
13207,Monroe County,2021-05-28,12,9694,35.7
13207,Monroe County,2021-05-29,6,9700,35.7
13207,Monroe County,2021-05-30,4,9704,35.7
13207,Monroe County,2021-05-31,4,9708,35.7
13207,Monroe County,2021-06-01,27,9735,35.8
13207,Monroe County,2021-06-02,23,9758,35.9
13207,Monroe County,2021-06-03,26,9784,36
13207,Monroe County,2021-06-04,30,9814,36.1
13207,Monroe County,2021-06-05,8,9822,36.1
13207,Monroe County,2021-06-06,3,9825,36.2
13207,Monroe County,2021-06-07,24,9849,36.2
13207,Monroe County,2021-06-08,13,9862,36.3
13207,Monroe County,2021-06-09,14,9876,36.3
13207,Monroe County,2021-06-10,19,9895,36.4
13207,Monroe County,2021-06-11,30,9925,36.5
13207,Monroe County,2021-06-12,17,9942,36.6
13207,Monroe County,2021-06-13,2,9944,36.6
13207,Monroe County,2021-06-14,11,9955,36.6
13207,Monroe County,2021-06-15,13,9968,36.7
13207,Monroe County,2021-06-16,11,9979,36.7
13207,Monroe County,2021-06-17,16,9995,36.8
13207,Monroe County,2021-06-18,7,10002,36.8
13207,Monroe County,2021-06-19,7,10009,36.8
13207,Monroe County,2021-06-20,6,10015,36.9
13207,Monroe County,2021-06-21,9,10024,36.9
13207,Monroe County,2021-06-22,20,10044,37
13207,Monroe County,2021-06-23,21,10065,37
13207,Monroe County,2021-06-24,15,10080,37.1
13207,Monroe County,2021-06-25,17,10097,37.2
13207,Monroe County,2021-06-26,7,10104,37.2
13207,Monroe County,2021-06-27,4,10108,37.2
13207,Monroe County,2021-06-28,13,10121,37.2
13207,Monroe County,2021-06-29,12,10133,37.3
13207,Monroe County,2021-06-30,12,10145,37.3
13207,Monroe County,2021-07-01,10,10155,37.4
13207,Monroe County,2021-07-02,25,10180,37.5
13207,Monroe County,2021-07-03,4,10184,37.5
13207,Monroe County,2021-07-04,1,10185,37.5
13207,Monroe County,2021-07-05,5,10190,37.5
13207,Monroe County,2021-07-06,14,10204,37.6
13207,Monroe County,2021-07-07,9,10213,37.6
13207,Monroe County,2021-07-08,10,10223,37.6
13207,Monroe County,2021-07-09,13,10236,37.7
13207,Monroe County,2021-07-10,8,10244,37.7
13207,Monroe County,2021-07-11,3,10247,37.7
13207,Monroe County,2021-07-12,13,10260,37.8
13207,Monroe County,2021-07-13,15,10275,37.8
13207,Monroe County,2021-07-14,9,10284,37.8
13207,Monroe County,2021-07-15,14,10298,37.9
13207,Monroe County,2021-07-16,15,10313,38
13207,Monroe County,2021-07-17,10,10323,38
13207,Monroe County,2021-07-18,12,10335,38
13207,Monroe County,2021-07-19,18,10353,38.1
13207,Monroe County,2021-07-20,20,10373,38.2
13207,Monroe County,2021-07-21,19,10392,38.2
13207,Monroe County,2021-07-22,37,10429,38.4
13207,Monroe County,2021-07-23,50,10479,38.6
13207,Monroe County,2021-07-24,24,10503,38.7
13207,Monroe County,2021-07-25,13,10516,38.7
13207,Monroe County,2021-07-26,36,10552,38.8
13207,Monroe County,2021-07-27,30,10582,38.9
13207,Monroe County,2021-07-28,38,10620,39.1
13207,Monroe County,2021-07-29,44,10664,39.2
13207,Monroe County,2021-07-30,43,10707,39.4
13207,Monroe County,2021-07-31,14,10721,39.5
13207,Monroe County,2021-08-01,19,10740,39.5
13207,Monroe County,2021-08-02,42,10782,39.7
13207,Monroe County,2021-08-03,47,10829,39.9
13207,Monroe County,2021-08-04,31,10860,40
13207,Monroe County,2021-08-05,39,10899,40.1
13207,Monroe County,2021-08-06,67,10966,40.4
13207,Monroe County,2021-08-07,30,10996,40.5
13207,Monroe County,2021-08-08,21,11017,40.5
13207,Monroe County,2021-08-09,63,11080,40.8
13207,Monroe County,2021-08-10,60,11140,41
13207,Monroe County,2021-08-11,45,11185,41.2
13207,Monroe County,2021-08-12,54,11239,41.4
13207,Monroe County,2021-08-13,73,11312,41.6
13207,Monroe County,2021-08-14,32,11344,41.8
13207,Monroe County,2021-08-15,30,11374,41.9
13207,Monroe County,2021-08-16,76,11450,42.1
13207,Monroe County,2021-08-17,68,11518,42.4
13207,Monroe County,2021-08-18,42,11560,42.5
13207,Monroe County,2021-08-19,46,11606,42.7
13207,Monroe County,2021-08-20,76,11682,43
13207,Monroe County,2021-08-21,32,11714,43.1
13207,Monroe County,2021-08-22,18,11732,43.2
13207,Monroe County,2021-08-23,44,11776,43.3
13207,Monroe County,2021-08-24,55,11831,43.5
13207,Monroe County,2021-08-25,47,11878,43.7
13207,Monroe County,2021-08-26,42,11920,43.9
13207,Monroe County,2021-08-27,36,11956,44
13207,Monroe County,2021-08-28,34,11990,44.1
13207,Monroe County,2021-08-29,17,12007,44.2
13207,Monroe County,2021-08-30,44,12051,44.4
13207,Monroe County,2021-08-31,40,12091,44.5
13207,Monroe County,2021-09-01,38,12129,44.6
13207,Monroe County,2021-09-02,39,12168,44.8
13207,Monroe County,2021-09-03,71,12239,45
13207,Monroe County,2021-09-04,22,12261,45.1
13207,Monroe County,2021-09-05,23,12284,45.2
13207,Monroe County,2021-09-06,7,12291,45.2
13207,Monroe County,2021-09-07,35,12326,45.4
13207,Monroe County,2021-09-08,51,12377,45.6
13207,Monroe County,2021-09-09,51,12428,45.7
13207,Monroe County,2021-09-10,57,12485,45.9
13207,Monroe County,2021-09-11,28,12513,46.1
13207,Monroe County,2021-09-12,13,12526,46.1
13207,Monroe County,2021-09-13,29,12555,46.2
13207,Monroe County,2021-09-14,37,12592,46.3
13207,Monroe County,2021-09-15,51,12643,46.5
13207,Monroe County,2021-09-16,40,12683,46.7
13207,Monroe County,2021-09-17,42,12725,46.8
13207,Monroe County,2021-09-18,19,12744,46.9
13207,Monroe County,2021-09-19,16,12760,47
13207,Monroe County,2021-09-20,27,12787,47.1
13207,Monroe County,2021-09-21,21,12808,47.1
13207,Monroe County,2021-09-22,28,12836,47.2
13207,Monroe County,2021-09-23,17,12853,47.3
13207,Monroe County,2021-09-24,17,12870,47.4
13207,Monroe County,2021-09-25,7,12877,47.4
13207,Monroe County,2021-09-26,4,12881,47.4
13207,Monroe County,2021-09-27,10,12891,47.4
13207,Monroe County,2021-09-28,16,12907,47.5
13207,Monroe County,2021-09-29,17,12924,47.6
13207,Monroe County,2021-09-30,17,12941,47.6
13207,Monroe County,2021-10-01,18,12959,47.7
13207,Monroe County,2021-10-02,4,12963,47.7
13207,Monroe County,2021-10-03,5,12968,47.7
13207,Monroe County,2021-10-04,6,12974,47.7
13207,Monroe County,2021-10-05,7,12981,47.8
13207,Monroe County,2021-10-06,1,12982,47.8
13207,Monroe County,2021-10-07,4,12986,47.8
13209,Montgomery County,2020-12-21,1,1,0
13209,Montgomery County,2020-12-22,2,3,0
13209,Montgomery County,2020-12-23,8,11,0.1
13209,Montgomery County,2020-12-24,1,12,0.1
13209,Montgomery County,2020-12-28,5,17,0.2
13209,Montgomery County,2020-12-29,8,25,0.3
13209,Montgomery County,2020-12-30,26,51,0.6
13209,Montgomery County,2020-12-31,2,53,0.6
13209,Montgomery County,2021-01-01,3,56,0.6
13209,Montgomery County,2021-01-03,1,57,0.6
13209,Montgomery County,2021-01-04,1,58,0.6
13209,Montgomery County,2021-01-05,9,67,0.7
13209,Montgomery County,2021-01-06,10,77,0.9
13209,Montgomery County,2021-01-07,9,86,0.9
13209,Montgomery County,2021-01-08,9,95,1
13209,Montgomery County,2021-01-11,134,229,2.5
13209,Montgomery County,2021-01-12,7,236,2.6
13209,Montgomery County,2021-01-13,23,259,2.9
13209,Montgomery County,2021-01-14,12,271,3
13209,Montgomery County,2021-01-15,7,278,3.1
13209,Montgomery County,2021-01-16,7,285,3.1
13209,Montgomery County,2021-01-17,5,290,3.2
13209,Montgomery County,2021-01-18,133,423,4.7
13209,Montgomery County,2021-01-19,46,469,5.2
13209,Montgomery County,2021-01-20,28,497,5.5
13209,Montgomery County,2021-01-21,3,500,5.5
13209,Montgomery County,2021-01-22,15,515,5.7
13209,Montgomery County,2021-01-23,2,517,5.7
13209,Montgomery County,2021-01-25,116,633,7
13209,Montgomery County,2021-01-26,5,638,7
13209,Montgomery County,2021-01-27,6,644,7.1
13209,Montgomery County,2021-01-28,21,665,7.3
13209,Montgomery County,2021-01-29,2,667,7.4
13209,Montgomery County,2021-01-30,2,669,7.4
13209,Montgomery County,2021-02-01,59,728,8
13209,Montgomery County,2021-02-02,5,733,8.1
13209,Montgomery County,2021-02-03,12,745,8.2
13209,Montgomery County,2021-02-04,6,751,8.3
13209,Montgomery County,2021-02-06,5,756,8.3
13209,Montgomery County,2021-02-07,1,757,8.4
13209,Montgomery County,2021-02-08,26,783,8.6
13209,Montgomery County,2021-02-09,10,793,8.8
13209,Montgomery County,2021-02-10,8,801,8.8
13209,Montgomery County,2021-02-11,9,810,8.9
13209,Montgomery County,2021-02-12,3,813,9
13209,Montgomery County,2021-02-13,7,820,9.1
13209,Montgomery County,2021-02-14,1,821,9.1
13209,Montgomery County,2021-02-15,22,843,9.3
13209,Montgomery County,2021-02-16,7,850,9.4
13209,Montgomery County,2021-02-17,9,859,9.5
13209,Montgomery County,2021-02-18,2,861,9.5
13209,Montgomery County,2021-02-19,3,864,9.5
13209,Montgomery County,2021-02-20,1,865,9.5
13209,Montgomery County,2021-02-22,25,890,9.8
13209,Montgomery County,2021-02-23,7,897,9.9
13209,Montgomery County,2021-02-24,3,900,9.9
13209,Montgomery County,2021-02-25,5,905,10
13209,Montgomery County,2021-02-26,4,909,10
13209,Montgomery County,2021-03-01,40,949,10.5
13209,Montgomery County,2021-03-02,17,966,10.7
13209,Montgomery County,2021-03-03,13,979,10.8
13209,Montgomery County,2021-03-04,9,988,10.9
13209,Montgomery County,2021-03-05,6,994,11
13209,Montgomery County,2021-03-06,1,995,11
13209,Montgomery County,2021-03-07,1,996,11
13209,Montgomery County,2021-03-08,42,1038,11.5
13209,Montgomery County,2021-03-09,6,1044,11.5
13209,Montgomery County,2021-03-10,22,1066,11.8
13209,Montgomery County,2021-03-11,46,1112,12.3
13209,Montgomery County,2021-03-12,51,1163,12.8
13209,Montgomery County,2021-03-14,3,1166,12.9
13209,Montgomery County,2021-03-15,19,1185,13.1
13209,Montgomery County,2021-03-16,86,1271,14
13209,Montgomery County,2021-03-17,25,1296,14.3
13209,Montgomery County,2021-03-18,19,1315,14.5
13209,Montgomery County,2021-03-19,19,1334,14.7
13209,Montgomery County,2021-03-20,5,1339,14.8
13209,Montgomery County,2021-03-21,2,1341,14.8
13209,Montgomery County,2021-03-22,11,1352,14.9
13209,Montgomery County,2021-03-23,79,1431,15.8
13209,Montgomery County,2021-03-24,25,1456,16.1
13209,Montgomery County,2021-03-25,17,1473,16.3
13209,Montgomery County,2021-03-26,27,1500,16.6
13209,Montgomery County,2021-03-27,30,1530,16.9
13209,Montgomery County,2021-03-28,2,1532,16.9
13209,Montgomery County,2021-03-29,14,1546,17.1
13209,Montgomery County,2021-03-30,57,1603,17.7
13209,Montgomery County,2021-03-31,18,1621,17.9
13209,Montgomery County,2021-04-01,22,1643,18.1
13209,Montgomery County,2021-04-02,21,1664,18.4
13209,Montgomery County,2021-04-03,7,1671,18.4
13209,Montgomery County,2021-04-04,1,1672,18.5
13209,Montgomery County,2021-04-05,17,1689,18.6
13209,Montgomery County,2021-04-06,53,1742,19.2
13209,Montgomery County,2021-04-07,28,1770,19.5
13209,Montgomery County,2021-04-08,24,1794,19.8
13209,Montgomery County,2021-04-09,18,1812,20
13209,Montgomery County,2021-04-10,9,1821,20.1
13209,Montgomery County,2021-04-11,2,1823,20.1
13209,Montgomery County,2021-04-12,11,1834,20.2
13209,Montgomery County,2021-04-13,22,1856,20.5
13209,Montgomery County,2021-04-14,4,1860,20.5
13209,Montgomery County,2021-04-15,7,1867,20.6
13209,Montgomery County,2021-04-16,8,1875,20.7
13209,Montgomery County,2021-04-17,2,1877,20.7
13209,Montgomery County,2021-04-19,3,1880,20.8
13209,Montgomery County,2021-04-20,22,1902,21
13209,Montgomery County,2021-04-21,15,1917,21.2
13209,Montgomery County,2021-04-22,14,1931,21.3
13209,Montgomery County,2021-04-23,7,1938,21.4
13209,Montgomery County,2021-04-24,9,1947,21.5
13209,Montgomery County,2021-04-25,2,1949,21.5
13209,Montgomery County,2021-04-26,4,1953,21.6
13209,Montgomery County,2021-04-27,30,1983,21.9
13209,Montgomery County,2021-04-28,14,1997,22
13209,Montgomery County,2021-04-29,4,2001,22.1
13209,Montgomery County,2021-04-30,10,2011,22.2
13209,Montgomery County,2021-05-01,11,2022,22.3
13209,Montgomery County,2021-05-02,1,2023,22.3
13209,Montgomery County,2021-05-03,9,2032,22.4
13209,Montgomery County,2021-05-04,26,2058,22.7
13209,Montgomery County,2021-05-05,5,2063,22.8
13209,Montgomery County,2021-05-06,9,2072,22.9
13209,Montgomery County,2021-05-07,7,2079,23
13209,Montgomery County,2021-05-08,4,2083,23
13209,Montgomery County,2021-05-09,1,2084,23
13209,Montgomery County,2021-05-10,9,2093,23.1
13209,Montgomery County,2021-05-11,18,2111,23.3
13209,Montgomery County,2021-05-12,11,2122,23.4
13209,Montgomery County,2021-05-13,6,2128,23.5
13209,Montgomery County,2021-05-14,11,2139,23.6
13209,Montgomery County,2021-05-15,5,2144,23.7
13209,Montgomery County,2021-05-16,2,2146,23.7
13209,Montgomery County,2021-05-17,7,2153,23.8
13209,Montgomery County,2021-05-18,22,2175,24
13209,Montgomery County,2021-05-19,8,2183,24.1
13209,Montgomery County,2021-05-20,4,2187,24.1
13209,Montgomery County,2021-05-21,5,2192,24.2
13209,Montgomery County,2021-05-22,6,2198,24.3
13209,Montgomery County,2021-05-23,1,2199,24.3
13209,Montgomery County,2021-05-24,11,2210,24.4
13209,Montgomery County,2021-05-25,17,2227,24.6
13209,Montgomery County,2021-05-26,2,2229,24.6
13209,Montgomery County,2021-05-27,3,2232,24.6
13209,Montgomery County,2021-05-28,6,2238,24.7
13209,Montgomery County,2021-05-29,2,2240,24.7
13209,Montgomery County,2021-05-31,1,2241,24.7
13209,Montgomery County,2021-06-01,11,2252,24.9
13209,Montgomery County,2021-06-02,6,2258,24.9
13209,Montgomery County,2021-06-03,3,2261,25
13209,Montgomery County,2021-06-04,13,2274,25.1
13209,Montgomery County,2021-06-05,3,2277,25.1
13209,Montgomery County,2021-06-07,5,2282,25.2
13209,Montgomery County,2021-06-08,8,2290,25.3
13209,Montgomery County,2021-06-09,1,2291,25.3
13209,Montgomery County,2021-06-10,7,2298,25.4
13209,Montgomery County,2021-06-11,8,2306,25.5
13209,Montgomery County,2021-06-12,3,2309,25.5
13209,Montgomery County,2021-06-13,4,2313,25.5
13209,Montgomery County,2021-06-14,3,2316,25.6
13209,Montgomery County,2021-06-15,4,2320,25.6
13209,Montgomery County,2021-06-17,3,2323,25.6
13209,Montgomery County,2021-06-18,12,2335,25.8
13209,Montgomery County,2021-06-19,4,2339,25.8
13209,Montgomery County,2021-06-21,3,2342,25.9
13209,Montgomery County,2021-06-22,6,2348,25.9
13209,Montgomery County,2021-06-23,6,2354,26
13209,Montgomery County,2021-06-24,3,2357,26
13209,Montgomery County,2021-06-25,4,2361,26.1
13209,Montgomery County,2021-06-26,3,2364,26.1
13209,Montgomery County,2021-06-28,3,2367,26.1
13209,Montgomery County,2021-06-29,4,2371,26.2
13209,Montgomery County,2021-06-30,1,2372,26.2
13209,Montgomery County,2021-07-01,2,2374,26.2
13209,Montgomery County,2021-07-02,2,2376,26.2
13209,Montgomery County,2021-07-05,2,2378,26.3
13209,Montgomery County,2021-07-06,6,2384,26.3
13209,Montgomery County,2021-07-07,5,2389,26.4
13209,Montgomery County,2021-07-08,4,2393,26.4
13209,Montgomery County,2021-07-09,2,2395,26.4
13209,Montgomery County,2021-07-10,5,2400,26.5
13209,Montgomery County,2021-07-11,2,2402,26.5
13209,Montgomery County,2021-07-12,5,2407,26.6
13209,Montgomery County,2021-07-13,3,2410,26.6
13209,Montgomery County,2021-07-14,2,2412,26.6
13209,Montgomery County,2021-07-15,8,2420,26.7
13209,Montgomery County,2021-07-16,9,2429,26.8
13209,Montgomery County,2021-07-17,5,2434,26.9
13209,Montgomery County,2021-07-19,5,2439,26.9
13209,Montgomery County,2021-07-20,14,2453,27.1
13209,Montgomery County,2021-07-21,10,2463,27.2
13209,Montgomery County,2021-07-22,17,2480,27.4
13209,Montgomery County,2021-07-23,15,2495,27.5
13209,Montgomery County,2021-07-24,5,2500,27.6
13209,Montgomery County,2021-07-25,3,2503,27.6
13209,Montgomery County,2021-07-26,15,2518,27.8
13209,Montgomery County,2021-07-27,22,2540,28
13209,Montgomery County,2021-07-28,29,2569,28.4
13209,Montgomery County,2021-07-29,17,2586,28.5
13209,Montgomery County,2021-07-30,28,2614,28.9
13209,Montgomery County,2021-07-31,6,2620,28.9
13209,Montgomery County,2021-08-01,3,2623,29
13209,Montgomery County,2021-08-02,30,2653,29.3
13209,Montgomery County,2021-08-03,30,2683,29.6
13209,Montgomery County,2021-08-04,28,2711,29.9
13209,Montgomery County,2021-08-05,23,2734,30.2
13209,Montgomery County,2021-08-06,22,2756,30.4
13209,Montgomery County,2021-08-07,9,2765,30.5
13209,Montgomery County,2021-08-08,7,2772,30.6
13209,Montgomery County,2021-08-09,20,2792,30.8
13209,Montgomery County,2021-08-10,17,2809,31
13209,Montgomery County,2021-08-11,24,2833,31.3
13209,Montgomery County,2021-08-12,16,2849,31.5
13209,Montgomery County,2021-08-13,18,2867,31.7
13209,Montgomery County,2021-08-14,10,2877,31.8
13209,Montgomery County,2021-08-15,5,2882,31.8
13209,Montgomery County,2021-08-16,54,2936,32.4
13209,Montgomery County,2021-08-17,31,2967,32.8
13209,Montgomery County,2021-08-18,31,2998,33.1
13209,Montgomery County,2021-08-19,24,3022,33.4
13209,Montgomery County,2021-08-20,22,3044,33.6
13209,Montgomery County,2021-08-21,7,3051,33.7
13209,Montgomery County,2021-08-22,4,3055,33.7
13209,Montgomery County,2021-08-23,31,3086,34.1
13209,Montgomery County,2021-08-24,27,3113,34.4
13209,Montgomery County,2021-08-25,25,3138,34.6
13209,Montgomery County,2021-08-26,35,3173,35
13209,Montgomery County,2021-08-27,33,3206,35.4
13209,Montgomery County,2021-08-28,17,3223,35.6
13209,Montgomery County,2021-08-29,5,3228,35.6
13209,Montgomery County,2021-08-30,24,3252,35.9
13209,Montgomery County,2021-08-31,27,3279,36.2
13209,Montgomery County,2021-09-01,21,3300,36.4
13209,Montgomery County,2021-09-02,17,3317,36.6
13209,Montgomery County,2021-09-03,23,3340,36.9
13209,Montgomery County,2021-09-04,2,3342,36.9
13209,Montgomery County,2021-09-05,7,3349,37
13209,Montgomery County,2021-09-06,7,3356,37.1
13209,Montgomery County,2021-09-07,31,3387,37.4
13209,Montgomery County,2021-09-08,21,3408,37.6
13209,Montgomery County,2021-09-09,11,3419,37.7
13209,Montgomery County,2021-09-10,7,3426,37.8
13209,Montgomery County,2021-09-11,8,3434,37.9
13209,Montgomery County,2021-09-12,4,3438,38
13209,Montgomery County,2021-09-13,17,3455,38.1
13209,Montgomery County,2021-09-14,25,3480,38.4
13209,Montgomery County,2021-09-15,13,3493,38.6
13209,Montgomery County,2021-09-16,8,3501,38.7
13209,Montgomery County,2021-09-17,6,3507,38.7
13209,Montgomery County,2021-09-18,3,3510,38.8
13209,Montgomery County,2021-09-19,1,3511,38.8
13209,Montgomery County,2021-09-20,9,3520,38.9
13209,Montgomery County,2021-09-21,15,3535,39
13209,Montgomery County,2021-09-22,6,3541,39.1
13209,Montgomery County,2021-09-23,2,3543,39.1
13209,Montgomery County,2021-09-24,6,3549,39.2
13209,Montgomery County,2021-09-26,2,3551,39.2
13209,Montgomery County,2021-09-27,7,3558,39.3
13209,Montgomery County,2021-09-28,13,3571,39.4
13209,Montgomery County,2021-09-29,6,3577,39.5
13209,Montgomery County,2021-09-30,5,3582,39.5
13209,Montgomery County,2021-10-01,3,3585,39.6
13209,Montgomery County,2021-10-02,1,3586,39.6
13209,Montgomery County,2021-10-03,1,3587,39.6
13209,Montgomery County,2021-10-04,4,3591,39.6
13209,Montgomery County,2021-10-05,2,3593,39.7
13209,Montgomery County,2021-10-06,3,3596,39.7
13209,Montgomery County,2021-10-07,2,3598,39.7
13211,Morgan County,2020-12-17,1,1,0
13211,Morgan County,2020-12-18,7,8,0
13211,Morgan County,2020-12-21,2,10,0.1
13211,Morgan County,2020-12-22,10,20,0.1
13211,Morgan County,2020-12-23,15,35,0.2
13211,Morgan County,2020-12-24,4,39,0.2
13211,Morgan County,2020-12-28,21,60,0.3
13211,Morgan County,2020-12-29,19,79,0.4
13211,Morgan County,2020-12-30,17,96,0.5
13211,Morgan County,2020-12-31,9,105,0.6
13211,Morgan County,2021-01-01,4,109,0.6
13211,Morgan County,2021-01-02,8,117,0.6
13211,Morgan County,2021-01-03,2,119,0.6
13211,Morgan County,2021-01-04,28,147,0.8
13211,Morgan County,2021-01-05,26,173,0.9
13211,Morgan County,2021-01-06,27,200,1.1
13211,Morgan County,2021-01-07,23,223,1.2
13211,Morgan County,2021-01-08,31,254,1.4
13211,Morgan County,2021-01-09,4,258,1.4
13211,Morgan County,2021-01-10,53,311,1.7
13211,Morgan County,2021-01-11,34,345,1.9
13211,Morgan County,2021-01-12,78,423,2.3
13211,Morgan County,2021-01-13,62,485,2.6
13211,Morgan County,2021-01-14,41,526,2.8
13211,Morgan County,2021-01-15,37,563,3
13211,Morgan County,2021-01-16,31,594,3.2
13211,Morgan County,2021-01-17,17,611,3.3
13211,Morgan County,2021-01-18,40,651,3.5
13211,Morgan County,2021-01-19,46,697,3.8
13211,Morgan County,2021-01-20,44,741,4
13211,Morgan County,2021-01-21,55,796,4.3
13211,Morgan County,2021-01-22,84,880,4.8
13211,Morgan County,2021-01-23,31,911,4.9
13211,Morgan County,2021-01-24,3,914,4.9
13211,Morgan County,2021-01-25,160,1074,5.8
13211,Morgan County,2021-01-26,56,1130,6.1
13211,Morgan County,2021-01-27,31,1161,6.3
13211,Morgan County,2021-01-28,66,1227,6.6
13211,Morgan County,2021-01-29,57,1284,6.9
13211,Morgan County,2021-01-30,22,1306,7.1
13211,Morgan County,2021-01-31,32,1338,7.2
13211,Morgan County,2021-02-01,120,1458,7.9
13211,Morgan County,2021-02-02,16,1474,8
13211,Morgan County,2021-02-03,21,1495,8.1
13211,Morgan County,2021-02-04,61,1556,8.4
13211,Morgan County,2021-02-05,37,1593,8.6
13211,Morgan County,2021-02-06,26,1619,8.7
13211,Morgan County,2021-02-07,13,1632,8.8
13211,Morgan County,2021-02-08,106,1738,9.4
13211,Morgan County,2021-02-09,9,1747,9.4
13211,Morgan County,2021-02-10,22,1769,9.6
13211,Morgan County,2021-02-11,27,1796,9.7
13211,Morgan County,2021-02-12,15,1811,9.8
13211,Morgan County,2021-02-13,12,1823,9.9
13211,Morgan County,2021-02-14,11,1834,9.9
13211,Morgan County,2021-02-15,105,1939,10.5
13211,Morgan County,2021-02-16,29,1968,10.6
13211,Morgan County,2021-02-17,24,1992,10.8
13211,Morgan County,2021-02-18,45,2037,11
13211,Morgan County,2021-02-19,47,2084,11.3
13211,Morgan County,2021-02-20,15,2099,11.3
13211,Morgan County,2021-02-21,15,2114,11.4
13211,Morgan County,2021-02-22,23,2137,11.5
13211,Morgan County,2021-02-23,21,2158,11.7
13211,Morgan County,2021-02-24,18,2176,11.8
13211,Morgan County,2021-02-25,31,2207,11.9
13211,Morgan County,2021-02-26,28,2235,12.1
13211,Morgan County,2021-02-27,30,2265,12.2
13211,Morgan County,2021-02-28,9,2274,12.3
13211,Morgan County,2021-03-01,33,2307,12.5
13211,Morgan County,2021-03-02,35,2342,12.7
13211,Morgan County,2021-03-03,53,2395,12.9
13211,Morgan County,2021-03-04,43,2438,13.2
13211,Morgan County,2021-03-05,61,2499,13.5
13211,Morgan County,2021-03-06,25,2524,13.6
13211,Morgan County,2021-03-07,24,2548,13.8
13211,Morgan County,2021-03-08,83,2631,14.2
13211,Morgan County,2021-03-09,67,2698,14.6
13211,Morgan County,2021-03-10,94,2792,15.1
13211,Morgan County,2021-03-11,199,2991,16.2
13211,Morgan County,2021-03-12,88,3079,16.6
13211,Morgan County,2021-03-13,41,3120,16.9
13211,Morgan County,2021-03-14,20,3140,17
13211,Morgan County,2021-03-15,52,3192,17.2
13211,Morgan County,2021-03-16,165,3357,18.1
13211,Morgan County,2021-03-17,77,3434,18.6
13211,Morgan County,2021-03-18,80,3514,19
13211,Morgan County,2021-03-19,57,3571,19.3
13211,Morgan County,2021-03-20,33,3604,19.5
13211,Morgan County,2021-03-21,21,3625,19.6
13211,Morgan County,2021-03-22,169,3794,20.5
13211,Morgan County,2021-03-23,87,3881,21
13211,Morgan County,2021-03-24,127,4008,21.7
13211,Morgan County,2021-03-25,182,4190,22.6
13211,Morgan County,2021-03-26,139,4329,23.4
13211,Morgan County,2021-03-27,34,4363,23.6
13211,Morgan County,2021-03-28,29,4392,23.7
13211,Morgan County,2021-03-29,73,4465,24.1
13211,Morgan County,2021-03-30,75,4540,24.5
13211,Morgan County,2021-03-31,374,4914,26.6
13211,Morgan County,2021-04-01,118,5032,27.2
13211,Morgan County,2021-04-02,91,5123,27.7
13211,Morgan County,2021-04-03,33,5156,27.9
13211,Morgan County,2021-04-04,13,5169,27.9
13211,Morgan County,2021-04-05,72,5241,28.3
13211,Morgan County,2021-04-06,80,5321,28.8
13211,Morgan County,2021-04-07,68,5389,29.1
13211,Morgan County,2021-04-08,79,5468,29.5
13211,Morgan County,2021-04-09,55,5523,29.8
13211,Morgan County,2021-04-10,30,5553,30
13211,Morgan County,2021-04-11,24,5577,30.1
13211,Morgan County,2021-04-12,57,5634,30.4
13211,Morgan County,2021-04-13,59,5693,30.8
13211,Morgan County,2021-04-14,228,5921,32
13211,Morgan County,2021-04-15,72,5993,32.4
13211,Morgan County,2021-04-16,36,6029,32.6
13211,Morgan County,2021-04-17,28,6057,32.7
13211,Morgan County,2021-04-18,23,6080,32.9
13211,Morgan County,2021-04-19,32,6112,33
13211,Morgan County,2021-04-20,26,6138,33.2
13211,Morgan County,2021-04-21,63,6201,33.5
13211,Morgan County,2021-04-22,50,6251,33.8
13211,Morgan County,2021-04-23,28,6279,33.9
13211,Morgan County,2021-04-24,11,6290,34
13211,Morgan County,2021-04-25,10,6300,34
13211,Morgan County,2021-04-26,24,6324,34.2
13211,Morgan County,2021-04-27,20,6344,34.3
13211,Morgan County,2021-04-28,56,6400,34.6
13211,Morgan County,2021-04-29,38,6438,34.8
13211,Morgan County,2021-04-30,40,6478,35
13211,Morgan County,2021-05-01,28,6506,35.2
13211,Morgan County,2021-05-02,6,6512,35.2
13211,Morgan County,2021-05-03,38,6550,35.4
13211,Morgan County,2021-05-04,15,6565,35.5
13211,Morgan County,2021-05-05,29,6594,35.6
13211,Morgan County,2021-05-06,24,6618,35.8
13211,Morgan County,2021-05-07,28,6646,35.9
13211,Morgan County,2021-05-08,12,6658,36
13211,Morgan County,2021-05-09,3,6661,36
13211,Morgan County,2021-05-10,18,6679,36.1
13211,Morgan County,2021-05-11,9,6688,36.1
13211,Morgan County,2021-05-12,19,6707,36.2
13211,Morgan County,2021-05-13,25,6732,36.4
13211,Morgan County,2021-05-14,18,6750,36.5
13211,Morgan County,2021-05-15,21,6771,36.6
13211,Morgan County,2021-05-16,15,6786,36.7
13211,Morgan County,2021-05-17,27,6813,36.8
13211,Morgan County,2021-05-18,20,6833,36.9
13211,Morgan County,2021-05-19,23,6856,37
13211,Morgan County,2021-05-20,34,6890,37.2
13211,Morgan County,2021-05-21,21,6911,37.3
13211,Morgan County,2021-05-22,18,6929,37.4
13211,Morgan County,2021-05-23,6,6935,37.5
13211,Morgan County,2021-05-24,19,6954,37.6
13211,Morgan County,2021-05-25,13,6967,37.6
13211,Morgan County,2021-05-26,26,6993,37.8
13211,Morgan County,2021-05-27,11,7004,37.8
13211,Morgan County,2021-05-28,13,7017,37.9
13211,Morgan County,2021-05-29,11,7028,38
13211,Morgan County,2021-05-30,5,7033,38
13211,Morgan County,2021-05-31,4,7037,38
13211,Morgan County,2021-06-01,12,7049,38.1
13211,Morgan County,2021-06-02,13,7062,38.2
13211,Morgan County,2021-06-03,17,7079,38.3
13211,Morgan County,2021-06-04,22,7101,38.4
13211,Morgan County,2021-06-05,11,7112,38.4
13211,Morgan County,2021-06-06,7,7119,38.5
13211,Morgan County,2021-06-07,8,7127,38.5
13211,Morgan County,2021-06-08,13,7140,38.6
13211,Morgan County,2021-06-09,9,7149,38.6
13211,Morgan County,2021-06-10,12,7161,38.7
13211,Morgan County,2021-06-11,13,7174,38.8
13211,Morgan County,2021-06-12,8,7182,38.8
13211,Morgan County,2021-06-13,1,7183,38.8
13211,Morgan County,2021-06-14,16,7199,38.9
13211,Morgan County,2021-06-15,6,7205,38.9
13211,Morgan County,2021-06-16,9,7214,39
13211,Morgan County,2021-06-17,12,7226,39
13211,Morgan County,2021-06-18,12,7238,39.1
13211,Morgan County,2021-06-19,9,7247,39.2
13211,Morgan County,2021-06-20,2,7249,39.2
13211,Morgan County,2021-06-21,8,7257,39.2
13211,Morgan County,2021-06-22,12,7269,39.3
13211,Morgan County,2021-06-23,12,7281,39.3
13211,Morgan County,2021-06-24,15,7296,39.4
13211,Morgan County,2021-06-25,8,7304,39.5
13211,Morgan County,2021-06-26,3,7307,39.5
13211,Morgan County,2021-06-27,1,7308,39.5
13211,Morgan County,2021-06-28,9,7317,39.5
13211,Morgan County,2021-06-29,8,7325,39.6
13211,Morgan County,2021-06-30,20,7345,39.7
13211,Morgan County,2021-07-01,1,7346,39.7
13211,Morgan County,2021-07-02,14,7360,39.8
13211,Morgan County,2021-07-03,9,7369,39.8
13211,Morgan County,2021-07-04,1,7370,39.8
13211,Morgan County,2021-07-05,2,7372,39.8
13211,Morgan County,2021-07-06,13,7385,39.9
13211,Morgan County,2021-07-07,7,7392,39.9
13211,Morgan County,2021-07-08,15,7407,40
13211,Morgan County,2021-07-09,13,7420,40.1
13211,Morgan County,2021-07-10,6,7426,40.1
13211,Morgan County,2021-07-11,3,7429,40.1
13211,Morgan County,2021-07-12,11,7440,40.2
13211,Morgan County,2021-07-13,7,7447,40.2
13211,Morgan County,2021-07-14,22,7469,40.4
13211,Morgan County,2021-07-15,12,7481,40.4
13211,Morgan County,2021-07-16,16,7497,40.5
13211,Morgan County,2021-07-17,6,7503,40.5
13211,Morgan County,2021-07-18,6,7509,40.6
13211,Morgan County,2021-07-19,13,7522,40.6
13211,Morgan County,2021-07-20,9,7531,40.7
13211,Morgan County,2021-07-21,21,7552,40.8
13211,Morgan County,2021-07-22,20,7572,40.9
13211,Morgan County,2021-07-23,29,7601,41.1
13211,Morgan County,2021-07-24,12,7613,41.1
13211,Morgan County,2021-07-25,4,7617,41.2
13211,Morgan County,2021-07-26,23,7640,41.3
13211,Morgan County,2021-07-27,22,7662,41.4
13211,Morgan County,2021-07-28,24,7686,41.5
13211,Morgan County,2021-07-29,31,7717,41.7
13211,Morgan County,2021-07-30,29,7746,41.9
13211,Morgan County,2021-07-31,15,7761,41.9
13211,Morgan County,2021-08-01,20,7781,42
13211,Morgan County,2021-08-02,29,7810,42.2
13211,Morgan County,2021-08-03,29,7839,42.4
13211,Morgan County,2021-08-04,23,7862,42.5
13211,Morgan County,2021-08-05,20,7882,42.6
13211,Morgan County,2021-08-06,32,7914,42.8
13211,Morgan County,2021-08-07,18,7932,42.9
13211,Morgan County,2021-08-08,15,7947,42.9
13211,Morgan County,2021-08-09,30,7977,43.1
13211,Morgan County,2021-08-10,33,8010,43.3
13211,Morgan County,2021-08-11,39,8049,43.5
13211,Morgan County,2021-08-12,22,8071,43.6
13211,Morgan County,2021-08-13,33,8104,43.8
13211,Morgan County,2021-08-14,21,8125,43.9
13211,Morgan County,2021-08-15,9,8134,44
13211,Morgan County,2021-08-16,30,8164,44.1
13211,Morgan County,2021-08-17,26,8190,44.3
13211,Morgan County,2021-08-18,33,8223,44.4
13211,Morgan County,2021-08-19,29,8252,44.6
13211,Morgan County,2021-08-20,39,8291,44.8
13211,Morgan County,2021-08-21,14,8305,44.9
13211,Morgan County,2021-08-22,17,8322,45
13211,Morgan County,2021-08-23,37,8359,45.2
13211,Morgan County,2021-08-24,24,8383,45.3
13211,Morgan County,2021-08-25,55,8438,45.6
13211,Morgan County,2021-08-26,51,8489,45.9
13211,Morgan County,2021-08-27,28,8517,46
13211,Morgan County,2021-08-28,18,8535,46.1
13211,Morgan County,2021-08-29,16,8551,46.2
13211,Morgan County,2021-08-30,27,8578,46.4
13211,Morgan County,2021-08-31,23,8601,46.5
13211,Morgan County,2021-09-01,21,8622,46.6
13211,Morgan County,2021-09-02,25,8647,46.7
13211,Morgan County,2021-09-03,37,8684,46.9
13211,Morgan County,2021-09-04,14,8698,47
13211,Morgan County,2021-09-05,10,8708,47.1
13211,Morgan County,2021-09-06,5,8713,47.1
13211,Morgan County,2021-09-07,18,8731,47.2
13211,Morgan County,2021-09-08,23,8754,47.3
13211,Morgan County,2021-09-09,23,8777,47.4
13211,Morgan County,2021-09-10,24,8801,47.6
13211,Morgan County,2021-09-11,8,8809,47.6
13211,Morgan County,2021-09-12,7,8816,47.6
13211,Morgan County,2021-09-13,25,8841,47.8
13211,Morgan County,2021-09-14,20,8861,47.9
13211,Morgan County,2021-09-15,16,8877,48
13211,Morgan County,2021-09-16,12,8889,48
13211,Morgan County,2021-09-17,22,8911,48.1
13211,Morgan County,2021-09-18,6,8917,48.2
13211,Morgan County,2021-09-19,5,8922,48.2
13211,Morgan County,2021-09-20,15,8937,48.3
13211,Morgan County,2021-09-21,19,8956,48.4
13211,Morgan County,2021-09-22,17,8973,48.5
13211,Morgan County,2021-09-23,10,8983,48.5
13211,Morgan County,2021-09-24,12,8995,48.6
13211,Morgan County,2021-09-25,4,8999,48.6
13211,Morgan County,2021-09-26,1,9000,48.6
13211,Morgan County,2021-09-27,17,9017,48.7
13211,Morgan County,2021-09-28,4,9021,48.7
13211,Morgan County,2021-09-29,8,9029,48.8
13211,Morgan County,2021-09-30,7,9036,48.8
13211,Morgan County,2021-10-01,9,9045,48.9
13211,Morgan County,2021-10-02,4,9049,48.9
13211,Morgan County,2021-10-03,3,9052,48.9
13211,Morgan County,2021-10-04,8,9060,49
13211,Morgan County,2021-10-05,4,9064,49
13211,Morgan County,2021-10-06,5,9069,49
13211,Morgan County,2021-10-07,4,9073,49
13213,Murray County,2020-12-18,22,22,0.1
13213,Murray County,2020-12-20,6,28,0.1
13213,Murray County,2020-12-21,35,63,0.2
13213,Murray County,2020-12-22,50,113,0.3
13213,Murray County,2020-12-23,25,138,0.3
13213,Murray County,2020-12-24,9,147,0.4
13213,Murray County,2020-12-26,1,148,0.4
13213,Murray County,2020-12-27,4,152,0.4
13213,Murray County,2020-12-28,55,207,0.5
13213,Murray County,2020-12-29,50,257,0.6
13213,Murray County,2020-12-30,38,295,0.7
13213,Murray County,2020-12-31,30,325,0.8
13213,Murray County,2021-01-01,2,327,0.8
13213,Murray County,2021-01-02,4,331,0.8
13213,Murray County,2021-01-03,2,333,0.8
13213,Murray County,2021-01-04,31,364,0.9
13213,Murray County,2021-01-05,41,405,1
13213,Murray County,2021-01-06,57,462,1.2
13213,Murray County,2021-01-07,86,548,1.4
13213,Murray County,2021-01-08,68,616,1.6
13213,Murray County,2021-01-09,2,618,1.6
13213,Murray County,2021-01-10,6,624,1.6
13213,Murray County,2021-01-11,285,909,2.3
13213,Murray County,2021-01-12,377,1286,3.2
13213,Murray County,2021-01-13,246,1532,3.9
13213,Murray County,2021-01-14,310,1842,4.6
13213,Murray County,2021-01-15,187,2029,5.1
13213,Murray County,2021-01-16,12,2041,5.1
13213,Murray County,2021-01-17,12,2053,5.2
13213,Murray County,2021-01-18,233,2286,5.8
13213,Murray County,2021-01-19,206,2492,6.3
13213,Murray County,2021-01-20,149,2641,6.6
13213,Murray County,2021-01-21,48,2689,6.8
13213,Murray County,2021-01-22,78,2767,7
13213,Murray County,2021-01-23,1,2768,7
13213,Murray County,2021-01-24,1,2769,7
13213,Murray County,2021-01-25,63,2832,7.1
13213,Murray County,2021-01-26,88,2920,7.4
13213,Murray County,2021-01-27,99,3019,7.6
13213,Murray County,2021-01-28,86,3105,7.8
13213,Murray County,2021-01-29,76,3181,8
13213,Murray County,2021-01-30,4,3185,8
13213,Murray County,2021-01-31,3,3188,8
13213,Murray County,2021-02-01,35,3223,8.1
13213,Murray County,2021-02-02,73,3296,8.3
13213,Murray County,2021-02-03,185,3481,8.8
13213,Murray County,2021-02-04,179,3660,9.2
13213,Murray County,2021-02-05,72,3732,9.4
13213,Murray County,2021-02-06,1,3733,9.4
13213,Murray County,2021-02-07,1,3734,9.4
13213,Murray County,2021-02-08,18,3752,9.4
13213,Murray County,2021-02-09,36,3788,9.5
13213,Murray County,2021-02-10,90,3878,9.8
13213,Murray County,2021-02-11,35,3913,9.9
13213,Murray County,2021-02-12,33,3946,9.9
13213,Murray County,2021-02-13,7,3953,10
13213,Murray County,2021-02-14,3,3956,10
13213,Murray County,2021-02-15,49,4005,10.1
13213,Murray County,2021-02-16,40,4045,10.2
13213,Murray County,2021-02-17,14,4059,10.2
13213,Murray County,2021-02-18,20,4079,10.3
13213,Murray County,2021-02-19,17,4096,10.3
13213,Murray County,2021-02-20,9,4105,10.3
13213,Murray County,2021-02-22,30,4135,10.4
13213,Murray County,2021-02-23,35,4170,10.5
13213,Murray County,2021-02-24,32,4202,10.6
13213,Murray County,2021-02-25,69,4271,10.8
13213,Murray County,2021-02-26,47,4318,10.9
13213,Murray County,2021-02-27,15,4333,10.9
13213,Murray County,2021-02-28,14,4347,10.9
13213,Murray County,2021-03-01,165,4512,11.4
13213,Murray County,2021-03-02,117,4629,11.7
13213,Murray County,2021-03-03,129,4758,12
13213,Murray County,2021-03-04,66,4824,12.1
13213,Murray County,2021-03-05,90,4914,12.4
13213,Murray County,2021-03-06,1,4915,12.4
13213,Murray County,2021-03-07,13,4928,12.4
13213,Murray County,2021-03-08,106,5034,12.7
13213,Murray County,2021-03-09,135,5169,13
13213,Murray County,2021-03-10,144,5313,13.4
13213,Murray County,2021-03-11,103,5416,13.6
13213,Murray County,2021-03-12,134,5550,14
13213,Murray County,2021-03-13,86,5636,14.2
13213,Murray County,2021-03-14,25,5661,14.3
13213,Murray County,2021-03-15,121,5782,14.6
13213,Murray County,2021-03-16,172,5954,15
13213,Murray County,2021-03-17,121,6075,15.3
13213,Murray County,2021-03-18,90,6165,15.5
13213,Murray County,2021-03-19,142,6307,15.9
13213,Murray County,2021-03-20,40,6347,16
13213,Murray County,2021-03-21,23,6370,16
13213,Murray County,2021-03-22,158,6528,16.4
13213,Murray County,2021-03-23,104,6632,16.7
13213,Murray County,2021-03-24,253,6885,17.3
13213,Murray County,2021-03-25,183,7068,17.8
13213,Murray County,2021-03-26,179,7247,18.2
13213,Murray County,2021-03-27,28,7275,18.3
13213,Murray County,2021-03-28,47,7322,18.4
13213,Murray County,2021-03-29,122,7444,18.7
13213,Murray County,2021-03-30,178,7622,19.2
13213,Murray County,2021-03-31,255,7877,19.8
13213,Murray County,2021-04-01,174,8051,20.3
13213,Murray County,2021-04-02,110,8161,20.5
13213,Murray County,2021-04-03,50,8211,20.7
13213,Murray County,2021-04-04,32,8243,20.8
13213,Murray County,2021-04-05,88,8331,21
13213,Murray County,2021-04-06,103,8434,21.2
13213,Murray County,2021-04-07,106,8540,21.5
13213,Murray County,2021-04-08,161,8701,21.9
13213,Murray County,2021-04-09,98,8799,22.2
13213,Murray County,2021-04-10,38,8837,22.2
13213,Murray County,2021-04-11,39,8876,22.3
13213,Murray County,2021-04-12,48,8924,22.5
13213,Murray County,2021-04-13,77,9001,22.7
13213,Murray County,2021-04-14,115,9116,22.9
13213,Murray County,2021-04-15,112,9228,23.2
13213,Murray County,2021-04-16,86,9314,23.4
13213,Murray County,2021-04-17,44,9358,23.6
13213,Murray County,2021-04-18,13,9371,23.6
13213,Murray County,2021-04-19,46,9417,23.7
13213,Murray County,2021-04-20,55,9472,23.8
13213,Murray County,2021-04-21,85,9557,24.1
13213,Murray County,2021-04-22,122,9679,24.4
13213,Murray County,2021-04-23,66,9745,24.5
13213,Murray County,2021-04-24,23,9768,24.6
13213,Murray County,2021-04-25,11,9779,24.6
13213,Murray County,2021-04-26,59,9838,24.8
13213,Murray County,2021-04-27,61,9899,24.9
13213,Murray County,2021-04-28,53,9952,25.1
13213,Murray County,2021-04-29,44,9996,25.2
13213,Murray County,2021-04-30,67,10063,25.3
13213,Murray County,2021-05-01,40,10103,25.4
13213,Murray County,2021-05-02,12,10115,25.5
13213,Murray County,2021-05-03,25,10140,25.5
13213,Murray County,2021-05-04,66,10206,25.7
13213,Murray County,2021-05-05,55,10261,25.8
13213,Murray County,2021-05-06,42,10303,25.9
13213,Murray County,2021-05-07,51,10354,26.1
13213,Murray County,2021-05-08,31,10385,26.1
13213,Murray County,2021-05-09,5,10390,26.2
13213,Murray County,2021-05-10,25,10415,26.2
13213,Murray County,2021-05-11,42,10457,26.3
13213,Murray County,2021-05-12,18,10475,26.4
13213,Murray County,2021-05-13,40,10515,26.5
13213,Murray County,2021-05-14,56,10571,26.6
13213,Murray County,2021-05-15,33,10604,26.7
13213,Murray County,2021-05-16,13,10617,26.7
13213,Murray County,2021-05-17,49,10666,26.9
13213,Murray County,2021-05-18,51,10717,27
13213,Murray County,2021-05-19,65,10782,27.1
13213,Murray County,2021-05-20,27,10809,27.2
13213,Murray County,2021-05-21,35,10844,27.3
13213,Murray County,2021-05-22,16,10860,27.3
13213,Murray County,2021-05-23,18,10878,27.4
13213,Murray County,2021-05-24,33,10911,27.5
13213,Murray County,2021-05-25,53,10964,27.6
13213,Murray County,2021-05-26,29,10993,27.7
13213,Murray County,2021-05-27,26,11019,27.7
13213,Murray County,2021-05-28,30,11049,27.8
13213,Murray County,2021-05-29,18,11067,27.9
13213,Murray County,2021-05-30,11,11078,27.9
13213,Murray County,2021-05-31,4,11082,27.9
13213,Murray County,2021-06-01,25,11107,28
13213,Murray County,2021-06-02,21,11128,28
13213,Murray County,2021-06-03,23,11151,28.1
13213,Murray County,2021-06-04,26,11177,28.1
13213,Murray County,2021-06-05,16,11193,28.2
13213,Murray County,2021-06-06,7,11200,28.2
13213,Murray County,2021-06-07,14,11214,28.2
13213,Murray County,2021-06-08,3,11217,28.2
13213,Murray County,2021-06-09,15,11232,28.3
13213,Murray County,2021-06-10,24,11256,28.3
13213,Murray County,2021-06-11,25,11281,28.4
13213,Murray County,2021-06-12,9,11290,28.4
13213,Murray County,2021-06-13,3,11293,28.4
13213,Murray County,2021-06-14,21,11314,28.5
13213,Murray County,2021-06-15,20,11334,28.5
13213,Murray County,2021-06-16,14,11348,28.6
13213,Murray County,2021-06-17,31,11379,28.6
13213,Murray County,2021-06-18,15,11394,28.7
13213,Murray County,2021-06-19,11,11405,28.7
13213,Murray County,2021-06-20,1,11406,28.7
13213,Murray County,2021-06-21,16,11422,28.8
13213,Murray County,2021-06-22,20,11442,28.8
13213,Murray County,2021-06-23,15,11457,28.8
13213,Murray County,2021-06-24,21,11478,28.9
13213,Murray County,2021-06-25,18,11496,28.9
13213,Murray County,2021-06-26,13,11509,29
13213,Murray County,2021-06-27,8,11517,29
13213,Murray County,2021-06-28,17,11534,29
13213,Murray County,2021-06-29,16,11550,29.1
13213,Murray County,2021-06-30,12,11562,29.1
13213,Murray County,2021-07-01,22,11584,29.2
13213,Murray County,2021-07-02,18,11602,29.2
13213,Murray County,2021-07-03,8,11610,29.2
13213,Murray County,2021-07-04,1,11611,29.2
13213,Murray County,2021-07-05,6,11617,29.2
13213,Murray County,2021-07-06,15,11632,29.3
13213,Murray County,2021-07-07,22,11654,29.3
13213,Murray County,2021-07-08,22,11676,29.4
13213,Murray County,2021-07-09,23,11699,29.5
13213,Murray County,2021-07-10,14,11713,29.5
13213,Murray County,2021-07-11,4,11717,29.5
13213,Murray County,2021-07-12,15,11732,29.5
13213,Murray County,2021-07-13,12,11744,29.6
13213,Murray County,2021-07-14,16,11760,29.6
13213,Murray County,2021-07-15,21,11781,29.7
13213,Murray County,2021-07-16,24,11805,29.7
13213,Murray County,2021-07-17,11,11816,29.7
13213,Murray County,2021-07-18,9,11825,29.8
13213,Murray County,2021-07-19,16,11841,29.8
13213,Murray County,2021-07-20,33,11874,29.9
13213,Murray County,2021-07-21,45,11919,30
13213,Murray County,2021-07-22,26,11945,30.1
13213,Murray County,2021-07-23,41,11986,30.2
13213,Murray County,2021-07-24,21,12007,30.2
13213,Murray County,2021-07-25,18,12025,30.3
13213,Murray County,2021-07-26,44,12069,30.4
13213,Murray County,2021-07-27,50,12119,30.5
13213,Murray County,2021-07-28,37,12156,30.6
13213,Murray County,2021-07-29,62,12218,30.8
13213,Murray County,2021-07-30,63,12281,30.9
13213,Murray County,2021-07-31,30,12311,31
13213,Murray County,2021-08-01,18,12329,31
13213,Murray County,2021-08-02,40,12369,31.1
13213,Murray County,2021-08-03,50,12419,31.3
13213,Murray County,2021-08-04,75,12494,31.5
13213,Murray County,2021-08-05,55,12549,31.6
13213,Murray County,2021-08-06,59,12608,31.7
13213,Murray County,2021-08-07,40,12648,31.8
13213,Murray County,2021-08-08,27,12675,31.9
13213,Murray County,2021-08-09,59,12734,32.1
13213,Murray County,2021-08-10,71,12805,32.2
13213,Murray County,2021-08-11,60,12865,32.4
13213,Murray County,2021-08-12,81,12946,32.6
13213,Murray County,2021-08-13,79,13025,32.8
13213,Murray County,2021-08-14,38,13063,32.9
13213,Murray County,2021-08-15,37,13100,33
13213,Murray County,2021-08-16,79,13179,33.2
13213,Murray County,2021-08-17,86,13265,33.4
13213,Murray County,2021-08-18,104,13369,33.7
13213,Murray County,2021-08-19,93,13462,33.9
13213,Murray County,2021-08-20,76,13538,34.1
13213,Murray County,2021-08-21,40,13578,34.2
13213,Murray County,2021-08-22,33,13611,34.3
13213,Murray County,2021-08-23,67,13678,34.4
13213,Murray County,2021-08-24,53,13731,34.6
13213,Murray County,2021-08-25,67,13798,34.7
13213,Murray County,2021-08-26,79,13877,34.9
13213,Murray County,2021-08-27,82,13959,35.1
13213,Murray County,2021-08-28,47,14006,35.3
13213,Murray County,2021-08-29,29,14035,35.3
13213,Murray County,2021-08-30,57,14092,35.5
13213,Murray County,2021-08-31,110,14202,35.8
13213,Murray County,2021-09-01,104,14306,36
13213,Murray County,2021-09-02,106,14412,36.3
13213,Murray County,2021-09-03,148,14560,36.7
13213,Murray County,2021-09-04,70,14630,36.8
13213,Murray County,2021-09-05,34,14664,36.9
13213,Murray County,2021-09-06,16,14680,37
13213,Murray County,2021-09-07,70,14750,37.1
13213,Murray County,2021-09-08,64,14814,37.3
13213,Murray County,2021-09-09,66,14880,37.5
13213,Murray County,2021-09-10,81,14961,37.7
13213,Murray County,2021-09-11,58,15019,37.8
13213,Murray County,2021-09-12,22,15041,37.9
13213,Murray County,2021-09-13,57,15098,38
13213,Murray County,2021-09-14,56,15154,38.1
13213,Murray County,2021-09-15,55,15209,38.3
13213,Murray County,2021-09-16,45,15254,38.4
13213,Murray County,2021-09-17,50,15304,38.5
13213,Murray County,2021-09-18,25,15329,38.6
13213,Murray County,2021-09-19,13,15342,38.6
13213,Murray County,2021-09-20,28,15370,38.7
13213,Murray County,2021-09-21,21,15391,38.7
13213,Murray County,2021-09-22,30,15421,38.8
13213,Murray County,2021-09-23,20,15441,38.9
13213,Murray County,2021-09-24,25,15466,38.9
13213,Murray County,2021-09-25,24,15490,39
13213,Murray County,2021-09-26,8,15498,39
13213,Murray County,2021-09-27,31,15529,39.1
13213,Murray County,2021-09-28,18,15547,39.1
13213,Murray County,2021-09-29,26,15573,39.2
13213,Murray County,2021-09-30,25,15598,39.3
13213,Murray County,2021-10-01,20,15618,39.3
13213,Murray County,2021-10-02,9,15627,39.3
13213,Murray County,2021-10-03,7,15634,39.4
13213,Murray County,2021-10-04,10,15644,39.4
13213,Murray County,2021-10-05,9,15653,39.4
13213,Murray County,2021-10-06,15,15668,39.4
13213,Murray County,2021-10-07,2,15670,39.4
13215,Muscogee County,2020-12-12,1,1,0
13215,Muscogee County,2020-12-14,1,2,0
13215,Muscogee County,2020-12-16,2,4,0
13215,Muscogee County,2020-12-17,2,6,0
13215,Muscogee County,2020-12-18,10,16,0
13215,Muscogee County,2020-12-19,22,38,0
13215,Muscogee County,2020-12-20,24,62,0
13215,Muscogee County,2020-12-21,69,131,0.1
13215,Muscogee County,2020-12-22,107,238,0.1
13215,Muscogee County,2020-12-23,243,481,0.2
13215,Muscogee County,2020-12-24,3,484,0.2
13215,Muscogee County,2020-12-25,1,485,0.2
13215,Muscogee County,2020-12-26,7,492,0.3
13215,Muscogee County,2020-12-27,44,536,0.3
13215,Muscogee County,2020-12-28,216,752,0.4
13215,Muscogee County,2020-12-29,431,1183,0.6
13215,Muscogee County,2020-12-30,382,1565,0.8
13215,Muscogee County,2020-12-31,197,1762,0.9
13215,Muscogee County,2021-01-01,20,1782,0.9
13215,Muscogee County,2021-01-02,9,1791,0.9
13215,Muscogee County,2021-01-03,45,1836,0.9
13215,Muscogee County,2021-01-04,296,2132,1.1
13215,Muscogee County,2021-01-05,532,2664,1.4
13215,Muscogee County,2021-01-06,347,3011,1.5
13215,Muscogee County,2021-01-07,298,3309,1.7
13215,Muscogee County,2021-01-08,228,3537,1.8
13215,Muscogee County,2021-01-09,34,3571,1.8
13215,Muscogee County,2021-01-10,48,3619,1.8
13215,Muscogee County,2021-01-11,574,4193,2.1
13215,Muscogee County,2021-01-12,728,4921,2.5
13215,Muscogee County,2021-01-13,701,5622,2.9
13215,Muscogee County,2021-01-14,788,6410,3.3
13215,Muscogee County,2021-01-15,204,6614,3.4
13215,Muscogee County,2021-01-16,441,7055,3.6
13215,Muscogee County,2021-01-17,87,7142,3.6
13215,Muscogee County,2021-01-18,418,7560,3.9
13215,Muscogee County,2021-01-19,533,8093,4.1
13215,Muscogee County,2021-01-20,458,8551,4.4
13215,Muscogee County,2021-01-21,536,9087,4.6
13215,Muscogee County,2021-01-22,209,9296,4.7
13215,Muscogee County,2021-01-23,279,9575,4.9
13215,Muscogee County,2021-01-24,46,9621,4.9
13215,Muscogee County,2021-01-25,203,9824,5
13215,Muscogee County,2021-01-26,182,10006,5.1
13215,Muscogee County,2021-01-27,180,10186,5.2
13215,Muscogee County,2021-01-28,365,10551,5.4
13215,Muscogee County,2021-01-29,684,11235,5.7
13215,Muscogee County,2021-01-30,66,11301,5.8
13215,Muscogee County,2021-01-31,20,11321,5.8
13215,Muscogee County,2021-02-01,257,11578,5.9
13215,Muscogee County,2021-02-02,222,11800,6
13215,Muscogee County,2021-02-03,204,12004,6.1
13215,Muscogee County,2021-02-04,406,12410,6.3
13215,Muscogee County,2021-02-05,179,12589,6.4
13215,Muscogee County,2021-02-06,7,12596,6.4
13215,Muscogee County,2021-02-07,10,12606,6.4
13215,Muscogee County,2021-02-08,97,12703,6.5
13215,Muscogee County,2021-02-09,241,12944,6.6
13215,Muscogee County,2021-02-10,181,13125,6.7
13215,Muscogee County,2021-02-11,350,13475,6.9
13215,Muscogee County,2021-02-12,303,13778,7
13215,Muscogee County,2021-02-13,215,13993,7.1
13215,Muscogee County,2021-02-14,136,14129,7.2
13215,Muscogee County,2021-02-15,379,14508,7.4
13215,Muscogee County,2021-02-16,467,14975,7.7
13215,Muscogee County,2021-02-17,413,15388,7.9
13215,Muscogee County,2021-02-18,434,15822,8.1
13215,Muscogee County,2021-02-19,180,16002,8.2
13215,Muscogee County,2021-02-20,122,16124,8.2
13215,Muscogee County,2021-02-21,76,16200,8.3
13215,Muscogee County,2021-02-22,218,16418,8.4
13215,Muscogee County,2021-02-23,371,16789,8.6
13215,Muscogee County,2021-02-24,347,17136,8.8
13215,Muscogee County,2021-02-25,431,17567,9
13215,Muscogee County,2021-02-26,1448,19015,9.7
13215,Muscogee County,2021-02-27,180,19195,9.8
13215,Muscogee County,2021-02-28,75,19270,9.8
13215,Muscogee County,2021-03-01,339,19609,10
13215,Muscogee County,2021-03-02,342,19951,10.2
13215,Muscogee County,2021-03-03,360,20311,10.4
13215,Muscogee County,2021-03-04,423,20734,10.6
13215,Muscogee County,2021-03-05,376,21110,10.8
13215,Muscogee County,2021-03-06,124,21234,10.8
13215,Muscogee County,2021-03-07,69,21303,10.9
13215,Muscogee County,2021-03-08,673,21976,11.2
13215,Muscogee County,2021-03-09,505,22481,11.5
13215,Muscogee County,2021-03-10,803,23284,11.9
13215,Muscogee County,2021-03-11,1348,24632,12.6
13215,Muscogee County,2021-03-12,546,25178,12.9
13215,Muscogee County,2021-03-13,180,25358,13
13215,Muscogee County,2021-03-14,71,25429,13
13215,Muscogee County,2021-03-15,751,26180,13.4
13215,Muscogee County,2021-03-16,580,26760,13.7
13215,Muscogee County,2021-03-17,1830,28590,14.6
13215,Muscogee County,2021-03-18,699,29289,15
13215,Muscogee County,2021-03-19,1170,30459,15.6
13215,Muscogee County,2021-03-20,674,31133,15.9
13215,Muscogee County,2021-03-21,204,31337,16
13215,Muscogee County,2021-03-22,883,32220,16.5
13215,Muscogee County,2021-03-23,905,33125,16.9
13215,Muscogee County,2021-03-24,1121,34246,17.5
13215,Muscogee County,2021-03-25,1857,36103,18.4
13215,Muscogee County,2021-03-26,1823,37926,19.4
13215,Muscogee County,2021-03-27,620,38546,19.7
13215,Muscogee County,2021-03-28,252,38798,19.8
13215,Muscogee County,2021-03-29,1183,39981,20.4
13215,Muscogee County,2021-03-30,944,40925,20.9
13215,Muscogee County,2021-03-31,970,41895,21.4
13215,Muscogee County,2021-04-01,893,42788,21.9
13215,Muscogee County,2021-04-02,1295,44083,22.5
13215,Muscogee County,2021-04-03,234,44317,22.6
13215,Muscogee County,2021-04-04,175,44492,22.7
13215,Muscogee County,2021-04-05,823,45315,23.2
13215,Muscogee County,2021-04-06,861,46176,23.6
13215,Muscogee County,2021-04-07,976,47152,24.1
13215,Muscogee County,2021-04-08,953,48105,24.6
13215,Muscogee County,2021-04-09,1316,49421,25.2
13215,Muscogee County,2021-04-10,230,49651,25.4
13215,Muscogee County,2021-04-11,155,49806,25.4
13215,Muscogee County,2021-04-12,591,50397,25.7
13215,Muscogee County,2021-04-13,493,50890,26
13215,Muscogee County,2021-04-14,485,51375,26.2
13215,Muscogee County,2021-04-15,424,51799,26.5
13215,Muscogee County,2021-04-16,597,52396,26.8
13215,Muscogee County,2021-04-17,197,52593,26.9
13215,Muscogee County,2021-04-18,48,52641,26.9
13215,Muscogee County,2021-04-19,466,53107,27.1
13215,Muscogee County,2021-04-20,322,53429,27.3
13215,Muscogee County,2021-04-21,362,53791,27.5
13215,Muscogee County,2021-04-22,305,54096,27.6
13215,Muscogee County,2021-04-23,526,54622,27.9
13215,Muscogee County,2021-04-24,128,54750,28
13215,Muscogee County,2021-04-25,60,54810,28
13215,Muscogee County,2021-04-26,364,55174,28.2
13215,Muscogee County,2021-04-27,370,55544,28.4
13215,Muscogee County,2021-04-28,350,55894,28.6
13215,Muscogee County,2021-04-29,351,56245,28.7
13215,Muscogee County,2021-04-30,515,56760,29
13215,Muscogee County,2021-05-01,268,57028,29.1
13215,Muscogee County,2021-05-02,88,57116,29.2
13215,Muscogee County,2021-05-03,247,57363,29.3
13215,Muscogee County,2021-05-04,291,57654,29.5
13215,Muscogee County,2021-05-05,291,57945,29.6
13215,Muscogee County,2021-05-06,243,58188,29.7
13215,Muscogee County,2021-05-07,300,58488,29.9
13215,Muscogee County,2021-05-08,152,58640,30
13215,Muscogee County,2021-05-09,73,58713,30
13215,Muscogee County,2021-05-10,173,58886,30.1
13215,Muscogee County,2021-05-11,203,59089,30.2
13215,Muscogee County,2021-05-12,226,59315,30.3
13215,Muscogee County,2021-05-13,315,59630,30.5
13215,Muscogee County,2021-05-14,294,59924,30.6
13215,Muscogee County,2021-05-15,264,60188,30.7
13215,Muscogee County,2021-05-16,154,60342,30.8
13215,Muscogee County,2021-05-17,494,60836,31.1
13215,Muscogee County,2021-05-18,456,61292,31.3
13215,Muscogee County,2021-05-19,327,61619,31.5
13215,Muscogee County,2021-05-20,299,61918,31.6
13215,Muscogee County,2021-05-21,343,62261,31.8
13215,Muscogee County,2021-05-22,174,62435,31.9
13215,Muscogee County,2021-05-23,153,62588,32
13215,Muscogee County,2021-05-24,218,62806,32.1
13215,Muscogee County,2021-05-25,170,62976,32.2
13215,Muscogee County,2021-05-26,212,63188,32.3
13215,Muscogee County,2021-05-27,177,63365,32.4
13215,Muscogee County,2021-05-28,168,63533,32.5
13215,Muscogee County,2021-05-29,109,63642,32.5
13215,Muscogee County,2021-05-30,84,63726,32.6
13215,Muscogee County,2021-05-31,35,63761,32.6
13215,Muscogee County,2021-06-01,173,63934,32.7
13215,Muscogee County,2021-06-02,307,64241,32.8
13215,Muscogee County,2021-06-03,160,64401,32.9
13215,Muscogee County,2021-06-04,196,64597,33
13215,Muscogee County,2021-06-05,131,64728,33.1
13215,Muscogee County,2021-06-06,62,64790,33.1
13215,Muscogee County,2021-06-07,131,64921,33.2
13215,Muscogee County,2021-06-08,188,65109,33.3
13215,Muscogee County,2021-06-09,139,65248,33.3
13215,Muscogee County,2021-06-10,166,65414,33.4
13215,Muscogee County,2021-06-11,172,65586,33.5
13215,Muscogee County,2021-06-12,85,65671,33.6
13215,Muscogee County,2021-06-13,30,65701,33.6
13215,Muscogee County,2021-06-14,115,65816,33.6
13215,Muscogee County,2021-06-15,130,65946,33.7
13215,Muscogee County,2021-06-16,140,66086,33.8
13215,Muscogee County,2021-06-17,121,66207,33.8
13215,Muscogee County,2021-06-18,173,66380,33.9
13215,Muscogee County,2021-06-19,73,66453,33.9
13215,Muscogee County,2021-06-20,44,66497,34
13215,Muscogee County,2021-06-21,103,66600,34
13215,Muscogee County,2021-06-22,117,66717,34.1
13215,Muscogee County,2021-06-23,107,66824,34.1
13215,Muscogee County,2021-06-24,149,66973,34.2
13215,Muscogee County,2021-06-25,166,67139,34.3
13215,Muscogee County,2021-06-26,77,67216,34.3
13215,Muscogee County,2021-06-27,60,67276,34.4
13215,Muscogee County,2021-06-28,127,67403,34.4
13215,Muscogee County,2021-06-29,125,67528,34.5
13215,Muscogee County,2021-06-30,99,67627,34.5
13215,Muscogee County,2021-07-01,113,67740,34.6
13215,Muscogee County,2021-07-02,111,67851,34.7
13215,Muscogee County,2021-07-03,83,67934,34.7
13215,Muscogee County,2021-07-04,6,67940,34.7
13215,Muscogee County,2021-07-05,87,68027,34.8
13215,Muscogee County,2021-07-06,127,68154,34.8
13215,Muscogee County,2021-07-07,122,68276,34.9
13215,Muscogee County,2021-07-08,117,68393,34.9
13215,Muscogee County,2021-07-09,138,68531,35
13215,Muscogee County,2021-07-10,99,68630,35.1
13215,Muscogee County,2021-07-11,52,68682,35.1
13215,Muscogee County,2021-07-12,112,68794,35.1
13215,Muscogee County,2021-07-13,121,68915,35.2
13215,Muscogee County,2021-07-14,139,69054,35.3
13215,Muscogee County,2021-07-15,150,69204,35.4
13215,Muscogee County,2021-07-16,151,69355,35.4
13215,Muscogee County,2021-07-17,102,69457,35.5
13215,Muscogee County,2021-07-18,66,69523,35.5
13215,Muscogee County,2021-07-19,169,69692,35.6
13215,Muscogee County,2021-07-20,173,69865,35.7
13215,Muscogee County,2021-07-21,211,70076,35.8
13215,Muscogee County,2021-07-22,275,70351,35.9
13215,Muscogee County,2021-07-23,246,70597,36.1
13215,Muscogee County,2021-07-24,216,70813,36.2
13215,Muscogee County,2021-07-25,119,70932,36.2
13215,Muscogee County,2021-07-26,258,71190,36.4
13215,Muscogee County,2021-07-27,245,71435,36.5
13215,Muscogee County,2021-07-28,292,71727,36.6
13215,Muscogee County,2021-07-29,292,72019,36.8
13215,Muscogee County,2021-07-30,321,72340,37
13215,Muscogee County,2021-07-31,185,72525,37.1
13215,Muscogee County,2021-08-01,150,72675,37.1
13215,Muscogee County,2021-08-02,272,72947,37.3
13215,Muscogee County,2021-08-03,324,73271,37.4
13215,Muscogee County,2021-08-04,364,73635,37.6
13215,Muscogee County,2021-08-05,315,73950,37.8
13215,Muscogee County,2021-08-06,361,74311,38
13215,Muscogee County,2021-08-07,201,74512,38.1
13215,Muscogee County,2021-08-08,163,74675,38.2
13215,Muscogee County,2021-08-09,256,74931,38.3
13215,Muscogee County,2021-08-10,279,75210,38.4
13215,Muscogee County,2021-08-11,321,75531,38.6
13215,Muscogee County,2021-08-12,308,75839,38.7
13215,Muscogee County,2021-08-13,361,76200,38.9
13215,Muscogee County,2021-08-14,191,76391,39
13215,Muscogee County,2021-08-15,143,76534,39.1
13215,Muscogee County,2021-08-16,247,76781,39.2
13215,Muscogee County,2021-08-17,288,77069,39.4
13215,Muscogee County,2021-08-18,251,77320,39.5
13215,Muscogee County,2021-08-19,277,77597,39.6
13215,Muscogee County,2021-08-20,300,77897,39.8
13215,Muscogee County,2021-08-21,187,78084,39.9
13215,Muscogee County,2021-08-22,103,78187,39.9
13215,Muscogee County,2021-08-23,257,78444,40.1
13215,Muscogee County,2021-08-24,279,78723,40.2
13215,Muscogee County,2021-08-25,226,78949,40.3
13215,Muscogee County,2021-08-26,258,79207,40.5
13215,Muscogee County,2021-08-27,337,79544,40.6
13215,Muscogee County,2021-08-28,172,79716,40.7
13215,Muscogee County,2021-08-29,136,79852,40.8
13215,Muscogee County,2021-08-30,237,80089,40.9
13215,Muscogee County,2021-08-31,199,80288,41
13215,Muscogee County,2021-09-01,232,80520,41.1
13215,Muscogee County,2021-09-02,221,80741,41.2
13215,Muscogee County,2021-09-03,312,81053,41.4
13215,Muscogee County,2021-09-04,160,81213,41.5
13215,Muscogee County,2021-09-05,123,81336,41.6
13215,Muscogee County,2021-09-06,32,81368,41.6
13215,Muscogee County,2021-09-07,157,81525,41.6
13215,Muscogee County,2021-09-08,185,81710,41.7
13215,Muscogee County,2021-09-09,193,81903,41.8
13215,Muscogee County,2021-09-10,237,82140,42
13215,Muscogee County,2021-09-11,181,82321,42.1
13215,Muscogee County,2021-09-12,94,82415,42.1
13215,Muscogee County,2021-09-13,159,82574,42.2
13215,Muscogee County,2021-09-14,170,82744,42.3
13215,Muscogee County,2021-09-15,148,82892,42.3
13215,Muscogee County,2021-09-16,166,83058,42.4
13215,Muscogee County,2021-09-17,188,83246,42.5
13215,Muscogee County,2021-09-18,125,83371,42.6
13215,Muscogee County,2021-09-19,72,83443,42.6
13215,Muscogee County,2021-09-20,132,83575,42.7
13215,Muscogee County,2021-09-21,166,83741,42.8
13215,Muscogee County,2021-09-22,128,83869,42.8
13215,Muscogee County,2021-09-23,120,83989,42.9
13215,Muscogee County,2021-09-24,127,84116,43
13215,Muscogee County,2021-09-25,92,84208,43
13215,Muscogee County,2021-09-26,35,84243,43
13215,Muscogee County,2021-09-27,62,84305,43.1
13215,Muscogee County,2021-09-28,88,84393,43.1
13215,Muscogee County,2021-09-29,92,84485,43.2
13215,Muscogee County,2021-09-30,98,84583,43.2
13215,Muscogee County,2021-10-01,92,84675,43.3
13215,Muscogee County,2021-10-02,53,84728,43.3
13215,Muscogee County,2021-10-03,29,84757,43.3
13215,Muscogee County,2021-10-04,47,84804,43.3
13215,Muscogee County,2021-10-05,43,84847,43.3
13215,Muscogee County,2021-10-06,60,84907,43.4
13215,Muscogee County,2021-10-07,38,84945,43.4
13217,Newton County,2020-12-16,1,1,0
13217,Newton County,2020-12-17,29,30,0
13217,Newton County,2020-12-18,34,64,0.1
13217,Newton County,2020-12-19,12,76,0.1
13217,Newton County,2020-12-20,2,78,0.1
13217,Newton County,2020-12-21,27,105,0.1
13217,Newton County,2020-12-22,36,141,0.1
13217,Newton County,2020-12-23,60,201,0.2
13217,Newton County,2020-12-24,19,220,0.2
13217,Newton County,2020-12-25,3,223,0.2
13217,Newton County,2020-12-26,9,232,0.2
13217,Newton County,2020-12-27,8,240,0.2
13217,Newton County,2020-12-28,95,335,0.3
13217,Newton County,2020-12-29,130,465,0.4
13217,Newton County,2020-12-30,93,558,0.5
13217,Newton County,2020-12-31,60,618,0.6
13217,Newton County,2021-01-01,6,624,0.6
13217,Newton County,2021-01-02,40,664,0.6
13217,Newton County,2021-01-03,76,740,0.7
13217,Newton County,2021-01-04,160,900,0.8
13217,Newton County,2021-01-05,133,1033,1
13217,Newton County,2021-01-06,156,1189,1.1
13217,Newton County,2021-01-07,139,1328,1.2
13217,Newton County,2021-01-08,118,1446,1.3
13217,Newton County,2021-01-09,31,1477,1.4
13217,Newton County,2021-01-10,18,1495,1.4
13217,Newton County,2021-01-11,124,1619,1.5
13217,Newton County,2021-01-12,234,1853,1.7
13217,Newton County,2021-01-13,294,2147,2
13217,Newton County,2021-01-14,336,2483,2.3
13217,Newton County,2021-01-15,374,2857,2.6
13217,Newton County,2021-01-16,321,3178,2.9
13217,Newton County,2021-01-17,51,3229,3
13217,Newton County,2021-01-18,278,3507,3.2
13217,Newton County,2021-01-19,366,3873,3.6
13217,Newton County,2021-01-20,233,4106,3.8
13217,Newton County,2021-01-21,261,4367,4
13217,Newton County,2021-01-22,181,4548,4.2
13217,Newton County,2021-01-23,112,4660,4.3
13217,Newton County,2021-01-24,48,4708,4.4
13217,Newton County,2021-01-25,170,4878,4.5
13217,Newton County,2021-01-26,202,5080,4.7
13217,Newton County,2021-01-27,187,5267,4.9
13217,Newton County,2021-01-28,212,5479,5.1
13217,Newton County,2021-01-29,189,5668,5.2
13217,Newton County,2021-01-30,116,5784,5.4
13217,Newton County,2021-01-31,5,5789,5.4
13217,Newton County,2021-02-01,121,5910,5.5
13217,Newton County,2021-02-02,121,6031,5.6
13217,Newton County,2021-02-03,144,6175,5.7
13217,Newton County,2021-02-04,144,6319,5.8
13217,Newton County,2021-02-05,127,6446,6
13217,Newton County,2021-02-06,53,6499,6
13217,Newton County,2021-02-07,22,6521,6
13217,Newton County,2021-02-08,110,6631,6.1
13217,Newton County,2021-02-09,98,6729,6.2
13217,Newton County,2021-02-10,125,6854,6.3
13217,Newton County,2021-02-11,127,6981,6.5
13217,Newton County,2021-02-12,88,7069,6.5
13217,Newton County,2021-02-13,56,7125,6.6
13217,Newton County,2021-02-14,23,7148,6.6
13217,Newton County,2021-02-15,145,7293,6.7
13217,Newton County,2021-02-16,119,7412,6.9
13217,Newton County,2021-02-17,189,7601,7
13217,Newton County,2021-02-18,152,7753,7.2
13217,Newton County,2021-02-19,115,7868,7.3
13217,Newton County,2021-02-20,94,7962,7.4
13217,Newton County,2021-02-21,18,7980,7.4
13217,Newton County,2021-02-22,126,8106,7.5
13217,Newton County,2021-02-23,169,8275,7.7
13217,Newton County,2021-02-24,197,8472,7.8
13217,Newton County,2021-02-25,191,8663,8
13217,Newton County,2021-02-26,194,8857,8.2
13217,Newton County,2021-02-27,93,8950,8.3
13217,Newton County,2021-02-28,55,9005,8.3
13217,Newton County,2021-03-01,179,9184,8.5
13217,Newton County,2021-03-02,266,9450,8.7
13217,Newton County,2021-03-03,255,9705,9
13217,Newton County,2021-03-04,316,10021,9.3
13217,Newton County,2021-03-05,275,10296,9.5
13217,Newton County,2021-03-06,178,10474,9.7
13217,Newton County,2021-03-07,54,10528,9.7
13217,Newton County,2021-03-08,325,10853,10
13217,Newton County,2021-03-09,417,11270,10.4
13217,Newton County,2021-03-10,396,11666,10.8
13217,Newton County,2021-03-11,448,12114,11.2
13217,Newton County,2021-03-12,557,12671,11.7
13217,Newton County,2021-03-13,140,12811,11.9
13217,Newton County,2021-03-14,111,12922,12
13217,Newton County,2021-03-15,405,13327,12.3
13217,Newton County,2021-03-16,556,13883,12.8
13217,Newton County,2021-03-17,592,14475,13.4
13217,Newton County,2021-03-18,404,14879,13.8
13217,Newton County,2021-03-19,599,15478,14.3
13217,Newton County,2021-03-20,245,15723,14.5
13217,Newton County,2021-03-21,147,15870,14.7
13217,Newton County,2021-03-22,493,16363,15.1
13217,Newton County,2021-03-23,570,16933,15.7
13217,Newton County,2021-03-24,741,17674,16.4
13217,Newton County,2021-03-25,671,18345,17
13217,Newton County,2021-03-26,602,18947,17.5
13217,Newton County,2021-03-27,259,19206,17.8
13217,Newton County,2021-03-28,144,19350,17.9
13217,Newton County,2021-03-29,471,19821,18.3
13217,Newton County,2021-03-30,663,20484,19
13217,Newton County,2021-03-31,684,21168,19.6
13217,Newton County,2021-04-01,648,21816,20.2
13217,Newton County,2021-04-02,514,22330,20.7
13217,Newton County,2021-04-03,278,22608,20.9
13217,Newton County,2021-04-04,99,22707,21
13217,Newton County,2021-04-05,506,23213,21.5
13217,Newton County,2021-04-06,619,23832,22.1
13217,Newton County,2021-04-07,502,24334,22.5
13217,Newton County,2021-04-08,529,24863,23
13217,Newton County,2021-04-09,608,25471,23.6
13217,Newton County,2021-04-10,296,25767,23.8
13217,Newton County,2021-04-11,138,25905,24
13217,Newton County,2021-04-12,290,26195,24.2
13217,Newton County,2021-04-13,339,26534,24.6
13217,Newton County,2021-04-14,359,26893,24.9
13217,Newton County,2021-04-15,373,27266,25.2
13217,Newton County,2021-04-16,367,27633,25.6
13217,Newton County,2021-04-17,120,27753,25.7
13217,Newton County,2021-04-18,87,27840,25.8
13217,Newton County,2021-04-19,246,28086,26
13217,Newton County,2021-04-20,305,28391,26.3
13217,Newton County,2021-04-21,259,28650,26.5
13217,Newton County,2021-04-22,289,28939,26.8
13217,Newton County,2021-04-23,272,29211,27
13217,Newton County,2021-04-24,145,29356,27.2
13217,Newton County,2021-04-25,80,29436,27.2
13217,Newton County,2021-04-26,204,29640,27.4
13217,Newton County,2021-04-27,219,29859,27.6
13217,Newton County,2021-04-28,268,30127,27.9
13217,Newton County,2021-04-29,198,30325,28.1
13217,Newton County,2021-04-30,248,30573,28.3
13217,Newton County,2021-05-01,179,30752,28.5
13217,Newton County,2021-05-02,74,30826,28.5
13217,Newton County,2021-05-03,152,30978,28.7
13217,Newton County,2021-05-04,162,31140,28.8
13217,Newton County,2021-05-05,196,31336,29
13217,Newton County,2021-05-06,237,31573,29.2
13217,Newton County,2021-05-07,208,31781,29.4
13217,Newton County,2021-05-08,131,31912,29.5
13217,Newton County,2021-05-09,51,31963,29.6
13217,Newton County,2021-05-10,112,32075,29.7
13217,Newton County,2021-05-11,171,32246,29.8
13217,Newton County,2021-05-12,164,32410,30
13217,Newton County,2021-05-13,181,32591,30.2
13217,Newton County,2021-05-14,211,32802,30.4
13217,Newton County,2021-05-15,234,33036,30.6
13217,Newton County,2021-05-16,118,33154,30.7
13217,Newton County,2021-05-17,227,33381,30.9
13217,Newton County,2021-05-18,237,33618,31.1
13217,Newton County,2021-05-19,207,33825,31.3
13217,Newton County,2021-05-20,172,33997,31.5
13217,Newton County,2021-05-21,185,34182,31.6
13217,Newton County,2021-05-22,144,34326,31.8
13217,Newton County,2021-05-23,81,34407,31.8
13217,Newton County,2021-05-24,119,34526,31.9
13217,Newton County,2021-05-25,104,34630,32
13217,Newton County,2021-05-26,139,34769,32.2
13217,Newton County,2021-05-27,137,34906,32.3
13217,Newton County,2021-05-28,112,35018,32.4
13217,Newton County,2021-05-29,87,35105,32.5
13217,Newton County,2021-05-30,31,35136,32.5
13217,Newton County,2021-05-31,11,35147,32.5
13217,Newton County,2021-06-01,132,35279,32.6
13217,Newton County,2021-06-02,111,35390,32.7
13217,Newton County,2021-06-03,143,35533,32.9
13217,Newton County,2021-06-04,129,35662,33
13217,Newton County,2021-06-05,110,35772,33.1
13217,Newton County,2021-06-06,52,35824,33.1
13217,Newton County,2021-06-07,90,35914,33.2
13217,Newton County,2021-06-08,96,36010,33.3
13217,Newton County,2021-06-09,121,36131,33.4
13217,Newton County,2021-06-10,103,36234,33.5
13217,Newton County,2021-06-11,125,36359,33.6
13217,Newton County,2021-06-12,67,36426,33.7
13217,Newton County,2021-06-13,51,36477,33.8
13217,Newton County,2021-06-14,81,36558,33.8
13217,Newton County,2021-06-15,85,36643,33.9
13217,Newton County,2021-06-16,98,36741,34
13217,Newton County,2021-06-17,92,36833,34.1
13217,Newton County,2021-06-18,104,36937,34.2
13217,Newton County,2021-06-19,70,37007,34.2
13217,Newton County,2021-06-20,27,37034,34.3
13217,Newton County,2021-06-21,98,37132,34.4
13217,Newton County,2021-06-22,82,37214,34.4
13217,Newton County,2021-06-23,94,37308,34.5
13217,Newton County,2021-06-24,61,37369,34.6
13217,Newton County,2021-06-25,104,37473,34.7
13217,Newton County,2021-06-26,56,37529,34.7
13217,Newton County,2021-06-27,24,37553,34.7
13217,Newton County,2021-06-28,74,37627,34.8
13217,Newton County,2021-06-29,76,37703,34.9
13217,Newton County,2021-06-30,78,37781,35
13217,Newton County,2021-07-01,70,37851,35
13217,Newton County,2021-07-02,93,37944,35.1
13217,Newton County,2021-07-03,65,38009,35.2
13217,Newton County,2021-07-04,6,38015,35.2
13217,Newton County,2021-07-05,53,38068,35.2
13217,Newton County,2021-07-06,82,38150,35.3
13217,Newton County,2021-07-07,66,38216,35.4
13217,Newton County,2021-07-08,79,38295,35.4
13217,Newton County,2021-07-09,86,38381,35.5
13217,Newton County,2021-07-10,70,38451,35.6
13217,Newton County,2021-07-11,33,38484,35.6
13217,Newton County,2021-07-12,79,38563,35.7
13217,Newton County,2021-07-13,82,38645,35.8
13217,Newton County,2021-07-14,143,38788,35.9
13217,Newton County,2021-07-15,93,38881,36
13217,Newton County,2021-07-16,98,38979,36.1
13217,Newton County,2021-07-17,80,39059,36.1
13217,Newton County,2021-07-18,32,39091,36.2
13217,Newton County,2021-07-19,108,39199,36.3
13217,Newton County,2021-07-20,109,39308,36.4
13217,Newton County,2021-07-21,125,39433,36.5
13217,Newton County,2021-07-22,149,39582,36.6
13217,Newton County,2021-07-23,163,39745,36.8
13217,Newton County,2021-07-24,119,39864,36.9
13217,Newton County,2021-07-25,54,39918,36.9
13217,Newton County,2021-07-26,112,40030,37
13217,Newton County,2021-07-27,222,40252,37.2
13217,Newton County,2021-07-28,161,40413,37.4
13217,Newton County,2021-07-29,140,40553,37.5
13217,Newton County,2021-07-30,214,40767,37.7
13217,Newton County,2021-07-31,168,40935,37.9
13217,Newton County,2021-08-01,86,41021,38
13217,Newton County,2021-08-02,190,41211,38.1
13217,Newton County,2021-08-03,201,41412,38.3
13217,Newton County,2021-08-04,170,41582,38.5
13217,Newton County,2021-08-05,192,41774,38.7
13217,Newton County,2021-08-06,237,42011,38.9
13217,Newton County,2021-08-07,171,42182,39
13217,Newton County,2021-08-08,125,42307,39.1
13217,Newton County,2021-08-09,211,42518,39.3
13217,Newton County,2021-08-10,235,42753,39.6
13217,Newton County,2021-08-11,200,42953,39.7
13217,Newton County,2021-08-12,182,43135,39.9
13217,Newton County,2021-08-13,214,43349,40.1
13217,Newton County,2021-08-14,152,43501,40.2
13217,Newton County,2021-08-15,65,43566,40.3
13217,Newton County,2021-08-16,148,43714,40.4
13217,Newton County,2021-08-17,176,43890,40.6
13217,Newton County,2021-08-18,158,44048,40.8
13217,Newton County,2021-08-19,171,44219,40.9
13217,Newton County,2021-08-20,176,44395,41.1
13217,Newton County,2021-08-21,115,44510,41.2
13217,Newton County,2021-08-22,83,44593,41.3
13217,Newton County,2021-08-23,143,44736,41.4
13217,Newton County,2021-08-24,147,44883,41.5
13217,Newton County,2021-08-25,147,45030,41.7
13217,Newton County,2021-08-26,160,45190,41.8
13217,Newton County,2021-08-27,184,45374,42
13217,Newton County,2021-08-28,162,45536,42.1
13217,Newton County,2021-08-29,97,45633,42.2
13217,Newton County,2021-08-30,168,45801,42.4
13217,Newton County,2021-08-31,173,45974,42.5
13217,Newton County,2021-09-01,166,46140,42.7
13217,Newton County,2021-09-02,175,46315,42.9
13217,Newton County,2021-09-03,210,46525,43
13217,Newton County,2021-09-04,135,46660,43.2
13217,Newton County,2021-09-05,84,46744,43.2
13217,Newton County,2021-09-06,41,46785,43.3
13217,Newton County,2021-09-07,127,46912,43.4
13217,Newton County,2021-09-08,135,47047,43.5
13217,Newton County,2021-09-09,129,47176,43.6
13217,Newton County,2021-09-10,221,47397,43.9
13217,Newton County,2021-09-11,89,47486,43.9
13217,Newton County,2021-09-12,70,47556,44
13217,Newton County,2021-09-13,144,47700,44.1
13217,Newton County,2021-09-14,108,47808,44.2
13217,Newton County,2021-09-15,110,47918,44.3
13217,Newton County,2021-09-16,89,48007,44.4
13217,Newton County,2021-09-17,126,48133,44.5
13217,Newton County,2021-09-18,71,48204,44.6
13217,Newton County,2021-09-19,45,48249,44.6
13217,Newton County,2021-09-20,75,48324,44.7
13217,Newton County,2021-09-21,99,48423,44.8
13217,Newton County,2021-09-22,96,48519,44.9
13217,Newton County,2021-09-23,93,48612,45
13217,Newton County,2021-09-24,85,48697,45.1
13217,Newton County,2021-09-25,43,48740,45.1
13217,Newton County,2021-09-26,25,48765,45.1
13217,Newton County,2021-09-27,54,48819,45.2
13217,Newton County,2021-09-28,47,48866,45.2
13217,Newton County,2021-09-29,54,48920,45.3
13217,Newton County,2021-09-30,50,48970,45.3
13217,Newton County,2021-10-01,65,49035,45.4
13217,Newton County,2021-10-02,37,49072,45.4
13217,Newton County,2021-10-03,23,49095,45.4
13217,Newton County,2021-10-04,37,49132,45.5
13217,Newton County,2021-10-05,17,49149,45.5
13217,Newton County,2021-10-06,28,49177,45.5
13217,Newton County,2021-10-07,28,49205,45.5
13219,Oconee County,2020-12-15,1,1,0
13219,Oconee County,2020-12-17,5,6,0
13219,Oconee County,2020-12-18,38,44,0.1
13219,Oconee County,2020-12-19,19,63,0.2
13219,Oconee County,2020-12-20,3,66,0.2
13219,Oconee County,2020-12-21,62,128,0.3
13219,Oconee County,2020-12-22,124,252,0.7
13219,Oconee County,2020-12-23,150,402,1.1
13219,Oconee County,2020-12-24,36,438,1.1
13219,Oconee County,2020-12-26,29,467,1.2
13219,Oconee County,2020-12-27,10,477,1.3
13219,Oconee County,2020-12-28,155,632,1.7
13219,Oconee County,2020-12-29,194,826,2.2
13219,Oconee County,2020-12-30,80,906,2.4
13219,Oconee County,2020-12-31,52,958,2.5
13219,Oconee County,2021-01-01,9,967,2.5
13219,Oconee County,2021-01-02,30,997,2.6
13219,Oconee County,2021-01-03,9,1006,2.6
13219,Oconee County,2021-01-04,116,1122,2.9
13219,Oconee County,2021-01-05,93,1215,3.2
13219,Oconee County,2021-01-06,156,1371,3.6
13219,Oconee County,2021-01-07,81,1452,3.8
13219,Oconee County,2021-01-08,91,1543,4
13219,Oconee County,2021-01-09,25,1568,4.1
13219,Oconee County,2021-01-10,10,1578,4.1
13219,Oconee County,2021-01-11,138,1716,4.5
13219,Oconee County,2021-01-12,182,1898,5
13219,Oconee County,2021-01-13,165,2063,5.4
13219,Oconee County,2021-01-14,213,2276,6
13219,Oconee County,2021-01-15,200,2476,6.5
13219,Oconee County,2021-01-16,235,2711,7.1
13219,Oconee County,2021-01-17,36,2747,7.2
13219,Oconee County,2021-01-18,109,2856,7.5
13219,Oconee County,2021-01-19,165,3021,7.9
13219,Oconee County,2021-01-20,139,3160,8.3
13219,Oconee County,2021-01-21,270,3430,9
13219,Oconee County,2021-01-22,159,3589,9.4
13219,Oconee County,2021-01-23,190,3779,9.9
13219,Oconee County,2021-01-24,11,3790,9.9
13219,Oconee County,2021-01-25,105,3895,10.2
13219,Oconee County,2021-01-26,117,4012,10.5
13219,Oconee County,2021-01-27,227,4239,11.1
13219,Oconee County,2021-01-28,435,4674,12.3
13219,Oconee County,2021-01-29,245,4919,12.9
13219,Oconee County,2021-01-30,69,4988,13.1
13219,Oconee County,2021-01-31,4,4992,13.1
13219,Oconee County,2021-02-01,73,5065,13.3
13219,Oconee County,2021-02-02,92,5157,13.5
13219,Oconee County,2021-02-03,88,5245,13.8
13219,Oconee County,2021-02-04,183,5428,14.2
13219,Oconee County,2021-02-05,66,5494,14.4
13219,Oconee County,2021-02-06,18,5512,14.5
13219,Oconee County,2021-02-07,12,5524,14.5
13219,Oconee County,2021-02-08,84,5608,14.7
13219,Oconee County,2021-02-09,59,5667,14.9
13219,Oconee County,2021-02-10,52,5719,15
13219,Oconee County,2021-02-11,157,5876,15.4
13219,Oconee County,2021-02-12,62,5938,15.6
13219,Oconee County,2021-02-13,34,5972,15.7
13219,Oconee County,2021-02-14,11,5983,15.7
13219,Oconee County,2021-02-15,71,6054,15.9
13219,Oconee County,2021-02-16,52,6106,16
13219,Oconee County,2021-02-17,58,6164,16.2
13219,Oconee County,2021-02-18,98,6262,16.4
13219,Oconee County,2021-02-19,45,6307,16.5
13219,Oconee County,2021-02-20,12,6319,16.6
13219,Oconee County,2021-02-21,6,6325,16.6
13219,Oconee County,2021-02-22,42,6367,16.7
13219,Oconee County,2021-02-23,52,6419,16.8
13219,Oconee County,2021-02-24,74,6493,17
13219,Oconee County,2021-02-25,91,6584,17.3
13219,Oconee County,2021-02-26,77,6661,17.5
13219,Oconee County,2021-02-27,48,6709,17.6
13219,Oconee County,2021-02-28,51,6760,17.7
13219,Oconee County,2021-03-01,100,6860,18
13219,Oconee County,2021-03-02,99,6959,18.2
13219,Oconee County,2021-03-03,105,7064,18.5
13219,Oconee County,2021-03-04,115,7179,18.8
13219,Oconee County,2021-03-05,101,7280,19.1
13219,Oconee County,2021-03-06,51,7331,19.2
13219,Oconee County,2021-03-07,36,7367,19.3
13219,Oconee County,2021-03-08,742,8109,21.3
13219,Oconee County,2021-03-09,297,8406,22
13219,Oconee County,2021-03-10,368,8774,23
13219,Oconee County,2021-03-11,282,9056,23.7
13219,Oconee County,2021-03-12,186,9242,24.2
13219,Oconee County,2021-03-13,296,9538,25
13219,Oconee County,2021-03-14,48,9586,25.1
13219,Oconee County,2021-03-15,290,9876,25.9
13219,Oconee County,2021-03-16,283,10159,26.6
13219,Oconee County,2021-03-17,455,10614,27.8
13219,Oconee County,2021-03-18,442,11056,29
13219,Oconee County,2021-03-19,253,11309,29.7
13219,Oconee County,2021-03-20,61,11370,29.8
13219,Oconee County,2021-03-21,74,11444,30
13219,Oconee County,2021-03-22,335,11779,30.9
13219,Oconee County,2021-03-23,346,12125,31.8
13219,Oconee County,2021-03-24,452,12577,33
13219,Oconee County,2021-03-25,545,13122,34.4
13219,Oconee County,2021-03-26,290,13412,35.2
13219,Oconee County,2021-03-27,64,13476,35.3
13219,Oconee County,2021-03-28,40,13516,35.4
13219,Oconee County,2021-03-29,312,13828,36.3
13219,Oconee County,2021-03-30,358,14186,37.2
13219,Oconee County,2021-03-31,409,14595,38.3
13219,Oconee County,2021-04-01,382,14977,39.3
13219,Oconee County,2021-04-02,296,15273,40.1
13219,Oconee County,2021-04-03,61,15334,40.2
13219,Oconee County,2021-04-04,29,15363,40.3
13219,Oconee County,2021-04-05,220,15583,40.9
13219,Oconee County,2021-04-06,262,15845,41.6
13219,Oconee County,2021-04-07,217,16062,42.1
13219,Oconee County,2021-04-08,219,16281,42.7
13219,Oconee County,2021-04-09,176,16457,43.2
13219,Oconee County,2021-04-10,95,16552,43.4
13219,Oconee County,2021-04-11,34,16586,43.5
13219,Oconee County,2021-04-12,116,16702,43.8
13219,Oconee County,2021-04-13,102,16804,44.1
13219,Oconee County,2021-04-14,90,16894,44.3
13219,Oconee County,2021-04-15,123,17017,44.6
13219,Oconee County,2021-04-16,92,17109,44.9
13219,Oconee County,2021-04-17,373,17482,45.8
13219,Oconee County,2021-04-18,14,17496,45.9
13219,Oconee County,2021-04-19,66,17562,46.1
13219,Oconee County,2021-04-20,84,17646,46.3
13219,Oconee County,2021-04-21,81,17727,46.5
13219,Oconee County,2021-04-22,88,17815,46.7
13219,Oconee County,2021-04-23,59,17874,46.9
13219,Oconee County,2021-04-24,18,17892,46.9
13219,Oconee County,2021-04-25,15,17907,47
13219,Oconee County,2021-04-26,46,17953,47.1
13219,Oconee County,2021-04-27,61,18014,47.2
13219,Oconee County,2021-04-28,60,18074,47.4
13219,Oconee County,2021-04-29,68,18142,47.6
13219,Oconee County,2021-04-30,96,18238,47.8
13219,Oconee County,2021-05-01,22,18260,47.9
13219,Oconee County,2021-05-02,12,18272,47.9
13219,Oconee County,2021-05-03,59,18331,48.1
13219,Oconee County,2021-05-04,53,18384,48.2
13219,Oconee County,2021-05-05,44,18428,48.3
13219,Oconee County,2021-05-06,49,18477,48.5
13219,Oconee County,2021-05-07,52,18529,48.6
13219,Oconee County,2021-05-08,27,18556,48.7
13219,Oconee County,2021-05-09,14,18570,48.7
13219,Oconee County,2021-05-10,39,18609,48.8
13219,Oconee County,2021-05-11,77,18686,49
13219,Oconee County,2021-05-12,97,18783,49.3
13219,Oconee County,2021-05-13,98,18881,49.5
13219,Oconee County,2021-05-14,131,19012,49.9
13219,Oconee County,2021-05-15,65,19077,50
13219,Oconee County,2021-05-16,44,19121,50.1
13219,Oconee County,2021-05-17,89,19210,50.4
13219,Oconee County,2021-05-18,75,19285,50.6
13219,Oconee County,2021-05-19,83,19368,50.8
13219,Oconee County,2021-05-20,68,19436,51
13219,Oconee County,2021-05-21,66,19502,51.1
13219,Oconee County,2021-05-22,38,19540,51.2
13219,Oconee County,2021-05-23,23,19563,51.3
13219,Oconee County,2021-05-24,61,19624,51.5
13219,Oconee County,2021-05-25,45,19669,51.6
13219,Oconee County,2021-05-26,44,19713,51.7
13219,Oconee County,2021-05-27,43,19756,51.8
13219,Oconee County,2021-05-28,43,19799,51.9
13219,Oconee County,2021-05-29,22,19821,52
13219,Oconee County,2021-05-30,22,19843,52
13219,Oconee County,2021-05-31,3,19846,52
13219,Oconee County,2021-06-01,36,19882,52.1
13219,Oconee County,2021-06-02,33,19915,52.2
13219,Oconee County,2021-06-03,38,19953,52.3
13219,Oconee County,2021-06-04,43,19996,52.4
13219,Oconee County,2021-06-05,36,20032,52.5
13219,Oconee County,2021-06-06,17,20049,52.6
13219,Oconee County,2021-06-07,26,20075,52.6
13219,Oconee County,2021-06-08,33,20108,52.7
13219,Oconee County,2021-06-09,16,20124,52.8
13219,Oconee County,2021-06-10,29,20153,52.9
13219,Oconee County,2021-06-11,35,20188,52.9
13219,Oconee County,2021-06-12,13,20201,53
13219,Oconee County,2021-06-13,4,20205,53
13219,Oconee County,2021-06-14,17,20222,53
13219,Oconee County,2021-06-15,24,20246,53.1
13219,Oconee County,2021-06-16,20,20266,53.1
13219,Oconee County,2021-06-17,10,20276,53.2
13219,Oconee County,2021-06-18,21,20297,53.2
13219,Oconee County,2021-06-19,22,20319,53.3
13219,Oconee County,2021-06-20,6,20325,53.3
13219,Oconee County,2021-06-21,17,20342,53.3
13219,Oconee County,2021-06-22,23,20365,53.4
13219,Oconee County,2021-06-23,21,20386,53.5
13219,Oconee County,2021-06-24,25,20411,53.5
13219,Oconee County,2021-06-25,18,20429,53.6
13219,Oconee County,2021-06-26,15,20444,53.6
13219,Oconee County,2021-06-27,6,20450,53.6
13219,Oconee County,2021-06-28,28,20478,53.7
13219,Oconee County,2021-06-29,17,20495,53.7
13219,Oconee County,2021-06-30,20,20515,53.8
13219,Oconee County,2021-07-01,13,20528,53.8
13219,Oconee County,2021-07-02,18,20546,53.9
13219,Oconee County,2021-07-03,15,20561,53.9
13219,Oconee County,2021-07-04,2,20563,53.9
13219,Oconee County,2021-07-05,18,20581,54
13219,Oconee County,2021-07-06,12,20593,54
13219,Oconee County,2021-07-07,18,20611,54.1
13219,Oconee County,2021-07-08,24,20635,54.1
13219,Oconee County,2021-07-09,16,20651,54.2
13219,Oconee County,2021-07-10,17,20668,54.2
13219,Oconee County,2021-07-11,5,20673,54.2
13219,Oconee County,2021-07-12,16,20689,54.3
13219,Oconee County,2021-07-13,19,20708,54.3
13219,Oconee County,2021-07-14,22,20730,54.4
13219,Oconee County,2021-07-15,17,20747,54.4
13219,Oconee County,2021-07-16,29,20776,54.5
13219,Oconee County,2021-07-17,16,20792,54.5
13219,Oconee County,2021-07-18,17,20809,54.6
13219,Oconee County,2021-07-19,33,20842,54.7
13219,Oconee County,2021-07-20,28,20870,54.7
13219,Oconee County,2021-07-21,28,20898,54.8
13219,Oconee County,2021-07-22,31,20929,54.9
13219,Oconee County,2021-07-23,55,20984,55
13219,Oconee County,2021-07-24,28,21012,55.1
13219,Oconee County,2021-07-25,33,21045,55.2
13219,Oconee County,2021-07-26,46,21091,55.3
13219,Oconee County,2021-07-27,49,21140,55.4
13219,Oconee County,2021-07-28,49,21189,55.6
13219,Oconee County,2021-07-29,48,21237,55.7
13219,Oconee County,2021-07-30,64,21301,55.9
13219,Oconee County,2021-07-31,26,21327,55.9
13219,Oconee County,2021-08-01,27,21354,56
13219,Oconee County,2021-08-02,58,21412,56.2
13219,Oconee County,2021-08-03,58,21470,56.3
13219,Oconee County,2021-08-04,35,21505,56.4
13219,Oconee County,2021-08-05,60,21565,56.6
13219,Oconee County,2021-08-06,81,21646,56.8
13219,Oconee County,2021-08-07,44,21690,56.9
13219,Oconee County,2021-08-08,26,21716,56.9
13219,Oconee County,2021-08-09,74,21790,57.1
13219,Oconee County,2021-08-10,70,21860,57.3
13219,Oconee County,2021-08-11,46,21906,57.4
13219,Oconee County,2021-08-12,57,21963,57.6
13219,Oconee County,2021-08-13,65,22028,57.8
13219,Oconee County,2021-08-14,44,22072,57.9
13219,Oconee County,2021-08-15,31,22103,58
13219,Oconee County,2021-08-16,57,22160,58.1
13219,Oconee County,2021-08-17,59,22219,58.3
13219,Oconee County,2021-08-18,42,22261,58.4
13219,Oconee County,2021-08-19,74,22335,58.6
13219,Oconee County,2021-08-20,58,22393,58.7
13219,Oconee County,2021-08-21,39,22432,58.8
13219,Oconee County,2021-08-22,22,22454,58.9
13219,Oconee County,2021-08-23,62,22516,59
13219,Oconee County,2021-08-24,59,22575,59.2
13219,Oconee County,2021-08-25,66,22641,59.4
13219,Oconee County,2021-08-26,70,22711,59.6
13219,Oconee County,2021-08-27,63,22774,59.7
13219,Oconee County,2021-08-28,30,22804,59.8
13219,Oconee County,2021-08-29,27,22831,59.9
13219,Oconee County,2021-08-30,42,22873,60
13219,Oconee County,2021-08-31,39,22912,60.1
13219,Oconee County,2021-09-01,45,22957,60.2
13219,Oconee County,2021-09-02,42,22999,60.3
13219,Oconee County,2021-09-03,62,23061,60.5
13219,Oconee County,2021-09-04,25,23086,60.5
13219,Oconee County,2021-09-05,18,23104,60.6
13219,Oconee County,2021-09-06,6,23110,60.6
13219,Oconee County,2021-09-07,43,23153,60.7
13219,Oconee County,2021-09-08,30,23183,60.8
13219,Oconee County,2021-09-09,39,23222,60.9
13219,Oconee County,2021-09-10,34,23256,61
13219,Oconee County,2021-09-11,29,23285,61.1
13219,Oconee County,2021-09-12,11,23296,61.1
13219,Oconee County,2021-09-13,38,23334,61.2
13219,Oconee County,2021-09-14,32,23366,61.3
13219,Oconee County,2021-09-15,21,23387,61.3
13219,Oconee County,2021-09-16,18,23405,61.4
13219,Oconee County,2021-09-17,28,23433,61.5
13219,Oconee County,2021-09-18,13,23446,61.5
13219,Oconee County,2021-09-19,4,23450,61.5
13219,Oconee County,2021-09-20,18,23468,61.5
13219,Oconee County,2021-09-21,16,23484,61.6
13219,Oconee County,2021-09-22,16,23500,61.6
13219,Oconee County,2021-09-23,20,23520,61.7
13219,Oconee County,2021-09-24,14,23534,61.7
13219,Oconee County,2021-09-25,16,23550,61.8
13219,Oconee County,2021-09-26,5,23555,61.8
13219,Oconee County,2021-09-27,7,23562,61.8
13219,Oconee County,2021-09-28,15,23577,61.8
13219,Oconee County,2021-09-29,7,23584,61.8
13219,Oconee County,2021-09-30,17,23601,61.9
13219,Oconee County,2021-10-01,18,23619,61.9
13219,Oconee County,2021-10-02,5,23624,62
13219,Oconee County,2021-10-03,4,23628,62
13219,Oconee County,2021-10-04,7,23635,62
13219,Oconee County,2021-10-05,6,23641,62
13219,Oconee County,2021-10-06,7,23648,62
13219,Oconee County,2021-10-07,5,23653,62
13221,Oglethorpe County,2020-12-17,1,1,0
13221,Oglethorpe County,2020-12-18,7,8,0.1
13221,Oglethorpe County,2020-12-19,6,14,0.1
13221,Oglethorpe County,2020-12-21,4,18,0.1
13221,Oglethorpe County,2020-12-22,6,24,0.2
13221,Oglethorpe County,2020-12-23,14,38,0.3
13221,Oglethorpe County,2020-12-24,7,45,0.3
13221,Oglethorpe County,2020-12-26,3,48,0.3
13221,Oglethorpe County,2020-12-27,2,50,0.3
13221,Oglethorpe County,2020-12-28,29,79,0.5
13221,Oglethorpe County,2020-12-29,23,102,0.7
13221,Oglethorpe County,2020-12-30,23,125,0.8
13221,Oglethorpe County,2020-12-31,12,137,0.9
13221,Oglethorpe County,2021-01-01,1,138,0.9
13221,Oglethorpe County,2021-01-02,6,144,1
13221,Oglethorpe County,2021-01-03,3,147,1
13221,Oglethorpe County,2021-01-04,23,170,1.1
13221,Oglethorpe County,2021-01-05,16,186,1.2
13221,Oglethorpe County,2021-01-06,22,208,1.4
13221,Oglethorpe County,2021-01-07,10,218,1.5
13221,Oglethorpe County,2021-01-08,15,233,1.6
13221,Oglethorpe County,2021-01-09,6,239,1.6
13221,Oglethorpe County,2021-01-10,3,242,1.6
13221,Oglethorpe County,2021-01-11,21,263,1.8
13221,Oglethorpe County,2021-01-12,66,329,2.2
13221,Oglethorpe County,2021-01-13,43,372,2.5
13221,Oglethorpe County,2021-01-14,25,397,2.7
13221,Oglethorpe County,2021-01-15,51,448,3
13221,Oglethorpe County,2021-01-16,24,472,3.2
13221,Oglethorpe County,2021-01-17,3,475,3.2
13221,Oglethorpe County,2021-01-18,35,510,3.4
13221,Oglethorpe County,2021-01-19,36,546,3.7
13221,Oglethorpe County,2021-01-20,50,596,4
13221,Oglethorpe County,2021-01-21,101,697,4.7
13221,Oglethorpe County,2021-01-22,56,753,5
13221,Oglethorpe County,2021-01-23,42,795,5.3
13221,Oglethorpe County,2021-01-24,4,799,5.4
13221,Oglethorpe County,2021-01-25,44,843,5.6
13221,Oglethorpe County,2021-01-26,22,865,5.8
13221,Oglethorpe County,2021-01-27,22,887,5.9
13221,Oglethorpe County,2021-01-28,117,1004,6.7
13221,Oglethorpe County,2021-01-29,39,1043,7
13221,Oglethorpe County,2021-01-30,8,1051,7
13221,Oglethorpe County,2021-01-31,3,1054,7.1
13221,Oglethorpe County,2021-02-01,19,1073,7.2
13221,Oglethorpe County,2021-02-02,42,1115,7.5
13221,Oglethorpe County,2021-02-03,23,1138,7.6
13221,Oglethorpe County,2021-02-04,111,1249,8.4
13221,Oglethorpe County,2021-02-05,36,1285,8.6
13221,Oglethorpe County,2021-02-06,6,1291,8.6
13221,Oglethorpe County,2021-02-07,6,1297,8.7
13221,Oglethorpe County,2021-02-08,5,1302,8.7
13221,Oglethorpe County,2021-02-09,30,1332,8.9
13221,Oglethorpe County,2021-02-10,38,1370,9.2
13221,Oglethorpe County,2021-02-11,107,1477,9.9
13221,Oglethorpe County,2021-02-12,17,1494,10
13221,Oglethorpe County,2021-02-13,4,1498,10
13221,Oglethorpe County,2021-02-14,1,1499,10
13221,Oglethorpe County,2021-02-15,13,1512,10.1
13221,Oglethorpe County,2021-02-16,19,1531,10.3
13221,Oglethorpe County,2021-02-17,16,1547,10.4
13221,Oglethorpe County,2021-02-18,41,1588,10.6
13221,Oglethorpe County,2021-02-19,27,1615,10.8
13221,Oglethorpe County,2021-02-21,2,1617,10.8
13221,Oglethorpe County,2021-02-22,18,1635,11
13221,Oglethorpe County,2021-02-23,13,1648,11
13221,Oglethorpe County,2021-02-24,31,1679,11.2
13221,Oglethorpe County,2021-02-25,17,1696,11.4
13221,Oglethorpe County,2021-02-26,23,1719,11.5
13221,Oglethorpe County,2021-02-27,10,1729,11.6
13221,Oglethorpe County,2021-02-28,7,1736,11.6
13221,Oglethorpe County,2021-03-01,34,1770,11.9
13221,Oglethorpe County,2021-03-02,18,1788,12
13221,Oglethorpe County,2021-03-03,28,1816,12.2
13221,Oglethorpe County,2021-03-04,34,1850,12.4
13221,Oglethorpe County,2021-03-05,31,1881,12.6
13221,Oglethorpe County,2021-03-06,7,1888,12.6
13221,Oglethorpe County,2021-03-07,13,1901,12.7
13221,Oglethorpe County,2021-03-08,53,1954,13.1
13221,Oglethorpe County,2021-03-09,45,1999,13.4
13221,Oglethorpe County,2021-03-10,281,2280,15.3
13221,Oglethorpe County,2021-03-11,54,2334,15.6
13221,Oglethorpe County,2021-03-12,202,2536,17
13221,Oglethorpe County,2021-03-13,39,2575,17.2
13221,Oglethorpe County,2021-03-14,4,2579,17.3
13221,Oglethorpe County,2021-03-15,39,2618,17.5
13221,Oglethorpe County,2021-03-16,50,2668,17.9
13221,Oglethorpe County,2021-03-17,277,2945,19.7
13221,Oglethorpe County,2021-03-18,102,3047,20.4
13221,Oglethorpe County,2021-03-19,41,3088,20.7
13221,Oglethorpe County,2021-03-20,8,3096,20.7
13221,Oglethorpe County,2021-03-21,6,3102,20.8
13221,Oglethorpe County,2021-03-22,84,3186,21.3
13221,Oglethorpe County,2021-03-23,52,3238,21.7
13221,Oglethorpe County,2021-03-24,171,3409,22.8
13221,Oglethorpe County,2021-03-25,110,3519,23.6
13221,Oglethorpe County,2021-03-26,67,3586,24
13221,Oglethorpe County,2021-03-27,5,3591,24.1
13221,Oglethorpe County,2021-03-28,4,3595,24.1
13221,Oglethorpe County,2021-03-29,42,3637,24.4
13221,Oglethorpe County,2021-03-30,54,3691,24.7
13221,Oglethorpe County,2021-03-31,221,3912,26.2
13221,Oglethorpe County,2021-04-01,80,3992,26.7
13221,Oglethorpe County,2021-04-02,54,4046,27.1
13221,Oglethorpe County,2021-04-03,14,4060,27.2
13221,Oglethorpe County,2021-04-04,5,4065,27.2
13221,Oglethorpe County,2021-04-05,40,4105,27.5
13221,Oglethorpe County,2021-04-06,44,4149,27.8
13221,Oglethorpe County,2021-04-07,64,4213,28.2
13221,Oglethorpe County,2021-04-08,73,4286,28.7
13221,Oglethorpe County,2021-04-09,54,4340,29.1
13221,Oglethorpe County,2021-04-10,21,4361,29.2
13221,Oglethorpe County,2021-04-11,5,4366,29.2
13221,Oglethorpe County,2021-04-12,26,4392,29.4
13221,Oglethorpe County,2021-04-13,28,4420,29.6
13221,Oglethorpe County,2021-04-14,38,4458,29.9
13221,Oglethorpe County,2021-04-15,38,4496,30.1
13221,Oglethorpe County,2021-04-16,20,4516,30.2
13221,Oglethorpe County,2021-04-17,18,4534,30.4
13221,Oglethorpe County,2021-04-18,2,4536,30.4
13221,Oglethorpe County,2021-04-19,22,4558,30.5
13221,Oglethorpe County,2021-04-20,17,4575,30.6
13221,Oglethorpe County,2021-04-21,32,4607,30.9
13221,Oglethorpe County,2021-04-22,38,4645,31.1
13221,Oglethorpe County,2021-04-23,27,4672,31.3
13221,Oglethorpe County,2021-04-24,10,4682,31.4
13221,Oglethorpe County,2021-04-25,9,4691,31.4
13221,Oglethorpe County,2021-04-26,10,4701,31.5
13221,Oglethorpe County,2021-04-27,21,4722,31.6
13221,Oglethorpe County,2021-04-28,28,4750,31.8
13221,Oglethorpe County,2021-04-29,22,4772,32
13221,Oglethorpe County,2021-04-30,23,4795,32.1
13221,Oglethorpe County,2021-05-01,9,4804,32.2
13221,Oglethorpe County,2021-05-02,2,4806,32.2
13221,Oglethorpe County,2021-05-03,9,4815,32.2
13221,Oglethorpe County,2021-05-04,15,4830,32.3
13221,Oglethorpe County,2021-05-05,19,4849,32.5
13221,Oglethorpe County,2021-05-06,20,4869,32.6
13221,Oglethorpe County,2021-05-07,39,4908,32.9
13221,Oglethorpe County,2021-05-08,12,4920,33
13221,Oglethorpe County,2021-05-09,2,4922,33
13221,Oglethorpe County,2021-05-10,21,4943,33.1
13221,Oglethorpe County,2021-05-11,10,4953,33.2
13221,Oglethorpe County,2021-05-12,16,4969,33.3
13221,Oglethorpe County,2021-05-13,27,4996,33.5
13221,Oglethorpe County,2021-05-14,30,5026,33.7
13221,Oglethorpe County,2021-05-15,14,5040,33.8
13221,Oglethorpe County,2021-05-16,8,5048,33.8
13221,Oglethorpe County,2021-05-17,24,5072,34
13221,Oglethorpe County,2021-05-18,15,5087,34.1
13221,Oglethorpe County,2021-05-19,17,5104,34.2
13221,Oglethorpe County,2021-05-20,16,5120,34.3
13221,Oglethorpe County,2021-05-21,17,5137,34.4
13221,Oglethorpe County,2021-05-22,10,5147,34.5
13221,Oglethorpe County,2021-05-23,2,5149,34.5
13221,Oglethorpe County,2021-05-24,9,5158,34.5
13221,Oglethorpe County,2021-05-25,7,5165,34.6
13221,Oglethorpe County,2021-05-26,21,5186,34.7
13221,Oglethorpe County,2021-05-27,23,5209,34.9
13221,Oglethorpe County,2021-05-28,14,5223,35
13221,Oglethorpe County,2021-05-29,5,5228,35
13221,Oglethorpe County,2021-05-30,1,5229,35
13221,Oglethorpe County,2021-05-31,2,5231,35
13221,Oglethorpe County,2021-06-01,8,5239,35.1
13221,Oglethorpe County,2021-06-02,10,5249,35.2
13221,Oglethorpe County,2021-06-03,5,5254,35.2
13221,Oglethorpe County,2021-06-04,8,5262,35.2
13221,Oglethorpe County,2021-06-05,8,5270,35.3
13221,Oglethorpe County,2021-06-06,5,5275,35.3
13221,Oglethorpe County,2021-06-07,3,5278,35.3
13221,Oglethorpe County,2021-06-08,15,5293,35.4
13221,Oglethorpe County,2021-06-09,10,5303,35.5
13221,Oglethorpe County,2021-06-10,21,5324,35.7
13221,Oglethorpe County,2021-06-11,17,5341,35.8
13221,Oglethorpe County,2021-06-12,6,5347,35.8
13221,Oglethorpe County,2021-06-13,2,5349,35.8
13221,Oglethorpe County,2021-06-14,10,5359,35.9
13221,Oglethorpe County,2021-06-15,8,5367,35.9
13221,Oglethorpe County,2021-06-16,9,5376,36
13221,Oglethorpe County,2021-06-17,3,5379,36
13221,Oglethorpe County,2021-06-18,6,5385,36.1
13221,Oglethorpe County,2021-06-19,6,5391,36.1
13221,Oglethorpe County,2021-06-20,2,5393,36.1
13221,Oglethorpe County,2021-06-21,3,5396,36.1
13221,Oglethorpe County,2021-06-22,5,5401,36.2
13221,Oglethorpe County,2021-06-23,14,5415,36.3
13221,Oglethorpe County,2021-06-24,11,5426,36.3
13221,Oglethorpe County,2021-06-25,7,5433,36.4
13221,Oglethorpe County,2021-06-26,3,5436,36.4
13221,Oglethorpe County,2021-06-27,5,5441,36.4
13221,Oglethorpe County,2021-06-28,4,5445,36.5
13221,Oglethorpe County,2021-06-29,5,5450,36.5
13221,Oglethorpe County,2021-06-30,15,5465,36.6
13221,Oglethorpe County,2021-07-01,13,5478,36.7
13221,Oglethorpe County,2021-07-02,4,5482,36.7
13221,Oglethorpe County,2021-07-03,6,5488,36.8
13221,Oglethorpe County,2021-07-05,1,5489,36.8
13221,Oglethorpe County,2021-07-06,5,5494,36.8
13221,Oglethorpe County,2021-07-07,10,5504,36.9
13221,Oglethorpe County,2021-07-08,16,5520,37
13221,Oglethorpe County,2021-07-09,5,5525,37
13221,Oglethorpe County,2021-07-10,5,5530,37
13221,Oglethorpe County,2021-07-11,4,5534,37.1
13221,Oglethorpe County,2021-07-12,6,5540,37.1
13221,Oglethorpe County,2021-07-13,5,5545,37.1
13221,Oglethorpe County,2021-07-14,12,5557,37.2
13221,Oglethorpe County,2021-07-15,7,5564,37.3
13221,Oglethorpe County,2021-07-16,10,5574,37.3
13221,Oglethorpe County,2021-07-17,4,5578,37.4
13221,Oglethorpe County,2021-07-18,4,5582,37.4
13221,Oglethorpe County,2021-07-19,9,5591,37.4
13221,Oglethorpe County,2021-07-20,4,5595,37.5
13221,Oglethorpe County,2021-07-21,13,5608,37.6
13221,Oglethorpe County,2021-07-22,24,5632,37.7
13221,Oglethorpe County,2021-07-23,14,5646,37.8
13221,Oglethorpe County,2021-07-24,10,5656,37.9
13221,Oglethorpe County,2021-07-25,3,5659,37.9
13221,Oglethorpe County,2021-07-26,11,5670,38
13221,Oglethorpe County,2021-07-27,18,5688,38.1
13221,Oglethorpe County,2021-07-28,7,5695,38.1
13221,Oglethorpe County,2021-07-29,26,5721,38.3
13221,Oglethorpe County,2021-07-30,23,5744,38.5
13221,Oglethorpe County,2021-07-31,14,5758,38.6
13221,Oglethorpe County,2021-08-01,4,5762,38.6
13221,Oglethorpe County,2021-08-02,16,5778,38.7
13221,Oglethorpe County,2021-08-03,21,5799,38.8
13221,Oglethorpe County,2021-08-04,23,5822,39
13221,Oglethorpe County,2021-08-05,20,5842,39.1
13221,Oglethorpe County,2021-08-06,24,5866,39.3
13221,Oglethorpe County,2021-08-07,19,5885,39.4
13221,Oglethorpe County,2021-08-08,8,5893,39.5
13221,Oglethorpe County,2021-08-09,26,5919,39.6
13221,Oglethorpe County,2021-08-10,23,5942,39.8
13221,Oglethorpe County,2021-08-11,19,5961,39.9
13221,Oglethorpe County,2021-08-12,14,5975,40
13221,Oglethorpe County,2021-08-13,28,6003,40.2
13221,Oglethorpe County,2021-08-14,6,6009,40.2
13221,Oglethorpe County,2021-08-15,11,6020,40.3
13221,Oglethorpe County,2021-08-16,13,6033,40.4
13221,Oglethorpe County,2021-08-17,20,6053,40.5
13221,Oglethorpe County,2021-08-18,21,6074,40.7
13221,Oglethorpe County,2021-08-19,22,6096,40.8
13221,Oglethorpe County,2021-08-20,19,6115,41
13221,Oglethorpe County,2021-08-21,12,6127,41
13221,Oglethorpe County,2021-08-22,6,6133,41.1
13221,Oglethorpe County,2021-08-23,24,6157,41.2
13221,Oglethorpe County,2021-08-24,21,6178,41.4
13221,Oglethorpe County,2021-08-25,30,6208,41.6
13221,Oglethorpe County,2021-08-26,36,6244,41.8
13221,Oglethorpe County,2021-08-27,25,6269,42
13221,Oglethorpe County,2021-08-28,10,6279,42.1
13221,Oglethorpe County,2021-08-29,8,6287,42.1
13221,Oglethorpe County,2021-08-30,20,6307,42.2
13221,Oglethorpe County,2021-08-31,30,6337,42.4
13221,Oglethorpe County,2021-09-01,27,6364,42.6
13221,Oglethorpe County,2021-09-02,24,6388,42.8
13221,Oglethorpe County,2021-09-03,25,6413,43
13221,Oglethorpe County,2021-09-04,8,6421,43
13221,Oglethorpe County,2021-09-05,6,6427,43
13221,Oglethorpe County,2021-09-06,4,6431,43.1
13221,Oglethorpe County,2021-09-07,17,6448,43.2
13221,Oglethorpe County,2021-09-08,23,6471,43.3
13221,Oglethorpe County,2021-09-09,13,6484,43.4
13221,Oglethorpe County,2021-09-10,27,6511,43.6
13221,Oglethorpe County,2021-09-11,11,6522,43.7
13221,Oglethorpe County,2021-09-12,7,6529,43.7
13221,Oglethorpe County,2021-09-13,15,6544,43.8
13221,Oglethorpe County,2021-09-14,8,6552,43.9
13221,Oglethorpe County,2021-09-15,12,6564,44
13221,Oglethorpe County,2021-09-16,11,6575,44
13221,Oglethorpe County,2021-09-17,13,6588,44.1
13221,Oglethorpe County,2021-09-18,11,6599,44.2
13221,Oglethorpe County,2021-09-19,6,6605,44.2
13221,Oglethorpe County,2021-09-20,7,6612,44.3
13221,Oglethorpe County,2021-09-21,10,6622,44.4
13221,Oglethorpe County,2021-09-22,13,6635,44.4
13221,Oglethorpe County,2021-09-23,11,6646,44.5
13221,Oglethorpe County,2021-09-24,2,6648,44.5
13221,Oglethorpe County,2021-09-25,5,6653,44.6
13221,Oglethorpe County,2021-09-26,1,6654,44.6
13221,Oglethorpe County,2021-09-27,1,6655,44.6
13221,Oglethorpe County,2021-09-28,7,6662,44.6
13221,Oglethorpe County,2021-09-29,4,6666,44.6
13221,Oglethorpe County,2021-09-30,6,6672,44.7
13221,Oglethorpe County,2021-10-01,5,6677,44.7
13221,Oglethorpe County,2021-10-02,5,6682,44.8
13221,Oglethorpe County,2021-10-03,3,6685,44.8
13221,Oglethorpe County,2021-10-04,8,6693,44.8
13221,Oglethorpe County,2021-10-05,2,6695,44.8
13221,Oglethorpe County,2021-10-06,5,6700,44.9
13221,Oglethorpe County,2021-10-07,12,6712,45
13223,Paulding County,2020-12-15,1,1,0
13223,Paulding County,2020-12-17,3,4,0
13223,Paulding County,2020-12-18,22,26,0
13223,Paulding County,2020-12-19,11,37,0
13223,Paulding County,2020-12-20,18,55,0
13223,Paulding County,2020-12-21,86,141,0.1
13223,Paulding County,2020-12-22,215,356,0.2
13223,Paulding County,2020-12-23,117,473,0.3
13223,Paulding County,2020-12-24,29,502,0.3
13223,Paulding County,2020-12-26,19,521,0.3
13223,Paulding County,2020-12-27,37,558,0.3
13223,Paulding County,2020-12-28,203,761,0.5
13223,Paulding County,2020-12-29,135,896,0.6
13223,Paulding County,2020-12-30,206,1102,0.7
13223,Paulding County,2020-12-31,58,1160,0.7
13223,Paulding County,2021-01-01,15,1175,0.7
13223,Paulding County,2021-01-02,18,1193,0.7
13223,Paulding County,2021-01-03,21,1214,0.8
13223,Paulding County,2021-01-04,167,1381,0.9
13223,Paulding County,2021-01-05,144,1525,1
13223,Paulding County,2021-01-06,148,1673,1
13223,Paulding County,2021-01-07,143,1816,1.1
13223,Paulding County,2021-01-08,195,2011,1.3
13223,Paulding County,2021-01-09,40,2051,1.3
13223,Paulding County,2021-01-10,17,2068,1.3
13223,Paulding County,2021-01-11,324,2392,1.5
13223,Paulding County,2021-01-12,368,2760,1.7
13223,Paulding County,2021-01-13,534,3294,2.1
13223,Paulding County,2021-01-14,511,3805,2.4
13223,Paulding County,2021-01-15,410,4215,2.6
13223,Paulding County,2021-01-16,139,4354,2.7
13223,Paulding County,2021-01-17,48,4402,2.8
13223,Paulding County,2021-01-18,284,4686,2.9
13223,Paulding County,2021-01-19,688,5374,3.4
13223,Paulding County,2021-01-20,486,5860,3.7
13223,Paulding County,2021-01-21,523,6383,4
13223,Paulding County,2021-01-22,445,6828,4.3
13223,Paulding County,2021-01-23,53,6881,4.3
13223,Paulding County,2021-01-24,30,6911,4.3
13223,Paulding County,2021-01-25,415,7326,4.6
13223,Paulding County,2021-01-26,527,7853,4.9
13223,Paulding County,2021-01-27,451,8304,5.2
13223,Paulding County,2021-01-28,506,8810,5.5
13223,Paulding County,2021-01-29,441,9251,5.8
13223,Paulding County,2021-01-30,55,9306,5.8
13223,Paulding County,2021-01-31,8,9314,5.8
13223,Paulding County,2021-02-01,360,9674,6.1
13223,Paulding County,2021-02-02,295,9969,6.2
13223,Paulding County,2021-02-03,317,10286,6.4
13223,Paulding County,2021-02-04,262,10548,6.6
13223,Paulding County,2021-02-05,194,10742,6.7
13223,Paulding County,2021-02-06,32,10774,6.7
13223,Paulding County,2021-02-07,33,10807,6.8
13223,Paulding County,2021-02-08,197,11004,6.9
13223,Paulding County,2021-02-09,216,11220,7
13223,Paulding County,2021-02-10,226,11446,7.2
13223,Paulding County,2021-02-11,122,11568,7.2
13223,Paulding County,2021-02-12,105,11673,7.3
13223,Paulding County,2021-02-13,46,11719,7.3
13223,Paulding County,2021-02-14,18,11737,7.3
13223,Paulding County,2021-02-15,128,11865,7.4
13223,Paulding County,2021-02-16,101,11966,7.5
13223,Paulding County,2021-02-17,129,12095,7.6
13223,Paulding County,2021-02-18,75,12170,7.6
13223,Paulding County,2021-02-19,80,12250,7.7
13223,Paulding County,2021-02-20,27,12277,7.7
13223,Paulding County,2021-02-21,14,12291,7.7
13223,Paulding County,2021-02-22,58,12349,7.7
13223,Paulding County,2021-02-23,141,12490,7.8
13223,Paulding County,2021-02-24,159,12649,7.9
13223,Paulding County,2021-02-25,182,12831,8
13223,Paulding County,2021-02-26,158,12989,8.1
13223,Paulding County,2021-02-27,100,13089,8.2
13223,Paulding County,2021-02-28,106,13195,8.3
13223,Paulding County,2021-03-01,212,13407,8.4
13223,Paulding County,2021-03-02,280,13687,8.6
13223,Paulding County,2021-03-03,300,13987,8.8
13223,Paulding County,2021-03-04,234,14221,8.9
13223,Paulding County,2021-03-05,316,14537,9.1
13223,Paulding County,2021-03-06,94,14631,9.2
13223,Paulding County,2021-03-07,173,14804,9.3
13223,Paulding County,2021-03-08,582,15386,9.6
13223,Paulding County,2021-03-09,576,15962,10
13223,Paulding County,2021-03-10,609,16571,10.4
13223,Paulding County,2021-03-11,526,17097,10.7
13223,Paulding County,2021-03-12,545,17642,11
13223,Paulding County,2021-03-13,150,17792,11.1
13223,Paulding County,2021-03-14,158,17950,11.2
13223,Paulding County,2021-03-15,699,18649,11.7
13223,Paulding County,2021-03-16,943,19592,12.3
13223,Paulding County,2021-03-17,704,20296,12.7
13223,Paulding County,2021-03-18,648,20944,13.1
13223,Paulding County,2021-03-19,812,21756,13.6
13223,Paulding County,2021-03-20,240,21996,13.8
13223,Paulding County,2021-03-21,178,22174,13.9
13223,Paulding County,2021-03-22,633,22807,14.3
13223,Paulding County,2021-03-23,617,23424,14.7
13223,Paulding County,2021-03-24,816,24240,15.2
13223,Paulding County,2021-03-25,726,24966,15.6
13223,Paulding County,2021-03-26,698,25664,16.1
13223,Paulding County,2021-03-27,234,25898,16.2
13223,Paulding County,2021-03-28,200,26098,16.3
13223,Paulding County,2021-03-29,710,26808,16.8
13223,Paulding County,2021-03-30,960,27768,17.4
13223,Paulding County,2021-03-31,892,28660,17.9
13223,Paulding County,2021-04-01,905,29565,18.5
13223,Paulding County,2021-04-02,702,30267,18.9
13223,Paulding County,2021-04-03,201,30468,19.1
13223,Paulding County,2021-04-04,172,30640,19.2
13223,Paulding County,2021-04-05,690,31330,19.6
13223,Paulding County,2021-04-06,922,32252,20.2
13223,Paulding County,2021-04-07,714,32966,20.6
13223,Paulding County,2021-04-08,878,33844,21.2
13223,Paulding County,2021-04-09,723,34567,21.6
13223,Paulding County,2021-04-10,395,34962,21.9
13223,Paulding County,2021-04-11,169,35131,22
13223,Paulding County,2021-04-12,584,35715,22.3
13223,Paulding County,2021-04-13,629,36344,22.7
13223,Paulding County,2021-04-14,484,36828,23
13223,Paulding County,2021-04-15,589,37417,23.4
13223,Paulding County,2021-04-16,414,37831,23.7
13223,Paulding County,2021-04-17,94,37925,23.7
13223,Paulding County,2021-04-18,88,38013,23.8
13223,Paulding County,2021-04-19,354,38367,24
13223,Paulding County,2021-04-20,474,38841,24.3
13223,Paulding County,2021-04-21,363,39204,24.5
13223,Paulding County,2021-04-22,434,39638,24.8
13223,Paulding County,2021-04-23,373,40011,25
13223,Paulding County,2021-04-24,175,40186,25.1
13223,Paulding County,2021-04-25,65,40251,25.2
13223,Paulding County,2021-04-26,313,40564,25.4
13223,Paulding County,2021-04-27,398,40962,25.6
13223,Paulding County,2021-04-28,336,41298,25.8
13223,Paulding County,2021-04-29,350,41648,26.1
13223,Paulding County,2021-04-30,343,41991,26.3
13223,Paulding County,2021-05-01,166,42157,26.4
13223,Paulding County,2021-05-02,98,42255,26.4
13223,Paulding County,2021-05-03,162,42417,26.5
13223,Paulding County,2021-05-04,303,42720,26.7
13223,Paulding County,2021-05-05,236,42956,26.9
13223,Paulding County,2021-05-06,260,43216,27
13223,Paulding County,2021-05-07,246,43462,27.2
13223,Paulding County,2021-05-08,147,43609,27.3
13223,Paulding County,2021-05-09,52,43661,27.3
13223,Paulding County,2021-05-10,132,43793,27.4
13223,Paulding County,2021-05-11,213,44006,27.5
13223,Paulding County,2021-05-12,205,44211,27.7
13223,Paulding County,2021-05-13,234,44445,27.8
13223,Paulding County,2021-05-14,356,44801,28
13223,Paulding County,2021-05-15,256,45057,28.2
13223,Paulding County,2021-05-16,165,45222,28.3
13223,Paulding County,2021-05-17,304,45526,28.5
13223,Paulding County,2021-05-18,337,45863,28.7
13223,Paulding County,2021-05-19,298,46161,28.9
13223,Paulding County,2021-05-20,278,46439,29.1
13223,Paulding County,2021-05-21,263,46702,29.2
13223,Paulding County,2021-05-22,220,46922,29.4
13223,Paulding County,2021-05-23,88,47010,29.4
13223,Paulding County,2021-05-24,192,47202,29.5
13223,Paulding County,2021-05-25,178,47380,29.6
13223,Paulding County,2021-05-26,196,47576,29.8
13223,Paulding County,2021-05-27,171,47747,29.9
13223,Paulding County,2021-05-28,158,47905,30
13223,Paulding County,2021-05-29,76,47981,30
13223,Paulding County,2021-05-30,74,48055,30.1
13223,Paulding County,2021-05-31,34,48089,30.1
13223,Paulding County,2021-06-01,213,48302,30.2
13223,Paulding County,2021-06-02,151,48453,30.3
13223,Paulding County,2021-06-03,182,48635,30.4
13223,Paulding County,2021-06-04,155,48790,30.5
13223,Paulding County,2021-06-05,113,48903,30.6
13223,Paulding County,2021-06-06,60,48963,30.6
13223,Paulding County,2021-06-07,129,49092,30.7
13223,Paulding County,2021-06-08,131,49223,30.8
13223,Paulding County,2021-06-09,107,49330,30.9
13223,Paulding County,2021-06-10,149,49479,31
13223,Paulding County,2021-06-11,150,49629,31.1
13223,Paulding County,2021-06-12,87,49716,31.1
13223,Paulding County,2021-06-13,34,49750,31.1
13223,Paulding County,2021-06-14,97,49847,31.2
13223,Paulding County,2021-06-15,96,49943,31.2
13223,Paulding County,2021-06-16,101,50044,31.3
13223,Paulding County,2021-06-17,91,50135,31.4
13223,Paulding County,2021-06-18,109,50244,31.4
13223,Paulding County,2021-06-19,95,50339,31.5
13223,Paulding County,2021-06-20,39,50378,31.5
13223,Paulding County,2021-06-21,97,50475,31.6
13223,Paulding County,2021-06-22,99,50574,31.6
13223,Paulding County,2021-06-23,112,50686,31.7
13223,Paulding County,2021-06-24,83,50769,31.8
13223,Paulding County,2021-06-25,111,50880,31.8
13223,Paulding County,2021-06-26,67,50947,31.9
13223,Paulding County,2021-06-27,56,51003,31.9
13223,Paulding County,2021-06-28,77,51080,32
13223,Paulding County,2021-06-29,80,51160,32
13223,Paulding County,2021-06-30,67,51227,32.1
13223,Paulding County,2021-07-01,86,51313,32.1
13223,Paulding County,2021-07-02,95,51408,32.2
13223,Paulding County,2021-07-03,78,51486,32.2
13223,Paulding County,2021-07-04,5,51491,32.2
13223,Paulding County,2021-07-05,74,51565,32.3
13223,Paulding County,2021-07-06,104,51669,32.3
13223,Paulding County,2021-07-07,86,51755,32.4
13223,Paulding County,2021-07-08,84,51839,32.4
13223,Paulding County,2021-07-09,110,51949,32.5
13223,Paulding County,2021-07-10,87,52036,32.6
13223,Paulding County,2021-07-11,59,52095,32.6
13223,Paulding County,2021-07-12,89,52184,32.7
13223,Paulding County,2021-07-13,95,52279,32.7
13223,Paulding County,2021-07-14,99,52378,32.8
13223,Paulding County,2021-07-15,113,52491,32.8
13223,Paulding County,2021-07-16,108,52599,32.9
13223,Paulding County,2021-07-17,90,52689,33
13223,Paulding County,2021-07-18,53,52742,33
13223,Paulding County,2021-07-19,134,52876,33.1
13223,Paulding County,2021-07-20,147,53023,33.2
13223,Paulding County,2021-07-21,136,53159,33.3
13223,Paulding County,2021-07-22,173,53332,33.4
13223,Paulding County,2021-07-23,222,53554,33.5
13223,Paulding County,2021-07-24,158,53712,33.6
13223,Paulding County,2021-07-25,117,53829,33.7
13223,Paulding County,2021-07-26,173,54002,33.8
13223,Paulding County,2021-07-27,216,54218,33.9
13223,Paulding County,2021-07-28,198,54416,34
13223,Paulding County,2021-07-29,214,54630,34.2
13223,Paulding County,2021-07-30,265,54895,34.3
13223,Paulding County,2021-07-31,192,55087,34.5
13223,Paulding County,2021-08-01,128,55215,34.5
13223,Paulding County,2021-08-02,227,55442,34.7
13223,Paulding County,2021-08-03,205,55647,34.8
13223,Paulding County,2021-08-04,213,55860,35
13223,Paulding County,2021-08-05,263,56123,35.1
13223,Paulding County,2021-08-06,324,56447,35.3
13223,Paulding County,2021-08-07,166,56613,35.4
13223,Paulding County,2021-08-08,152,56765,35.5
13223,Paulding County,2021-08-09,260,57025,35.7
13223,Paulding County,2021-08-10,288,57313,35.9
13223,Paulding County,2021-08-11,248,57561,36
13223,Paulding County,2021-08-12,246,57807,36.2
13223,Paulding County,2021-08-13,287,58094,36.3
13223,Paulding County,2021-08-14,207,58301,36.5
13223,Paulding County,2021-08-15,125,58426,36.6
13223,Paulding County,2021-08-16,239,58665,36.7
13223,Paulding County,2021-08-17,200,58865,36.8
13223,Paulding County,2021-08-18,215,59080,37
13223,Paulding County,2021-08-19,246,59326,37.1
13223,Paulding County,2021-08-20,290,59616,37.3
13223,Paulding County,2021-08-21,171,59787,37.4
13223,Paulding County,2021-08-22,99,59886,37.5
13223,Paulding County,2021-08-23,212,60098,37.6
13223,Paulding County,2021-08-24,228,60326,37.7
13223,Paulding County,2021-08-25,260,60586,37.9
13223,Paulding County,2021-08-26,235,60821,38.1
13223,Paulding County,2021-08-27,292,61113,38.2
13223,Paulding County,2021-08-28,206,61319,38.4
13223,Paulding County,2021-08-29,102,61421,38.4
13223,Paulding County,2021-08-30,235,61656,38.6
13223,Paulding County,2021-08-31,202,61858,38.7
13223,Paulding County,2021-09-01,225,62083,38.8
13223,Paulding County,2021-09-02,232,62315,39
13223,Paulding County,2021-09-03,300,62615,39.2
13223,Paulding County,2021-09-04,154,62769,39.3
13223,Paulding County,2021-09-05,127,62896,39.4
13223,Paulding County,2021-09-06,43,62939,39.4
13223,Paulding County,2021-09-07,170,63109,39.5
13223,Paulding County,2021-09-08,204,63313,39.6
13223,Paulding County,2021-09-09,211,63524,39.7
13223,Paulding County,2021-09-10,256,63780,39.9
13223,Paulding County,2021-09-11,162,63942,40
13223,Paulding County,2021-09-12,99,64041,40.1
13223,Paulding County,2021-09-13,192,64233,40.2
13223,Paulding County,2021-09-14,149,64382,40.3
13223,Paulding County,2021-09-15,126,64508,40.4
13223,Paulding County,2021-09-16,119,64627,40.4
13223,Paulding County,2021-09-17,159,64786,40.5
13223,Paulding County,2021-09-18,119,64905,40.6
13223,Paulding County,2021-09-19,58,64963,40.6
13223,Paulding County,2021-09-20,104,65067,40.7
13223,Paulding County,2021-09-21,118,65185,40.8
13223,Paulding County,2021-09-22,95,65280,40.8
13223,Paulding County,2021-09-23,113,65393,40.9
13223,Paulding County,2021-09-24,82,65475,41
13223,Paulding County,2021-09-25,74,65549,41
13223,Paulding County,2021-09-26,36,65585,41
13223,Paulding County,2021-09-27,50,65635,41.1
13223,Paulding County,2021-09-28,51,65686,41.1
13223,Paulding County,2021-09-29,68,65754,41.1
13223,Paulding County,2021-09-30,49,65803,41.2
13223,Paulding County,2021-10-01,71,65874,41.2
13223,Paulding County,2021-10-02,26,65900,41.2
13223,Paulding County,2021-10-03,20,65920,41.2
13223,Paulding County,2021-10-04,28,65948,41.3
13223,Paulding County,2021-10-05,41,65989,41.3
13223,Paulding County,2021-10-06,36,66025,41.3
13223,Paulding County,2021-10-07,16,66041,41.3
13225,Peach County,2020-12-18,1,1,0
13225,Peach County,2020-12-19,1,2,0
13225,Peach County,2020-12-21,2,4,0
13225,Peach County,2020-12-22,9,13,0
13225,Peach County,2020-12-23,26,39,0.1
13225,Peach County,2020-12-24,26,65,0.2
13225,Peach County,2020-12-26,9,74,0.3
13225,Peach County,2020-12-27,3,77,0.3
13225,Peach County,2020-12-28,38,115,0.4
13225,Peach County,2020-12-29,28,143,0.5
13225,Peach County,2020-12-30,27,170,0.6
13225,Peach County,2020-12-31,12,182,0.7
13225,Peach County,2021-01-01,5,187,0.7
13225,Peach County,2021-01-02,6,193,0.7
13225,Peach County,2021-01-03,5,198,0.7
13225,Peach County,2021-01-04,15,213,0.8
13225,Peach County,2021-01-05,68,281,1
13225,Peach County,2021-01-06,29,310,1.1
13225,Peach County,2021-01-07,35,345,1.3
13225,Peach County,2021-01-08,21,366,1.3
13225,Peach County,2021-01-09,8,374,1.4
13225,Peach County,2021-01-10,2,376,1.4
13225,Peach County,2021-01-11,64,440,1.6
13225,Peach County,2021-01-12,92,532,2
13225,Peach County,2021-01-13,48,580,2.1
13225,Peach County,2021-01-14,89,669,2.5
13225,Peach County,2021-01-15,97,766,2.8
13225,Peach County,2021-01-16,34,800,2.9
13225,Peach County,2021-01-17,20,820,3
13225,Peach County,2021-01-18,123,943,3.5
13225,Peach County,2021-01-19,54,997,3.7
13225,Peach County,2021-01-20,99,1096,4
13225,Peach County,2021-01-21,57,1153,4.2
13225,Peach County,2021-01-22,147,1300,4.8
13225,Peach County,2021-01-23,20,1320,4.9
13225,Peach County,2021-01-24,3,1323,4.9
13225,Peach County,2021-01-25,80,1403,5.2
13225,Peach County,2021-01-26,102,1505,5.5
13225,Peach County,2021-01-27,98,1603,5.9
13225,Peach County,2021-01-28,92,1695,6.2
13225,Peach County,2021-01-29,118,1813,6.7
13225,Peach County,2021-01-30,11,1824,6.7
13225,Peach County,2021-02-01,59,1883,6.9
13225,Peach County,2021-02-02,12,1895,7
13225,Peach County,2021-02-03,81,1976,7.3
13225,Peach County,2021-02-04,58,2034,7.5
13225,Peach County,2021-02-05,76,2110,7.8
13225,Peach County,2021-02-06,9,2119,7.8
13225,Peach County,2021-02-08,80,2199,8.1
13225,Peach County,2021-02-09,34,2233,8.2
13225,Peach County,2021-02-10,60,2293,8.4
13225,Peach County,2021-02-11,41,2334,8.6
13225,Peach County,2021-02-12,88,2422,8.9
13225,Peach County,2021-02-13,14,2436,9
13225,Peach County,2021-02-14,2,2438,9
13225,Peach County,2021-02-15,47,2485,9.2
13225,Peach County,2021-02-16,48,2533,9.3
13225,Peach County,2021-02-17,41,2574,9.5
13225,Peach County,2021-02-18,18,2592,9.5
13225,Peach County,2021-02-19,50,2642,9.7
13225,Peach County,2021-02-20,7,2649,9.8
13225,Peach County,2021-02-22,41,2690,9.9
13225,Peach County,2021-02-23,33,2723,10
13225,Peach County,2021-02-24,42,2765,10.2
13225,Peach County,2021-02-25,46,2811,10.4
13225,Peach County,2021-02-26,46,2857,10.5
13225,Peach County,2021-02-27,3,2860,10.5
13225,Peach County,2021-02-28,18,2878,10.6
13225,Peach County,2021-03-01,141,3019,11.1
13225,Peach County,2021-03-02,67,3086,11.4
13225,Peach County,2021-03-03,114,3200,11.8
13225,Peach County,2021-03-04,76,3276,12.1
13225,Peach County,2021-03-05,109,3385,12.5
13225,Peach County,2021-03-06,45,3430,12.6
13225,Peach County,2021-03-07,11,3441,12.7
13225,Peach County,2021-03-08,191,3632,13.4
13225,Peach County,2021-03-09,149,3781,13.9
13225,Peach County,2021-03-10,186,3967,14.6
13225,Peach County,2021-03-11,93,4060,15
13225,Peach County,2021-03-12,190,4250,15.7
13225,Peach County,2021-03-13,46,4296,15.8
13225,Peach County,2021-03-14,12,4308,15.9
13225,Peach County,2021-03-15,201,4509,16.6
13225,Peach County,2021-03-16,112,4621,17
13225,Peach County,2021-03-17,119,4740,17.5
13225,Peach County,2021-03-18,135,4875,18
13225,Peach County,2021-03-19,302,5177,19.1
13225,Peach County,2021-03-20,32,5209,19.2
13225,Peach County,2021-03-21,20,5229,19.3
13225,Peach County,2021-03-22,142,5371,19.8
13225,Peach County,2021-03-23,106,5477,20.2
13225,Peach County,2021-03-24,108,5585,20.6
13225,Peach County,2021-03-25,152,5737,21.1
13225,Peach County,2021-03-26,204,5941,21.9
13225,Peach County,2021-03-27,24,5965,22
13225,Peach County,2021-03-28,14,5979,22
13225,Peach County,2021-03-29,159,6138,22.6
13225,Peach County,2021-03-30,154,6292,23.2
13225,Peach County,2021-03-31,172,6464,23.8
13225,Peach County,2021-04-01,150,6614,24.4
13225,Peach County,2021-04-02,118,6732,24.8
13225,Peach County,2021-04-03,41,6773,25
13225,Peach County,2021-04-04,14,6787,25
13225,Peach County,2021-04-05,143,6930,25.5
13225,Peach County,2021-04-06,91,7021,25.9
13225,Peach County,2021-04-07,141,7162,26.4
13225,Peach County,2021-04-08,167,7329,27
13225,Peach County,2021-04-09,209,7538,27.8
13225,Peach County,2021-04-10,44,7582,27.9
13225,Peach County,2021-04-11,23,7605,28
13225,Peach County,2021-04-12,135,7740,28.5
13225,Peach County,2021-04-13,187,7927,29.2
13225,Peach County,2021-04-14,56,7983,29.4
13225,Peach County,2021-04-15,50,8033,29.6
13225,Peach County,2021-04-16,101,8134,30
13225,Peach County,2021-04-17,18,8152,30
13225,Peach County,2021-04-18,7,8159,30.1
13225,Peach County,2021-04-19,52,8211,30.2
13225,Peach County,2021-04-20,136,8347,30.7
13225,Peach County,2021-04-21,44,8391,30.9
13225,Peach County,2021-04-22,37,8428,31
13225,Peach County,2021-04-23,55,8483,31.3
13225,Peach County,2021-04-24,14,8497,31.3
13225,Peach County,2021-04-25,11,8508,31.3
13225,Peach County,2021-04-26,42,8550,31.5
13225,Peach County,2021-04-27,40,8590,31.6
13225,Peach County,2021-04-28,47,8637,31.8
13225,Peach County,2021-04-29,35,8672,31.9
13225,Peach County,2021-04-30,56,8728,32.2
13225,Peach County,2021-05-01,20,8748,32.2
13225,Peach County,2021-05-02,15,8763,32.3
13225,Peach County,2021-05-03,39,8802,32.4
13225,Peach County,2021-05-04,40,8842,32.6
13225,Peach County,2021-05-05,50,8892,32.8
13225,Peach County,2021-05-06,32,8924,32.9
13225,Peach County,2021-05-07,58,8982,33.1
13225,Peach County,2021-05-08,11,8993,33.1
13225,Peach County,2021-05-09,7,9000,33.2
13225,Peach County,2021-05-10,18,9018,33.2
13225,Peach County,2021-05-11,39,9057,33.4
13225,Peach County,2021-05-12,29,9086,33.5
13225,Peach County,2021-05-13,39,9125,33.6
13225,Peach County,2021-05-14,62,9187,33.8
13225,Peach County,2021-05-15,42,9229,34
13225,Peach County,2021-05-16,25,9254,34.1
13225,Peach County,2021-05-17,38,9292,34.2
13225,Peach County,2021-05-18,48,9340,34.4
13225,Peach County,2021-05-19,47,9387,34.6
13225,Peach County,2021-05-20,33,9420,34.7
13225,Peach County,2021-05-21,50,9470,34.9
13225,Peach County,2021-05-22,39,9509,35
13225,Peach County,2021-05-23,11,9520,35.1
13225,Peach County,2021-05-24,23,9543,35.2
13225,Peach County,2021-05-25,20,9563,35.2
13225,Peach County,2021-05-26,23,9586,35.3
13225,Peach County,2021-05-27,25,9611,35.4
13225,Peach County,2021-05-28,18,9629,35.5
13225,Peach County,2021-05-29,21,9650,35.5
13225,Peach County,2021-05-30,9,9659,35.6
13225,Peach County,2021-05-31,2,9661,35.6
13225,Peach County,2021-06-01,19,9680,35.7
13225,Peach County,2021-06-02,20,9700,35.7
13225,Peach County,2021-06-03,21,9721,35.8
13225,Peach County,2021-06-04,20,9741,35.9
13225,Peach County,2021-06-05,14,9755,35.9
13225,Peach County,2021-06-06,7,9762,36
13225,Peach County,2021-06-07,27,9789,36.1
13225,Peach County,2021-06-08,15,9804,36.1
13225,Peach County,2021-06-09,15,9819,36.2
13225,Peach County,2021-06-10,26,9845,36.3
13225,Peach County,2021-06-11,28,9873,36.4
13225,Peach County,2021-06-12,11,9884,36.4
13225,Peach County,2021-06-14,12,9896,36.5
13225,Peach County,2021-06-15,17,9913,36.5
13225,Peach County,2021-06-16,16,9929,36.6
13225,Peach County,2021-06-17,7,9936,36.6
13225,Peach County,2021-06-18,17,9953,36.7
13225,Peach County,2021-06-19,4,9957,36.7
13225,Peach County,2021-06-20,2,9959,36.7
13225,Peach County,2021-06-21,20,9979,36.8
13225,Peach County,2021-06-22,8,9987,36.8
13225,Peach County,2021-06-23,21,10008,36.9
13225,Peach County,2021-06-24,10,10018,36.9
13225,Peach County,2021-06-25,14,10032,37
13225,Peach County,2021-06-26,5,10037,37
13225,Peach County,2021-06-27,7,10044,37
13225,Peach County,2021-06-28,15,10059,37.1
13225,Peach County,2021-06-29,19,10078,37.1
13225,Peach County,2021-06-30,12,10090,37.2
13225,Peach County,2021-07-01,11,10101,37.2
13225,Peach County,2021-07-02,15,10116,37.3
13225,Peach County,2021-07-03,10,10126,37.3
13225,Peach County,2021-07-04,1,10127,37.3
13225,Peach County,2021-07-05,11,10138,37.3
13225,Peach County,2021-07-06,17,10155,37.4
13225,Peach County,2021-07-07,21,10176,37.5
13225,Peach County,2021-07-08,9,10185,37.5
13225,Peach County,2021-07-09,16,10201,37.6
13225,Peach County,2021-07-10,14,10215,37.6
13225,Peach County,2021-07-11,2,10217,37.6
13225,Peach County,2021-07-12,8,10225,37.7
13225,Peach County,2021-07-13,17,10242,37.7
13225,Peach County,2021-07-14,14,10256,37.8
13225,Peach County,2021-07-15,20,10276,37.9
13225,Peach County,2021-07-16,20,10296,37.9
13225,Peach County,2021-07-17,21,10317,38
13225,Peach County,2021-07-18,9,10326,38
13225,Peach County,2021-07-19,22,10348,38.1
13225,Peach County,2021-07-20,15,10363,38.2
13225,Peach County,2021-07-21,32,10395,38.3
13225,Peach County,2021-07-22,33,10428,38.4
13225,Peach County,2021-07-23,45,10473,38.6
13225,Peach County,2021-07-24,45,10518,38.7
13225,Peach County,2021-07-25,16,10534,38.8
13225,Peach County,2021-07-26,48,10582,39
13225,Peach County,2021-07-27,39,10621,39.1
13225,Peach County,2021-07-28,52,10673,39.3
13225,Peach County,2021-07-29,51,10724,39.5
13225,Peach County,2021-07-30,56,10780,39.7
13225,Peach County,2021-07-31,24,10804,39.8
13225,Peach County,2021-08-01,13,10817,39.8
13225,Peach County,2021-08-02,38,10855,40
13225,Peach County,2021-08-03,52,10907,40.2
13225,Peach County,2021-08-04,42,10949,40.3
13225,Peach County,2021-08-05,41,10990,40.5
13225,Peach County,2021-08-06,90,11080,40.8
13225,Peach County,2021-08-07,40,11120,41
13225,Peach County,2021-08-08,26,11146,41.1
13225,Peach County,2021-08-09,47,11193,41.2
13225,Peach County,2021-08-10,87,11280,41.6
13225,Peach County,2021-08-11,53,11333,41.7
13225,Peach County,2021-08-12,50,11383,41.9
13225,Peach County,2021-08-13,101,11484,42.3
13225,Peach County,2021-08-14,29,11513,42.4
13225,Peach County,2021-08-15,12,11525,42.5
13225,Peach County,2021-08-16,42,11567,42.6
13225,Peach County,2021-08-17,51,11618,42.8
13225,Peach County,2021-08-18,59,11677,43
13225,Peach County,2021-08-19,75,11752,43.3
13225,Peach County,2021-08-20,62,11814,43.5
13225,Peach County,2021-08-21,28,11842,43.6
13225,Peach County,2021-08-22,24,11866,43.7
13225,Peach County,2021-08-23,50,11916,43.9
13225,Peach County,2021-08-24,51,11967,44.1
13225,Peach County,2021-08-25,53,12020,44.3
13225,Peach County,2021-08-26,58,12078,44.5
13225,Peach County,2021-08-27,57,12135,44.7
13225,Peach County,2021-08-28,36,12171,44.8
13225,Peach County,2021-08-29,25,12196,44.9
13225,Peach County,2021-08-30,41,12237,45.1
13225,Peach County,2021-08-31,45,12282,45.2
13225,Peach County,2021-09-01,38,12320,45.4
13225,Peach County,2021-09-02,43,12363,45.5
13225,Peach County,2021-09-03,65,12428,45.8
13225,Peach County,2021-09-04,29,12457,45.9
13225,Peach County,2021-09-05,24,12481,46
13225,Peach County,2021-09-06,7,12488,46
13225,Peach County,2021-09-07,43,12531,46.2
13225,Peach County,2021-09-08,42,12573,46.3
13225,Peach County,2021-09-09,31,12604,46.4
13225,Peach County,2021-09-10,73,12677,46.7
13225,Peach County,2021-09-11,29,12706,46.8
13225,Peach County,2021-09-12,22,12728,46.9
13225,Peach County,2021-09-13,28,12756,47
13225,Peach County,2021-09-14,32,12788,47.1
13225,Peach County,2021-09-15,28,12816,47.2
13225,Peach County,2021-09-16,29,12845,47.3
13225,Peach County,2021-09-17,37,12882,47.5
13225,Peach County,2021-09-18,10,12892,47.5
13225,Peach County,2021-09-19,10,12902,47.5
13225,Peach County,2021-09-20,22,12924,47.6
13225,Peach County,2021-09-21,17,12941,47.7
13225,Peach County,2021-09-22,13,12954,47.7
13225,Peach County,2021-09-23,20,12974,47.8
13225,Peach County,2021-09-24,24,12998,47.9
13225,Peach County,2021-09-25,13,13011,47.9
13225,Peach County,2021-09-26,11,13022,48
13225,Peach County,2021-09-27,8,13030,48
13225,Peach County,2021-09-28,15,13045,48.1
13225,Peach County,2021-09-29,17,13062,48.1
13225,Peach County,2021-09-30,14,13076,48.2
13225,Peach County,2021-10-01,19,13095,48.2
13225,Peach County,2021-10-02,2,13097,48.2
13225,Peach County,2021-10-03,6,13103,48.3
13225,Peach County,2021-10-04,10,13113,48.3
13225,Peach County,2021-10-05,4,13117,48.3
13225,Peach County,2021-10-06,10,13127,48.4
13225,Peach County,2021-10-07,7,13134,48.4
13227,Pickens County,2020-12-17,1,1,0
13227,Pickens County,2020-12-18,7,8,0
13227,Pickens County,2020-12-19,2,10,0
13227,Pickens County,2020-12-20,3,13,0
13227,Pickens County,2020-12-21,10,23,0.1
13227,Pickens County,2020-12-22,16,39,0.1
13227,Pickens County,2020-12-23,48,87,0.3
13227,Pickens County,2020-12-24,8,95,0.3
13227,Pickens County,2020-12-26,3,98,0.3
13227,Pickens County,2020-12-27,4,102,0.3
13227,Pickens County,2020-12-28,42,144,0.5
13227,Pickens County,2020-12-29,89,233,0.7
13227,Pickens County,2020-12-30,49,282,0.9
13227,Pickens County,2020-12-31,26,308,1
13227,Pickens County,2021-01-01,12,320,1
13227,Pickens County,2021-01-02,4,324,1
13227,Pickens County,2021-01-03,6,330,1.1
13227,Pickens County,2021-01-04,56,386,1.2
13227,Pickens County,2021-01-05,56,442,1.4
13227,Pickens County,2021-01-06,71,513,1.6
13227,Pickens County,2021-01-07,43,556,1.8
13227,Pickens County,2021-01-08,43,599,1.9
13227,Pickens County,2021-01-09,2,601,1.9
13227,Pickens County,2021-01-10,6,607,1.9
13227,Pickens County,2021-01-11,157,764,2.4
13227,Pickens County,2021-01-12,242,1006,3.2
13227,Pickens County,2021-01-13,271,1277,4.1
13227,Pickens County,2021-01-14,281,1558,5
13227,Pickens County,2021-01-15,273,1831,5.8
13227,Pickens County,2021-01-16,120,1951,6.2
13227,Pickens County,2021-01-17,25,1976,6.3
13227,Pickens County,2021-01-18,214,2190,7
13227,Pickens County,2021-01-19,304,2494,7.9
13227,Pickens County,2021-01-20,229,2723,8.7
13227,Pickens County,2021-01-21,225,2948,9.4
13227,Pickens County,2021-01-22,140,3088,9.8
13227,Pickens County,2021-01-23,43,3131,10
13227,Pickens County,2021-01-24,4,3135,10
13227,Pickens County,2021-01-25,180,3315,10.6
13227,Pickens County,2021-01-26,134,3449,11
13227,Pickens County,2021-01-27,196,3645,11.6
13227,Pickens County,2021-01-28,103,3748,11.9
13227,Pickens County,2021-01-29,84,3832,12.2
13227,Pickens County,2021-01-30,34,3866,12.3
13227,Pickens County,2021-01-31,5,3871,12.3
13227,Pickens County,2021-02-01,70,3941,12.6
13227,Pickens County,2021-02-02,132,4073,13
13227,Pickens County,2021-02-03,135,4208,13.4
13227,Pickens County,2021-02-04,97,4305,13.7
13227,Pickens County,2021-02-05,83,4388,14
13227,Pickens County,2021-02-06,13,4401,14
13227,Pickens County,2021-02-07,3,4404,14
13227,Pickens County,2021-02-08,36,4440,14.1
13227,Pickens County,2021-02-09,60,4500,14.3
13227,Pickens County,2021-02-10,84,4584,14.6
13227,Pickens County,2021-02-11,73,4657,14.8
13227,Pickens County,2021-02-12,73,4730,15.1
13227,Pickens County,2021-02-13,15,4745,15.1
13227,Pickens County,2021-02-14,9,4754,15.1
13227,Pickens County,2021-02-15,31,4785,15.2
13227,Pickens County,2021-02-16,83,4868,15.5
13227,Pickens County,2021-02-17,75,4943,15.7
13227,Pickens County,2021-02-18,50,4993,15.9
13227,Pickens County,2021-02-19,43,5036,16
13227,Pickens County,2021-02-20,5,5041,16.1
13227,Pickens County,2021-02-21,8,5049,16.1
13227,Pickens County,2021-02-22,22,5071,16.2
13227,Pickens County,2021-02-23,50,5121,16.3
13227,Pickens County,2021-02-24,87,5208,16.6
13227,Pickens County,2021-02-25,96,5304,16.9
13227,Pickens County,2021-02-26,74,5378,17.1
13227,Pickens County,2021-02-27,37,5415,17.3
13227,Pickens County,2021-02-28,39,5454,17.4
13227,Pickens County,2021-03-01,128,5582,17.8
13227,Pickens County,2021-03-02,181,5763,18.4
13227,Pickens County,2021-03-03,184,5947,18.9
13227,Pickens County,2021-03-04,121,6068,19.3
13227,Pickens County,2021-03-05,150,6218,19.8
13227,Pickens County,2021-03-06,14,6232,19.9
13227,Pickens County,2021-03-07,16,6248,19.9
13227,Pickens County,2021-03-08,184,6432,20.5
13227,Pickens County,2021-03-09,190,6622,21.1
13227,Pickens County,2021-03-10,104,6726,21.4
13227,Pickens County,2021-03-11,141,6867,21.9
13227,Pickens County,2021-03-12,138,7005,22.3
13227,Pickens County,2021-03-13,27,7032,22.4
13227,Pickens County,2021-03-14,38,7070,22.5
13227,Pickens County,2021-03-15,299,7369,23.5
13227,Pickens County,2021-03-16,205,7574,24.1
13227,Pickens County,2021-03-17,138,7712,24.6
13227,Pickens County,2021-03-18,120,7832,25
13227,Pickens County,2021-03-19,115,7947,25.3
13227,Pickens County,2021-03-20,11,7958,25.4
13227,Pickens County,2021-03-21,21,7979,25.4
13227,Pickens County,2021-03-22,93,8072,25.7
13227,Pickens County,2021-03-23,153,8225,26.2
13227,Pickens County,2021-03-24,158,8383,26.7
13227,Pickens County,2021-03-25,126,8509,27.1
13227,Pickens County,2021-03-26,139,8648,27.6
13227,Pickens County,2021-03-27,26,8674,27.6
13227,Pickens County,2021-03-28,25,8699,27.7
13227,Pickens County,2021-03-29,111,8810,28.1
13227,Pickens County,2021-03-30,172,8982,28.6
13227,Pickens County,2021-03-31,145,9127,29.1
13227,Pickens County,2021-04-01,127,9254,29.5
13227,Pickens County,2021-04-02,66,9320,29.7
13227,Pickens County,2021-04-03,19,9339,29.8
13227,Pickens County,2021-04-04,17,9356,29.8
13227,Pickens County,2021-04-05,117,9473,30.2
13227,Pickens County,2021-04-06,123,9596,30.6
13227,Pickens County,2021-04-07,147,9743,31
13227,Pickens County,2021-04-08,122,9865,31.4
13227,Pickens County,2021-04-09,137,10002,31.9
13227,Pickens County,2021-04-10,31,10033,32
13227,Pickens County,2021-04-11,30,10063,32.1
13227,Pickens County,2021-04-12,74,10137,32.3
13227,Pickens County,2021-04-13,64,10201,32.5
13227,Pickens County,2021-04-14,52,10253,32.7
13227,Pickens County,2021-04-15,54,10307,32.8
13227,Pickens County,2021-04-16,80,10387,33.1
13227,Pickens County,2021-04-17,4,10391,33.1
13227,Pickens County,2021-04-18,14,10405,33.2
13227,Pickens County,2021-04-19,50,10455,33.3
13227,Pickens County,2021-04-20,80,10535,33.6
13227,Pickens County,2021-04-21,44,10579,33.7
13227,Pickens County,2021-04-22,49,10628,33.9
13227,Pickens County,2021-04-23,54,10682,34
13227,Pickens County,2021-04-24,20,10702,34.1
13227,Pickens County,2021-04-25,15,10717,34.1
13227,Pickens County,2021-04-26,45,10762,34.3
13227,Pickens County,2021-04-27,35,10797,34.4
13227,Pickens County,2021-04-28,50,10847,34.6
13227,Pickens County,2021-04-29,41,10888,34.7
13227,Pickens County,2021-04-30,53,10941,34.9
13227,Pickens County,2021-05-01,20,10961,34.9
13227,Pickens County,2021-05-02,7,10968,34.9
13227,Pickens County,2021-05-03,28,10996,35
13227,Pickens County,2021-05-04,46,11042,35.2
13227,Pickens County,2021-05-05,47,11089,35.3
13227,Pickens County,2021-05-06,36,11125,35.4
13227,Pickens County,2021-05-07,54,11179,35.6
13227,Pickens County,2021-05-08,11,11190,35.7
13227,Pickens County,2021-05-09,8,11198,35.7
13227,Pickens County,2021-05-10,20,11218,35.7
13227,Pickens County,2021-05-11,25,11243,35.8
13227,Pickens County,2021-05-12,27,11270,35.9
13227,Pickens County,2021-05-13,47,11317,36.1
13227,Pickens County,2021-05-14,52,11369,36.2
13227,Pickens County,2021-05-15,23,11392,36.3
13227,Pickens County,2021-05-16,15,11407,36.3
13227,Pickens County,2021-05-17,43,11450,36.5
13227,Pickens County,2021-05-18,26,11476,36.6
13227,Pickens County,2021-05-19,41,11517,36.7
13227,Pickens County,2021-05-20,31,11548,36.8
13227,Pickens County,2021-05-21,37,11585,36.9
13227,Pickens County,2021-05-22,12,11597,36.9
13227,Pickens County,2021-05-23,13,11610,37
13227,Pickens County,2021-05-24,18,11628,37
13227,Pickens County,2021-05-25,21,11649,37.1
13227,Pickens County,2021-05-26,41,11690,37.2
13227,Pickens County,2021-05-27,22,11712,37.3
13227,Pickens County,2021-05-28,20,11732,37.4
13227,Pickens County,2021-05-29,5,11737,37.4
13227,Pickens County,2021-05-30,9,11746,37.4
13227,Pickens County,2021-05-31,5,11751,37.4
13227,Pickens County,2021-06-01,21,11772,37.5
13227,Pickens County,2021-06-02,18,11790,37.6
13227,Pickens County,2021-06-03,11,11801,37.6
13227,Pickens County,2021-06-04,15,11816,37.6
13227,Pickens County,2021-06-05,10,11826,37.7
13227,Pickens County,2021-06-06,5,11831,37.7
13227,Pickens County,2021-06-07,31,11862,37.8
13227,Pickens County,2021-06-08,24,11886,37.9
13227,Pickens County,2021-06-09,19,11905,37.9
13227,Pickens County,2021-06-10,8,11913,38
13227,Pickens County,2021-06-11,15,11928,38
13227,Pickens County,2021-06-12,11,11939,38
13227,Pickens County,2021-06-13,5,11944,38.1
13227,Pickens County,2021-06-14,16,11960,38.1
13227,Pickens County,2021-06-15,15,11975,38.2
13227,Pickens County,2021-06-16,21,11996,38.2
13227,Pickens County,2021-06-17,9,12005,38.2
13227,Pickens County,2021-06-18,9,12014,38.3
13227,Pickens County,2021-06-19,11,12025,38.3
13227,Pickens County,2021-06-20,5,12030,38.3
13227,Pickens County,2021-06-21,19,12049,38.4
13227,Pickens County,2021-06-22,24,12073,38.5
13227,Pickens County,2021-06-23,10,12083,38.5
13227,Pickens County,2021-06-24,14,12097,38.5
13227,Pickens County,2021-06-25,15,12112,38.6
13227,Pickens County,2021-06-26,10,12122,38.6
13227,Pickens County,2021-06-27,7,12129,38.6
13227,Pickens County,2021-06-28,8,12137,38.7
13227,Pickens County,2021-06-29,13,12150,38.7
13227,Pickens County,2021-06-30,16,12166,38.8
13227,Pickens County,2021-07-01,19,12185,38.8
13227,Pickens County,2021-07-02,11,12196,38.9
13227,Pickens County,2021-07-03,8,12204,38.9
13227,Pickens County,2021-07-04,1,12205,38.9
13227,Pickens County,2021-07-05,4,12209,38.9
13227,Pickens County,2021-07-06,6,12215,38.9
13227,Pickens County,2021-07-07,9,12224,38.9
13227,Pickens County,2021-07-08,16,12240,39
13227,Pickens County,2021-07-09,17,12257,39.1
13227,Pickens County,2021-07-10,15,12272,39.1
13227,Pickens County,2021-07-11,6,12278,39.1
13227,Pickens County,2021-07-12,8,12286,39.1
13227,Pickens County,2021-07-13,15,12301,39.2
13227,Pickens County,2021-07-14,16,12317,39.2
13227,Pickens County,2021-07-15,12,12329,39.3
13227,Pickens County,2021-07-16,13,12342,39.3
13227,Pickens County,2021-07-17,7,12349,39.3
13227,Pickens County,2021-07-18,9,12358,39.4
13227,Pickens County,2021-07-19,20,12378,39.4
13227,Pickens County,2021-07-20,30,12408,39.5
13227,Pickens County,2021-07-21,16,12424,39.6
13227,Pickens County,2021-07-22,31,12455,39.7
13227,Pickens County,2021-07-23,48,12503,39.8
13227,Pickens County,2021-07-24,18,12521,39.9
13227,Pickens County,2021-07-25,15,12536,39.9
13227,Pickens County,2021-07-26,34,12570,40
13227,Pickens County,2021-07-27,29,12599,40.1
13227,Pickens County,2021-07-28,37,12636,40.3
13227,Pickens County,2021-07-29,38,12674,40.4
13227,Pickens County,2021-07-30,38,12712,40.5
13227,Pickens County,2021-07-31,23,12735,40.6
13227,Pickens County,2021-08-01,14,12749,40.6
13227,Pickens County,2021-08-02,35,12784,40.7
13227,Pickens County,2021-08-03,50,12834,40.9
13227,Pickens County,2021-08-04,35,12869,41
13227,Pickens County,2021-08-05,46,12915,41.1
13227,Pickens County,2021-08-06,72,12987,41.4
13227,Pickens County,2021-08-07,41,13028,41.5
13227,Pickens County,2021-08-08,22,13050,41.6
13227,Pickens County,2021-08-09,43,13093,41.7
13227,Pickens County,2021-08-10,51,13144,41.9
13227,Pickens County,2021-08-11,31,13175,42
13227,Pickens County,2021-08-12,30,13205,42.1
13227,Pickens County,2021-08-13,69,13274,42.3
13227,Pickens County,2021-08-14,31,13305,42.4
13227,Pickens County,2021-08-15,15,13320,42.4
13227,Pickens County,2021-08-16,37,13357,42.6
13227,Pickens County,2021-08-17,40,13397,42.7
13227,Pickens County,2021-08-18,22,13419,42.8
13227,Pickens County,2021-08-19,42,13461,42.9
13227,Pickens County,2021-08-20,40,13501,43
13227,Pickens County,2021-08-21,29,13530,43.1
13227,Pickens County,2021-08-22,17,13547,43.2
13227,Pickens County,2021-08-23,45,13592,43.3
13227,Pickens County,2021-08-24,52,13644,43.5
13227,Pickens County,2021-08-25,22,13666,43.5
13227,Pickens County,2021-08-26,37,13703,43.7
13227,Pickens County,2021-08-27,49,13752,43.8
13227,Pickens County,2021-08-28,38,13790,43.9
13227,Pickens County,2021-08-29,25,13815,44
13227,Pickens County,2021-08-30,46,13861,44.2
13227,Pickens County,2021-08-31,48,13909,44.3
13227,Pickens County,2021-09-01,34,13943,44.4
13227,Pickens County,2021-09-02,51,13994,44.6
13227,Pickens County,2021-09-03,44,14038,44.7
13227,Pickens County,2021-09-04,25,14063,44.8
13227,Pickens County,2021-09-05,22,14085,44.9
13227,Pickens County,2021-09-06,6,14091,44.9
13227,Pickens County,2021-09-07,45,14136,45
13227,Pickens County,2021-09-08,35,14171,45.1
13227,Pickens County,2021-09-09,41,14212,45.3
13227,Pickens County,2021-09-10,51,14263,45.4
13227,Pickens County,2021-09-11,19,14282,45.5
13227,Pickens County,2021-09-12,15,14297,45.6
13227,Pickens County,2021-09-13,33,14330,45.7
13227,Pickens County,2021-09-14,36,14366,45.8
13227,Pickens County,2021-09-15,22,14388,45.8
13227,Pickens County,2021-09-16,32,14420,45.9
13227,Pickens County,2021-09-17,20,14440,46
13227,Pickens County,2021-09-18,22,14462,46.1
13227,Pickens County,2021-09-19,6,14468,46.1
13227,Pickens County,2021-09-20,15,14483,46.1
13227,Pickens County,2021-09-21,18,14501,46.2
13227,Pickens County,2021-09-22,19,14520,46.3
13227,Pickens County,2021-09-23,15,14535,46.3
13227,Pickens County,2021-09-24,9,14544,46.3
13227,Pickens County,2021-09-25,7,14551,46.4
13227,Pickens County,2021-09-26,8,14559,46.4
13227,Pickens County,2021-09-27,6,14565,46.4
13227,Pickens County,2021-09-28,10,14575,46.4
13227,Pickens County,2021-09-29,11,14586,46.5
13227,Pickens County,2021-09-30,11,14597,46.5
13227,Pickens County,2021-10-01,9,14606,46.5
13227,Pickens County,2021-10-02,5,14611,46.6
13227,Pickens County,2021-10-03,3,14614,46.6
13227,Pickens County,2021-10-04,10,14624,46.6
13227,Pickens County,2021-10-05,12,14636,46.6
13227,Pickens County,2021-10-06,3,14639,46.6
13227,Pickens County,2021-10-07,1,14640,46.6
13229,Pierce County,2020-12-17,2,2,0
13229,Pierce County,2020-12-18,1,3,0
13229,Pierce County,2020-12-19,1,4,0
13229,Pierce County,2020-12-21,1,5,0
13229,Pierce County,2020-12-22,9,14,0.1
13229,Pierce County,2020-12-23,20,34,0.2
13229,Pierce County,2020-12-24,9,43,0.2
13229,Pierce County,2020-12-28,22,65,0.3
13229,Pierce County,2020-12-29,36,101,0.5
13229,Pierce County,2020-12-30,28,129,0.7
13229,Pierce County,2020-12-31,13,142,0.7
13229,Pierce County,2021-01-04,9,151,0.8
13229,Pierce County,2021-01-05,23,174,0.9
13229,Pierce County,2021-01-06,22,196,1
13229,Pierce County,2021-01-07,29,225,1.2
13229,Pierce County,2021-01-08,17,242,1.3
13229,Pierce County,2021-01-11,63,305,1.6
13229,Pierce County,2021-01-12,33,338,1.8
13229,Pierce County,2021-01-13,42,380,2
13229,Pierce County,2021-01-14,20,400,2.1
13229,Pierce County,2021-01-15,83,483,2.5
13229,Pierce County,2021-01-16,49,532,2.8
13229,Pierce County,2021-01-17,6,538,2.8
13229,Pierce County,2021-01-18,116,654,3.4
13229,Pierce County,2021-01-19,31,685,3.6
13229,Pierce County,2021-01-20,58,743,3.9
13229,Pierce County,2021-01-21,27,770,4
13229,Pierce County,2021-01-22,75,845,4.4
13229,Pierce County,2021-01-23,12,857,4.5
13229,Pierce County,2021-01-25,80,937,4.9
13229,Pierce County,2021-01-26,33,970,5
13229,Pierce County,2021-01-27,32,1002,5.2
13229,Pierce County,2021-01-28,14,1016,5.3
13229,Pierce County,2021-01-29,81,1097,5.7
13229,Pierce County,2021-01-30,65,1162,6
13229,Pierce County,2021-02-01,92,1254,6.5
13229,Pierce County,2021-02-02,33,1287,6.7
13229,Pierce County,2021-02-03,64,1351,7
13229,Pierce County,2021-02-04,19,1370,7.1
13229,Pierce County,2021-02-05,63,1433,7.4
13229,Pierce County,2021-02-06,3,1436,7.5
13229,Pierce County,2021-02-08,77,1513,7.9
13229,Pierce County,2021-02-09,14,1527,7.9
13229,Pierce County,2021-02-10,59,1586,8.2
13229,Pierce County,2021-02-11,20,1606,8.3
13229,Pierce County,2021-02-12,41,1647,8.6
13229,Pierce County,2021-02-13,32,1679,8.7
13229,Pierce County,2021-02-15,76,1755,9.1
13229,Pierce County,2021-02-16,44,1799,9.3
13229,Pierce County,2021-02-17,83,1882,9.8
13229,Pierce County,2021-02-18,14,1896,9.8
13229,Pierce County,2021-02-19,48,1944,10.1
13229,Pierce County,2021-02-20,9,1953,10.1
13229,Pierce County,2021-02-22,53,2006,10.4
13229,Pierce County,2021-02-23,21,2027,10.5
13229,Pierce County,2021-02-24,44,2071,10.8
13229,Pierce County,2021-02-25,33,2104,10.9
13229,Pierce County,2021-02-26,24,2128,11.1
13229,Pierce County,2021-02-27,1,2129,11.1
13229,Pierce County,2021-02-28,2,2131,11.1
13229,Pierce County,2021-03-01,21,2152,11.2
13229,Pierce County,2021-03-02,24,2176,11.3
13229,Pierce County,2021-03-03,37,2213,11.5
13229,Pierce County,2021-03-04,27,2240,11.6
13229,Pierce County,2021-03-05,43,2283,11.9
13229,Pierce County,2021-03-06,3,2286,11.9
13229,Pierce County,2021-03-07,2,2288,11.9
13229,Pierce County,2021-03-08,45,2333,12.1
13229,Pierce County,2021-03-09,30,2363,12.3
13229,Pierce County,2021-03-10,59,2422,12.6
13229,Pierce County,2021-03-11,117,2539,13.2
13229,Pierce County,2021-03-12,80,2619,13.6
13229,Pierce County,2021-03-13,3,2622,13.6
13229,Pierce County,2021-03-14,6,2628,13.7
13229,Pierce County,2021-03-15,32,2660,13.8
13229,Pierce County,2021-03-16,55,2715,14.1
13229,Pierce County,2021-03-17,114,2829,14.7
13229,Pierce County,2021-03-18,41,2870,14.9
13229,Pierce County,2021-03-19,71,2941,15.3
13229,Pierce County,2021-03-20,30,2971,15.4
13229,Pierce County,2021-03-21,10,2981,15.5
13229,Pierce County,2021-03-22,90,3071,16
13229,Pierce County,2021-03-23,51,3122,16.2
13229,Pierce County,2021-03-24,76,3198,16.6
13229,Pierce County,2021-03-25,67,3265,17
13229,Pierce County,2021-03-26,112,3377,17.5
13229,Pierce County,2021-03-27,34,3411,17.7
13229,Pierce County,2021-03-28,3,3414,17.7
13229,Pierce County,2021-03-29,63,3477,18.1
13229,Pierce County,2021-03-30,101,3578,18.6
13229,Pierce County,2021-03-31,87,3665,19
13229,Pierce County,2021-04-01,74,3739,19.4
13229,Pierce County,2021-04-02,72,3811,19.8
13229,Pierce County,2021-04-03,31,3842,20
13229,Pierce County,2021-04-04,1,3843,20
13229,Pierce County,2021-04-05,31,3874,20.1
13229,Pierce County,2021-04-06,48,3922,20.4
13229,Pierce County,2021-04-07,34,3956,20.6
13229,Pierce County,2021-04-08,63,4019,20.9
13229,Pierce County,2021-04-09,35,4054,21.1
13229,Pierce County,2021-04-10,32,4086,21.2
13229,Pierce County,2021-04-11,2,4088,21.2
13229,Pierce County,2021-04-12,20,4108,21.3
13229,Pierce County,2021-04-13,53,4161,21.6
13229,Pierce County,2021-04-14,24,4185,21.7
13229,Pierce County,2021-04-15,19,4204,21.8
13229,Pierce County,2021-04-16,17,4221,21.9
13229,Pierce County,2021-04-17,10,4231,22
13229,Pierce County,2021-04-19,12,4243,22
13229,Pierce County,2021-04-20,31,4274,22.2
13229,Pierce County,2021-04-21,26,4300,22.3
13229,Pierce County,2021-04-22,36,4336,22.5
13229,Pierce County,2021-04-23,29,4365,22.7
13229,Pierce County,2021-04-24,5,4370,22.7
13229,Pierce County,2021-04-26,8,4378,22.7
13229,Pierce County,2021-04-27,27,4405,22.9
13229,Pierce County,2021-04-28,21,4426,23
13229,Pierce County,2021-04-29,10,4436,23
13229,Pierce County,2021-04-30,27,4463,23.2
13229,Pierce County,2021-05-01,12,4475,23.2
13229,Pierce County,2021-05-02,2,4477,23.3
13229,Pierce County,2021-05-03,7,4484,23.3
13229,Pierce County,2021-05-04,27,4511,23.4
13229,Pierce County,2021-05-05,17,4528,23.5
13229,Pierce County,2021-05-06,19,4547,23.6
13229,Pierce County,2021-05-07,13,4560,23.7
13229,Pierce County,2021-05-08,13,4573,23.8
13229,Pierce County,2021-05-10,6,4579,23.8
13229,Pierce County,2021-05-11,27,4606,23.9
13229,Pierce County,2021-05-12,33,4639,24.1
13229,Pierce County,2021-05-13,14,4653,24.2
13229,Pierce County,2021-05-14,15,4668,24.2
13229,Pierce County,2021-05-15,10,4678,24.3
13229,Pierce County,2021-05-16,3,4681,24.3
13229,Pierce County,2021-05-17,18,4699,24.4
13229,Pierce County,2021-05-18,17,4716,24.5
13229,Pierce County,2021-05-19,38,4754,24.7
13229,Pierce County,2021-05-20,19,4773,24.8
13229,Pierce County,2021-05-21,13,4786,24.9
13229,Pierce County,2021-05-22,1,4787,24.9
13229,Pierce County,2021-05-23,8,4795,24.9
13229,Pierce County,2021-05-24,11,4806,25
13229,Pierce County,2021-05-25,27,4833,25.1
13229,Pierce County,2021-05-26,6,4839,25.1
13229,Pierce County,2021-05-27,12,4851,25.2
13229,Pierce County,2021-05-28,8,4859,25.2
13229,Pierce County,2021-05-29,1,4860,25.2
13229,Pierce County,2021-05-31,2,4862,25.3
13229,Pierce County,2021-06-01,16,4878,25.3
13229,Pierce County,2021-06-02,16,4894,25.4
13229,Pierce County,2021-06-03,7,4901,25.5
13229,Pierce County,2021-06-04,3,4904,25.5
13229,Pierce County,2021-06-05,5,4909,25.5
13229,Pierce County,2021-06-06,1,4910,25.5
13229,Pierce County,2021-06-07,7,4917,25.5
13229,Pierce County,2021-06-08,12,4929,25.6
13229,Pierce County,2021-06-09,16,4945,25.7
13229,Pierce County,2021-06-10,9,4954,25.7
13229,Pierce County,2021-06-11,13,4967,25.8
13229,Pierce County,2021-06-12,6,4973,25.8
13229,Pierce County,2021-06-14,4,4977,25.9
13229,Pierce County,2021-06-15,8,4985,25.9
13229,Pierce County,2021-06-16,9,4994,25.9
13229,Pierce County,2021-06-17,2,4996,26
13229,Pierce County,2021-06-18,6,5002,26
13229,Pierce County,2021-06-19,2,5004,26
13229,Pierce County,2021-06-20,1,5005,26
13229,Pierce County,2021-06-21,6,5011,26
13229,Pierce County,2021-06-22,6,5017,26.1
13229,Pierce County,2021-06-23,7,5024,26.1
13229,Pierce County,2021-06-24,2,5026,26.1
13229,Pierce County,2021-06-25,4,5030,26.1
13229,Pierce County,2021-06-28,5,5035,26.2
13229,Pierce County,2021-06-29,10,5045,26.2
13229,Pierce County,2021-06-30,6,5051,26.2
13229,Pierce County,2021-07-01,4,5055,26.3
13229,Pierce County,2021-07-02,12,5067,26.3
13229,Pierce County,2021-07-03,3,5070,26.3
13229,Pierce County,2021-07-05,7,5077,26.4
13229,Pierce County,2021-07-06,12,5089,26.4
13229,Pierce County,2021-07-07,3,5092,26.5
13229,Pierce County,2021-07-08,9,5101,26.5
13229,Pierce County,2021-07-09,4,5105,26.5
13229,Pierce County,2021-07-10,1,5106,26.5
13229,Pierce County,2021-07-11,1,5107,26.5
13229,Pierce County,2021-07-12,4,5111,26.6
13229,Pierce County,2021-07-13,11,5122,26.6
13229,Pierce County,2021-07-14,7,5129,26.6
13229,Pierce County,2021-07-15,6,5135,26.7
13229,Pierce County,2021-07-16,10,5145,26.7
13229,Pierce County,2021-07-17,3,5148,26.7
13229,Pierce County,2021-07-18,2,5150,26.8
13229,Pierce County,2021-07-19,3,5153,26.8
13229,Pierce County,2021-07-20,27,5180,26.9
13229,Pierce County,2021-07-21,22,5202,27
13229,Pierce County,2021-07-22,15,5217,27.1
13229,Pierce County,2021-07-23,30,5247,27.3
13229,Pierce County,2021-07-24,8,5255,27.3
13229,Pierce County,2021-07-25,9,5264,27.3
13229,Pierce County,2021-07-26,39,5303,27.5
13229,Pierce County,2021-07-27,52,5355,27.8
13229,Pierce County,2021-07-28,50,5405,28.1
13229,Pierce County,2021-07-29,40,5445,28.3
13229,Pierce County,2021-07-30,47,5492,28.5
13229,Pierce County,2021-07-31,27,5519,28.7
13229,Pierce County,2021-08-01,27,5546,28.8
13229,Pierce County,2021-08-02,46,5592,29
13229,Pierce County,2021-08-03,42,5634,29.3
13229,Pierce County,2021-08-04,42,5676,29.5
13229,Pierce County,2021-08-05,43,5719,29.7
13229,Pierce County,2021-08-06,58,5777,30
13229,Pierce County,2021-08-07,15,5792,30.1
13229,Pierce County,2021-08-08,7,5799,30.1
13229,Pierce County,2021-08-09,40,5839,30.3
13229,Pierce County,2021-08-10,50,5889,30.6
13229,Pierce County,2021-08-11,51,5940,30.9
13229,Pierce County,2021-08-12,41,5981,31.1
13229,Pierce County,2021-08-13,66,6047,31.4
13229,Pierce County,2021-08-14,12,6059,31.5
13229,Pierce County,2021-08-15,9,6068,31.5
13229,Pierce County,2021-08-16,42,6110,31.7
13229,Pierce County,2021-08-17,37,6147,31.9
13229,Pierce County,2021-08-18,47,6194,32.2
13229,Pierce County,2021-08-19,27,6221,32.3
13229,Pierce County,2021-08-20,76,6297,32.7
13229,Pierce County,2021-08-21,16,6313,32.8
13229,Pierce County,2021-08-22,13,6326,32.9
13229,Pierce County,2021-08-23,28,6354,33
13229,Pierce County,2021-08-24,34,6388,33.2
13229,Pierce County,2021-08-25,30,6418,33.3
13229,Pierce County,2021-08-26,68,6486,33.7
13229,Pierce County,2021-08-27,42,6528,33.9
13229,Pierce County,2021-08-28,8,6536,34
13229,Pierce County,2021-08-29,9,6545,34
13229,Pierce County,2021-08-30,35,6580,34.2
13229,Pierce County,2021-08-31,31,6611,34.3
13229,Pierce County,2021-09-01,21,6632,34.5
13229,Pierce County,2021-09-02,21,6653,34.6
13229,Pierce County,2021-09-03,35,6688,34.7
13229,Pierce County,2021-09-04,9,6697,34.8
13229,Pierce County,2021-09-05,4,6701,34.8
13229,Pierce County,2021-09-06,9,6710,34.9
13229,Pierce County,2021-09-07,22,6732,35
13229,Pierce County,2021-09-08,23,6755,35.1
13229,Pierce County,2021-09-09,15,6770,35.2
13229,Pierce County,2021-09-10,19,6789,35.3
13229,Pierce County,2021-09-11,15,6804,35.3
13229,Pierce County,2021-09-12,7,6811,35.4
13229,Pierce County,2021-09-13,20,6831,35.5
13229,Pierce County,2021-09-14,21,6852,35.6
13229,Pierce County,2021-09-15,8,6860,35.6
13229,Pierce County,2021-09-16,19,6879,35.7
13229,Pierce County,2021-09-17,16,6895,35.8
13229,Pierce County,2021-09-18,7,6902,35.9
13229,Pierce County,2021-09-19,1,6903,35.9
13229,Pierce County,2021-09-20,9,6912,35.9
13229,Pierce County,2021-09-21,8,6920,35.9
13229,Pierce County,2021-09-22,7,6927,36
13229,Pierce County,2021-09-23,7,6934,36
13229,Pierce County,2021-09-24,5,6939,36
13229,Pierce County,2021-09-25,1,6940,36.1
13229,Pierce County,2021-09-26,3,6943,36.1
13229,Pierce County,2021-09-27,7,6950,36.1
13229,Pierce County,2021-09-28,10,6960,36.2
13229,Pierce County,2021-09-29,4,6964,36.2
13229,Pierce County,2021-09-30,5,6969,36.2
13229,Pierce County,2021-10-01,7,6976,36.2
13229,Pierce County,2021-10-02,2,6978,36.2
13229,Pierce County,2021-10-04,3,6981,36.3
13229,Pierce County,2021-10-05,3,6984,36.3
13229,Pierce County,2021-10-06,1,6985,36.3
13229,Pierce County,2021-10-07,5,6990,36.3
13231,Pike County,2020-12-17,1,1,0
13231,Pike County,2020-12-18,2,3,0
13231,Pike County,2020-12-19,13,16,0.1
13231,Pike County,2020-12-21,11,27,0.1
13231,Pike County,2020-12-22,7,34,0.2
13231,Pike County,2020-12-23,17,51,0.3
13231,Pike County,2020-12-24,4,55,0.3
13231,Pike County,2020-12-27,2,57,0.3
13231,Pike County,2020-12-28,16,73,0.4
13231,Pike County,2020-12-29,30,103,0.6
13231,Pike County,2020-12-30,28,131,0.7
13231,Pike County,2020-12-31,12,143,0.8
13231,Pike County,2021-01-01,5,148,0.8
13231,Pike County,2021-01-02,1,149,0.8
13231,Pike County,2021-01-03,3,152,0.8
13231,Pike County,2021-01-04,16,168,0.9
13231,Pike County,2021-01-05,25,193,1.1
13231,Pike County,2021-01-06,15,208,1.1
13231,Pike County,2021-01-07,9,217,1.2
13231,Pike County,2021-01-08,22,239,1.3
13231,Pike County,2021-01-09,16,255,1.4
13231,Pike County,2021-01-10,5,260,1.4
13231,Pike County,2021-01-11,10,270,1.5
13231,Pike County,2021-01-12,39,309,1.7
13231,Pike County,2021-01-13,32,341,1.9
13231,Pike County,2021-01-14,49,390,2.1
13231,Pike County,2021-01-15,68,458,2.5
13231,Pike County,2021-01-16,15,473,2.6
13231,Pike County,2021-01-17,6,479,2.6
13231,Pike County,2021-01-18,34,513,2.8
13231,Pike County,2021-01-19,88,601,3.3
13231,Pike County,2021-01-20,41,642,3.5
13231,Pike County,2021-01-21,64,706,3.9
13231,Pike County,2021-01-22,52,758,4.1
13231,Pike County,2021-01-23,3,761,4.2
13231,Pike County,2021-01-24,14,775,4.2
13231,Pike County,2021-01-25,40,815,4.4
13231,Pike County,2021-01-26,47,862,4.7
13231,Pike County,2021-01-27,29,891,4.9
13231,Pike County,2021-01-28,54,945,5.2
13231,Pike County,2021-01-29,55,1000,5.5
13231,Pike County,2021-01-30,7,1007,5.5
13231,Pike County,2021-01-31,2,1009,5.5
13231,Pike County,2021-02-01,21,1030,5.6
13231,Pike County,2021-02-02,61,1091,6
13231,Pike County,2021-02-03,8,1099,6
13231,Pike County,2021-02-04,59,1158,6.3
13231,Pike County,2021-02-05,29,1187,6.5
13231,Pike County,2021-02-06,1,1188,6.5
13231,Pike County,2021-02-07,1,1189,6.5
13231,Pike County,2021-02-08,7,1196,6.5
13231,Pike County,2021-02-09,40,1236,6.7
13231,Pike County,2021-02-10,11,1247,6.8
13231,Pike County,2021-02-11,51,1298,7.1
13231,Pike County,2021-02-12,25,1323,7.2
13231,Pike County,2021-02-13,5,1328,7.2
13231,Pike County,2021-02-14,3,1331,7.3
13231,Pike County,2021-02-15,4,1335,7.3
13231,Pike County,2021-02-16,33,1368,7.5
13231,Pike County,2021-02-17,18,1386,7.6
13231,Pike County,2021-02-18,45,1431,7.8
13231,Pike County,2021-02-19,29,1460,8
13231,Pike County,2021-02-20,5,1465,8
13231,Pike County,2021-02-21,1,1466,8
13231,Pike County,2021-02-22,7,1473,8
13231,Pike County,2021-02-23,59,1532,8.4
13231,Pike County,2021-02-24,15,1547,8.4
13231,Pike County,2021-02-25,42,1589,8.7
13231,Pike County,2021-02-26,49,1638,8.9
13231,Pike County,2021-02-27,5,1643,9
13231,Pike County,2021-02-28,4,1647,9
13231,Pike County,2021-03-01,18,1665,9.1
13231,Pike County,2021-03-02,59,1724,9.4
13231,Pike County,2021-03-03,24,1748,9.5
13231,Pike County,2021-03-04,61,1809,9.9
13231,Pike County,2021-03-05,72,1881,10.3
13231,Pike County,2021-03-06,7,1888,10.3
13231,Pike County,2021-03-07,3,1891,10.3
13231,Pike County,2021-03-08,42,1933,10.5
13231,Pike County,2021-03-09,70,2003,10.9
13231,Pike County,2021-03-10,41,2044,11.2
13231,Pike County,2021-03-11,97,2141,11.7
13231,Pike County,2021-03-12,71,2212,12.1
13231,Pike County,2021-03-13,7,2219,12.1
13231,Pike County,2021-03-14,10,2229,12.2
13231,Pike County,2021-03-15,51,2280,12.4
13231,Pike County,2021-03-16,81,2361,12.9
13231,Pike County,2021-03-17,41,2402,13.1
13231,Pike County,2021-03-18,69,2471,13.5
13231,Pike County,2021-03-19,135,2606,14.2
13231,Pike County,2021-03-20,11,2617,14.3
13231,Pike County,2021-03-21,20,2637,14.4
13231,Pike County,2021-03-22,42,2679,14.6
13231,Pike County,2021-03-23,64,2743,15
13231,Pike County,2021-03-24,61,2804,15.3
13231,Pike County,2021-03-25,81,2885,15.7
13231,Pike County,2021-03-26,50,2935,16
13231,Pike County,2021-03-27,8,2943,16.1
13231,Pike County,2021-03-28,9,2952,16.1
13231,Pike County,2021-03-29,37,2989,16.3
13231,Pike County,2021-03-30,59,3048,16.6
13231,Pike County,2021-03-31,55,3103,16.9
13231,Pike County,2021-04-01,80,3183,17.4
13231,Pike County,2021-04-02,51,3234,17.6
13231,Pike County,2021-04-03,12,3246,17.7
13231,Pike County,2021-04-04,12,3258,17.8
13231,Pike County,2021-04-05,36,3294,18
13231,Pike County,2021-04-06,94,3388,18.5
13231,Pike County,2021-04-07,64,3452,18.8
13231,Pike County,2021-04-08,80,3532,19.3
13231,Pike County,2021-04-09,54,3586,19.6
13231,Pike County,2021-04-10,20,3606,19.7
13231,Pike County,2021-04-11,14,3620,19.8
13231,Pike County,2021-04-12,27,3647,19.9
13231,Pike County,2021-04-13,64,3711,20.2
13231,Pike County,2021-04-14,64,3775,20.6
13231,Pike County,2021-04-15,47,3822,20.9
13231,Pike County,2021-04-16,53,3875,21.1
13231,Pike County,2021-04-17,11,3886,21.2
13231,Pike County,2021-04-18,5,3891,21.2
13231,Pike County,2021-04-19,19,3910,21.3
13231,Pike County,2021-04-20,32,3942,21.5
13231,Pike County,2021-04-21,48,3990,21.8
13231,Pike County,2021-04-22,17,4007,21.9
13231,Pike County,2021-04-23,33,4040,22
13231,Pike County,2021-04-24,11,4051,22.1
13231,Pike County,2021-04-25,1,4052,22.1
13231,Pike County,2021-04-26,19,4071,22.2
13231,Pike County,2021-04-27,18,4089,22.3
13231,Pike County,2021-04-28,18,4107,22.4
13231,Pike County,2021-04-29,31,4138,22.6
13231,Pike County,2021-04-30,28,4166,22.7
13231,Pike County,2021-05-01,13,4179,22.8
13231,Pike County,2021-05-02,5,4184,22.8
13231,Pike County,2021-05-03,11,4195,22.9
13231,Pike County,2021-05-04,14,4209,23
13231,Pike County,2021-05-05,26,4235,23.1
13231,Pike County,2021-05-06,27,4262,23.3
13231,Pike County,2021-05-07,21,4283,23.4
13231,Pike County,2021-05-08,7,4290,23.4
13231,Pike County,2021-05-09,6,4296,23.4
13231,Pike County,2021-05-10,7,4303,23.5
13231,Pike County,2021-05-11,13,4316,23.5
13231,Pike County,2021-05-12,19,4335,23.7
13231,Pike County,2021-05-13,22,4357,23.8
13231,Pike County,2021-05-14,22,4379,23.9
13231,Pike County,2021-05-15,12,4391,24
13231,Pike County,2021-05-16,9,4400,24
13231,Pike County,2021-05-17,36,4436,24.2
13231,Pike County,2021-05-18,30,4466,24.4
13231,Pike County,2021-05-19,14,4480,24.4
13231,Pike County,2021-05-20,19,4499,24.5
13231,Pike County,2021-05-21,25,4524,24.7
13231,Pike County,2021-05-22,6,4530,24.7
13231,Pike County,2021-05-23,7,4537,24.8
13231,Pike County,2021-05-24,7,4544,24.8
13231,Pike County,2021-05-25,12,4556,24.9
13231,Pike County,2021-05-26,14,4570,24.9
13231,Pike County,2021-05-27,13,4583,25
13231,Pike County,2021-05-28,14,4597,25.1
13231,Pike County,2021-05-29,6,4603,25.1
13231,Pike County,2021-05-30,7,4610,25.2
13231,Pike County,2021-06-01,18,4628,25.3
13231,Pike County,2021-06-02,13,4641,25.3
13231,Pike County,2021-06-03,13,4654,25.4
13231,Pike County,2021-06-04,9,4663,25.4
13231,Pike County,2021-06-05,5,4668,25.5
13231,Pike County,2021-06-06,4,4672,25.5
13231,Pike County,2021-06-07,6,4678,25.5
13231,Pike County,2021-06-08,11,4689,25.6
13231,Pike County,2021-06-09,3,4692,25.6
13231,Pike County,2021-06-10,4,4696,25.6
13231,Pike County,2021-06-11,23,4719,25.7
13231,Pike County,2021-06-12,4,4723,25.8
13231,Pike County,2021-06-13,3,4726,25.8
13231,Pike County,2021-06-14,3,4729,25.8
13231,Pike County,2021-06-15,11,4740,25.9
13231,Pike County,2021-06-16,11,4751,25.9
13231,Pike County,2021-06-17,4,4755,25.9
13231,Pike County,2021-06-18,7,4762,26
13231,Pike County,2021-06-19,6,4768,26
13231,Pike County,2021-06-20,2,4770,26
13231,Pike County,2021-06-21,6,4776,26.1
13231,Pike County,2021-06-22,9,4785,26.1
13231,Pike County,2021-06-23,7,4792,26.1
13231,Pike County,2021-06-24,7,4799,26.2
13231,Pike County,2021-06-25,18,4817,26.3
13231,Pike County,2021-06-26,3,4820,26.3
13231,Pike County,2021-06-27,2,4822,26.3
13231,Pike County,2021-06-28,1,4823,26.3
13231,Pike County,2021-06-29,10,4833,26.4
13231,Pike County,2021-06-30,8,4841,26.4
13231,Pike County,2021-07-01,7,4848,26.5
13231,Pike County,2021-07-02,11,4859,26.5
13231,Pike County,2021-07-03,4,4863,26.5
13231,Pike County,2021-07-04,2,4865,26.5
13231,Pike County,2021-07-05,3,4868,26.6
13231,Pike County,2021-07-06,7,4875,26.6
13231,Pike County,2021-07-07,3,4878,26.6
13231,Pike County,2021-07-08,9,4887,26.7
13231,Pike County,2021-07-09,8,4895,26.7
13231,Pike County,2021-07-10,8,4903,26.8
13231,Pike County,2021-07-11,2,4905,26.8
13231,Pike County,2021-07-12,3,4908,26.8
13231,Pike County,2021-07-13,7,4915,26.8
13231,Pike County,2021-07-14,5,4920,26.8
13231,Pike County,2021-07-15,7,4927,26.9
13231,Pike County,2021-07-16,15,4942,27
13231,Pike County,2021-07-17,4,4946,27
13231,Pike County,2021-07-18,3,4949,27
13231,Pike County,2021-07-19,13,4962,27.1
13231,Pike County,2021-07-20,11,4973,27.1
13231,Pike County,2021-07-21,10,4983,27.2
13231,Pike County,2021-07-22,19,5002,27.3
13231,Pike County,2021-07-23,21,5023,27.4
13231,Pike County,2021-07-24,10,5033,27.5
13231,Pike County,2021-07-25,7,5040,27.5
13231,Pike County,2021-07-26,14,5054,27.6
13231,Pike County,2021-07-27,19,5073,27.7
13231,Pike County,2021-07-28,15,5088,27.8
13231,Pike County,2021-07-29,15,5103,27.8
13231,Pike County,2021-07-30,23,5126,28
13231,Pike County,2021-07-31,9,5135,28
13231,Pike County,2021-08-01,20,5155,28.1
13231,Pike County,2021-08-02,23,5178,28.3
13231,Pike County,2021-08-03,39,5217,28.5
13231,Pike County,2021-08-04,20,5237,28.6
13231,Pike County,2021-08-05,31,5268,28.7
13231,Pike County,2021-08-06,42,5310,29
13231,Pike County,2021-08-07,16,5326,29.1
13231,Pike County,2021-08-08,10,5336,29.1
13231,Pike County,2021-08-09,20,5356,29.2
13231,Pike County,2021-08-10,34,5390,29.4
13231,Pike County,2021-08-11,27,5417,29.6
13231,Pike County,2021-08-12,27,5444,29.7
13231,Pike County,2021-08-13,39,5483,29.9
13231,Pike County,2021-08-14,10,5493,30
13231,Pike County,2021-08-15,10,5503,30
13231,Pike County,2021-08-16,21,5524,30.1
13231,Pike County,2021-08-17,37,5561,30.3
13231,Pike County,2021-08-18,35,5596,30.5
13231,Pike County,2021-08-19,28,5624,30.7
13231,Pike County,2021-08-20,38,5662,30.9
13231,Pike County,2021-08-21,15,5677,31
13231,Pike County,2021-08-22,17,5694,31.1
13231,Pike County,2021-08-23,38,5732,31.3
13231,Pike County,2021-08-24,53,5785,31.6
13231,Pike County,2021-08-25,38,5823,31.8
13231,Pike County,2021-08-26,39,5862,32
13231,Pike County,2021-08-27,61,5923,32.3
13231,Pike County,2021-08-28,18,5941,32.4
13231,Pike County,2021-08-29,19,5960,32.5
13231,Pike County,2021-08-30,36,5996,32.7
13231,Pike County,2021-08-31,36,6032,32.9
13231,Pike County,2021-09-01,29,6061,33.1
13231,Pike County,2021-09-02,28,6089,33.2
13231,Pike County,2021-09-03,46,6135,33.5
13231,Pike County,2021-09-04,24,6159,33.6
13231,Pike County,2021-09-05,11,6170,33.7
13231,Pike County,2021-09-06,18,6188,33.8
13231,Pike County,2021-09-07,25,6213,33.9
13231,Pike County,2021-09-08,36,6249,34.1
13231,Pike County,2021-09-09,26,6275,34.2
13231,Pike County,2021-09-10,44,6319,34.5
13231,Pike County,2021-09-11,17,6336,34.6
13231,Pike County,2021-09-12,11,6347,34.6
13231,Pike County,2021-09-13,28,6375,34.8
13231,Pike County,2021-09-14,23,6398,34.9
13231,Pike County,2021-09-15,30,6428,35.1
13231,Pike County,2021-09-16,21,6449,35.2
13231,Pike County,2021-09-17,28,6477,35.3
13231,Pike County,2021-09-18,8,6485,35.4
13231,Pike County,2021-09-19,11,6496,35.4
13231,Pike County,2021-09-20,8,6504,35.5
13231,Pike County,2021-09-21,24,6528,35.6
13231,Pike County,2021-09-22,11,6539,35.7
13231,Pike County,2021-09-23,17,6556,35.8
13231,Pike County,2021-09-24,13,6569,35.8
13231,Pike County,2021-09-25,4,6573,35.9
13231,Pike County,2021-09-26,9,6582,35.9
13231,Pike County,2021-09-27,2,6584,35.9
13231,Pike County,2021-09-28,11,6595,36
13231,Pike County,2021-09-29,4,6599,36
13231,Pike County,2021-09-30,7,6606,36
13231,Pike County,2021-10-01,7,6613,36.1
13231,Pike County,2021-10-02,1,6614,36.1
13231,Pike County,2021-10-03,2,6616,36.1
13231,Pike County,2021-10-04,6,6622,36.1
13231,Pike County,2021-10-05,10,6632,36.2
13231,Pike County,2021-10-06,4,6636,36.2
13231,Pike County,2021-10-07,2,6638,36.2
13233,Polk County,2020-12-12,1,1,0
13233,Polk County,2020-12-18,9,10,0
13233,Polk County,2020-12-19,1,11,0
13233,Polk County,2020-12-21,17,28,0.1
13233,Polk County,2020-12-22,33,61,0.1
13233,Polk County,2020-12-23,50,111,0.3
13233,Polk County,2020-12-24,5,116,0.3
13233,Polk County,2020-12-26,8,124,0.3
13233,Polk County,2020-12-27,5,129,0.3
13233,Polk County,2020-12-28,120,249,0.6
13233,Polk County,2020-12-29,32,281,0.7
13233,Polk County,2020-12-30,35,316,0.8
13233,Polk County,2020-12-31,41,357,0.9
13233,Polk County,2021-01-01,6,363,0.9
13233,Polk County,2021-01-02,6,369,0.9
13233,Polk County,2021-01-03,5,374,0.9
13233,Polk County,2021-01-04,48,422,1
13233,Polk County,2021-01-05,58,480,1.1
13233,Polk County,2021-01-06,74,554,1.3
13233,Polk County,2021-01-07,87,641,1.5
13233,Polk County,2021-01-08,74,715,1.7
13233,Polk County,2021-01-09,3,718,1.7
13233,Polk County,2021-01-10,8,726,1.7
13233,Polk County,2021-01-11,129,855,2
13233,Polk County,2021-01-12,172,1027,2.5
13233,Polk County,2021-01-13,176,1203,2.9
13233,Polk County,2021-01-14,261,1464,3.5
13233,Polk County,2021-01-15,240,1704,4.1
13233,Polk County,2021-01-16,12,1716,4.1
13233,Polk County,2021-01-17,6,1722,4.1
13233,Polk County,2021-01-18,272,1994,4.8
13233,Polk County,2021-01-19,297,2291,5.5
13233,Polk County,2021-01-20,275,2566,6.1
13233,Polk County,2021-01-21,129,2695,6.4
13233,Polk County,2021-01-22,108,2803,6.7
13233,Polk County,2021-01-23,4,2807,6.7
13233,Polk County,2021-01-24,4,2811,6.7
13233,Polk County,2021-01-25,210,3021,7.2
13233,Polk County,2021-01-26,277,3298,7.9
13233,Polk County,2021-01-27,220,3518,8.4
13233,Polk County,2021-01-28,238,3756,9
13233,Polk County,2021-01-29,198,3954,9.4
13233,Polk County,2021-01-30,2,3956,9.4
13233,Polk County,2021-02-01,155,4111,9.8
13233,Polk County,2021-02-02,87,4198,10
13233,Polk County,2021-02-03,97,4295,10.2
13233,Polk County,2021-02-04,91,4386,10.5
13233,Polk County,2021-02-05,82,4468,10.7
13233,Polk County,2021-02-06,26,4494,10.7
13233,Polk County,2021-02-07,1,4495,10.7
13233,Polk County,2021-02-08,82,4577,10.9
13233,Polk County,2021-02-09,93,4670,11.1
13233,Polk County,2021-02-10,146,4816,11.5
13233,Polk County,2021-02-11,17,4833,11.5
13233,Polk County,2021-02-12,39,4872,11.6
13233,Polk County,2021-02-13,3,4875,11.6
13233,Polk County,2021-02-14,2,4877,11.6
13233,Polk County,2021-02-15,44,4921,11.7
13233,Polk County,2021-02-16,14,4935,11.8
13233,Polk County,2021-02-17,88,5023,12
13233,Polk County,2021-02-18,13,5036,12
13233,Polk County,2021-02-19,63,5099,12.2
13233,Polk County,2021-02-20,3,5102,12.2
13233,Polk County,2021-02-22,10,5112,12.2
13233,Polk County,2021-02-23,40,5152,12.3
13233,Polk County,2021-02-24,25,5177,12.4
13233,Polk County,2021-02-25,15,5192,12.4
13233,Polk County,2021-02-26,60,5252,12.5
13233,Polk County,2021-02-27,6,5258,12.5
13233,Polk County,2021-02-28,18,5276,12.6
13233,Polk County,2021-03-01,51,5327,12.7
13233,Polk County,2021-03-02,139,5466,13
13233,Polk County,2021-03-03,104,5570,13.3
13233,Polk County,2021-03-04,61,5631,13.4
13233,Polk County,2021-03-05,84,5715,13.6
13233,Polk County,2021-03-06,10,5725,13.7
13233,Polk County,2021-03-07,22,5747,13.7
13233,Polk County,2021-03-08,120,5867,14
13233,Polk County,2021-03-09,115,5982,14.3
13233,Polk County,2021-03-10,82,6064,14.5
13233,Polk County,2021-03-11,116,6180,14.7
13233,Polk County,2021-03-12,145,6325,15.1
13233,Polk County,2021-03-13,164,6489,15.5
13233,Polk County,2021-03-14,17,6506,15.5
13233,Polk County,2021-03-15,165,6671,15.9
13233,Polk County,2021-03-16,241,6912,16.5
13233,Polk County,2021-03-17,266,7178,17.1
13233,Polk County,2021-03-18,175,7353,17.5
13233,Polk County,2021-03-19,178,7531,18
13233,Polk County,2021-03-20,19,7550,18
13233,Polk County,2021-03-21,22,7572,18.1
13233,Polk County,2021-03-22,90,7662,18.3
13233,Polk County,2021-03-23,262,7924,18.9
13233,Polk County,2021-03-24,131,8055,19.2
13233,Polk County,2021-03-25,138,8193,19.5
13233,Polk County,2021-03-26,133,8326,19.9
13233,Polk County,2021-03-27,23,8349,19.9
13233,Polk County,2021-03-28,27,8376,20
13233,Polk County,2021-03-29,93,8469,20.2
13233,Polk County,2021-03-30,168,8637,20.6
13233,Polk County,2021-03-31,106,8743,20.9
13233,Polk County,2021-04-01,175,8918,21.3
13233,Polk County,2021-04-02,98,9016,21.5
13233,Polk County,2021-04-03,22,9038,21.6
13233,Polk County,2021-04-04,24,9062,21.6
13233,Polk County,2021-04-05,116,9178,21.9
13233,Polk County,2021-04-06,117,9295,22.2
13233,Polk County,2021-04-07,106,9401,22.4
13233,Polk County,2021-04-08,130,9531,22.7
13233,Polk County,2021-04-09,74,9605,22.9
13233,Polk County,2021-04-10,129,9734,23.2
13233,Polk County,2021-04-11,14,9748,23.3
13233,Polk County,2021-04-12,72,9820,23.4
13233,Polk County,2021-04-13,117,9937,23.7
13233,Polk County,2021-04-14,58,9995,23.8
13233,Polk County,2021-04-15,176,10171,24.3
13233,Polk County,2021-04-16,98,10269,24.5
13233,Polk County,2021-04-17,12,10281,24.5
13233,Polk County,2021-04-18,9,10290,24.6
13233,Polk County,2021-04-19,30,10320,24.6
13233,Polk County,2021-04-20,71,10391,24.8
13233,Polk County,2021-04-21,47,10438,24.9
13233,Polk County,2021-04-22,97,10535,25.1
13233,Polk County,2021-04-23,90,10625,25.4
13233,Polk County,2021-04-24,13,10638,25.4
13233,Polk County,2021-04-25,2,10640,25.4
13233,Polk County,2021-04-26,49,10689,25.5
13233,Polk County,2021-04-27,72,10761,25.7
13233,Polk County,2021-04-28,37,10798,25.8
13233,Polk County,2021-04-29,58,10856,25.9
13233,Polk County,2021-04-30,71,10927,26.1
13233,Polk County,2021-05-01,37,10964,26.2
13233,Polk County,2021-05-02,13,10977,26.2
13233,Polk County,2021-05-03,54,11031,26.3
13233,Polk County,2021-05-04,56,11087,26.5
13233,Polk County,2021-05-05,32,11119,26.5
13233,Polk County,2021-05-06,51,11170,26.7
13233,Polk County,2021-05-07,51,11221,26.8
13233,Polk County,2021-05-08,35,11256,26.9
13233,Polk County,2021-05-09,14,11270,26.9
13233,Polk County,2021-05-10,19,11289,26.9
13233,Polk County,2021-05-11,43,11332,27
13233,Polk County,2021-05-12,27,11359,27.1
13233,Polk County,2021-05-13,41,11400,27.2
13233,Polk County,2021-05-14,42,11442,27.3
13233,Polk County,2021-05-15,27,11469,27.4
13233,Polk County,2021-05-16,20,11489,27.4
13233,Polk County,2021-05-17,40,11529,27.5
13233,Polk County,2021-05-18,48,11577,27.6
13233,Polk County,2021-05-19,45,11622,27.7
13233,Polk County,2021-05-20,94,11716,28
13233,Polk County,2021-05-21,53,11769,28.1
13233,Polk County,2021-05-22,27,11796,28.1
13233,Polk County,2021-05-23,11,11807,28.2
13233,Polk County,2021-05-24,36,11843,28.3
13233,Polk County,2021-05-25,28,11871,28.3
13233,Polk County,2021-05-26,39,11910,28.4
13233,Polk County,2021-05-27,57,11967,28.6
13233,Polk County,2021-05-28,41,12008,28.7
13233,Polk County,2021-05-29,13,12021,28.7
13233,Polk County,2021-05-30,5,12026,28.7
13233,Polk County,2021-05-31,5,12031,28.7
13233,Polk County,2021-06-01,22,12053,28.8
13233,Polk County,2021-06-02,23,12076,28.8
13233,Polk County,2021-06-03,26,12102,28.9
13233,Polk County,2021-06-04,41,12143,29
13233,Polk County,2021-06-05,12,12155,29
13233,Polk County,2021-06-06,7,12162,29
13233,Polk County,2021-06-07,32,12194,29.1
13233,Polk County,2021-06-08,22,12216,29.1
13233,Polk County,2021-06-09,22,12238,29.2
13233,Polk County,2021-06-10,32,12270,29.3
13233,Polk County,2021-06-11,34,12304,29.4
13233,Polk County,2021-06-12,11,12315,29.4
13233,Polk County,2021-06-13,8,12323,29.4
13233,Polk County,2021-06-14,18,12341,29.4
13233,Polk County,2021-06-15,19,12360,29.5
13233,Polk County,2021-06-16,17,12377,29.5
13233,Polk County,2021-06-17,16,12393,29.6
13233,Polk County,2021-06-18,29,12422,29.6
13233,Polk County,2021-06-19,8,12430,29.7
13233,Polk County,2021-06-20,3,12433,29.7
13233,Polk County,2021-06-21,11,12444,29.7
13233,Polk County,2021-06-22,26,12470,29.8
13233,Polk County,2021-06-23,19,12489,29.8
13233,Polk County,2021-06-24,49,12538,29.9
13233,Polk County,2021-06-25,39,12577,30
13233,Polk County,2021-06-26,18,12595,30.1
13233,Polk County,2021-06-27,8,12603,30.1
13233,Polk County,2021-06-28,15,12618,30.1
13233,Polk County,2021-06-29,16,12634,30.1
13233,Polk County,2021-06-30,23,12657,30.2
13233,Polk County,2021-07-01,25,12682,30.3
13233,Polk County,2021-07-02,20,12702,30.3
13233,Polk County,2021-07-03,9,12711,30.3
13233,Polk County,2021-07-04,5,12716,30.3
13233,Polk County,2021-07-05,6,12722,30.4
13233,Polk County,2021-07-06,23,12745,30.4
13233,Polk County,2021-07-07,18,12763,30.5
13233,Polk County,2021-07-08,24,12787,30.5
13233,Polk County,2021-07-09,20,12807,30.6
13233,Polk County,2021-07-10,7,12814,30.6
13233,Polk County,2021-07-11,6,12820,30.6
13233,Polk County,2021-07-12,11,12831,30.6
13233,Polk County,2021-07-13,13,12844,30.6
13233,Polk County,2021-07-14,15,12859,30.7
13233,Polk County,2021-07-15,33,12892,30.8
13233,Polk County,2021-07-16,31,12923,30.8
13233,Polk County,2021-07-17,16,12939,30.9
13233,Polk County,2021-07-18,5,12944,30.9
13233,Polk County,2021-07-19,31,12975,31
13233,Polk County,2021-07-20,35,13010,31
13233,Polk County,2021-07-21,26,13036,31.1
13233,Polk County,2021-07-22,54,13090,31.2
13233,Polk County,2021-07-23,58,13148,31.4
13233,Polk County,2021-07-24,34,13182,31.5
13233,Polk County,2021-07-25,18,13200,31.5
13233,Polk County,2021-07-26,41,13241,31.6
13233,Polk County,2021-07-27,51,13292,31.7
13233,Polk County,2021-07-28,41,13333,31.8
13233,Polk County,2021-07-29,108,13441,32.1
13233,Polk County,2021-07-30,89,13530,32.3
13233,Polk County,2021-07-31,25,13555,32.3
13233,Polk County,2021-08-01,16,13571,32.4
13233,Polk County,2021-08-02,50,13621,32.5
13233,Polk County,2021-08-03,71,13692,32.7
13233,Polk County,2021-08-04,41,13733,32.8
13233,Polk County,2021-08-05,82,13815,33
13233,Polk County,2021-08-06,110,13925,33.2
13233,Polk County,2021-08-07,23,13948,33.3
13233,Polk County,2021-08-08,16,13964,33.3
13233,Polk County,2021-08-09,72,14036,33.5
13233,Polk County,2021-08-10,89,14125,33.7
13233,Polk County,2021-08-11,42,14167,33.8
13233,Polk County,2021-08-12,70,14237,34
13233,Polk County,2021-08-13,98,14335,34.2
13233,Polk County,2021-08-14,42,14377,34.3
13233,Polk County,2021-08-15,22,14399,34.4
13233,Polk County,2021-08-16,67,14466,34.5
13233,Polk County,2021-08-17,82,14548,34.7
13233,Polk County,2021-08-18,59,14607,34.9
13233,Polk County,2021-08-19,84,14691,35.1
13233,Polk County,2021-08-20,116,14807,35.3
13233,Polk County,2021-08-21,52,14859,35.5
13233,Polk County,2021-08-22,50,14909,35.6
13233,Polk County,2021-08-23,94,15003,35.8
13233,Polk County,2021-08-24,111,15114,36.1
13233,Polk County,2021-08-25,79,15193,36.3
13233,Polk County,2021-08-26,121,15314,36.5
13233,Polk County,2021-08-27,111,15425,36.8
13233,Polk County,2021-08-28,46,15471,36.9
13233,Polk County,2021-08-29,27,15498,37
13233,Polk County,2021-08-30,81,15579,37.2
13233,Polk County,2021-08-31,90,15669,37.4
13233,Polk County,2021-09-01,86,15755,37.6
13233,Polk County,2021-09-02,102,15857,37.8
13233,Polk County,2021-09-03,140,15997,38.2
13233,Polk County,2021-09-04,53,16050,38.3
13233,Polk County,2021-09-05,33,16083,38.4
13233,Polk County,2021-09-06,14,16097,38.4
13233,Polk County,2021-09-07,75,16172,38.6
13233,Polk County,2021-09-08,59,16231,38.7
13233,Polk County,2021-09-09,66,16297,38.9
13233,Polk County,2021-09-10,112,16409,39.2
13233,Polk County,2021-09-11,39,16448,39.2
13233,Polk County,2021-09-12,26,16474,39.3
13233,Polk County,2021-09-13,81,16555,39.5
13233,Polk County,2021-09-14,73,16628,39.7
13233,Polk County,2021-09-15,42,16670,39.8
13233,Polk County,2021-09-16,63,16733,39.9
13233,Polk County,2021-09-17,77,16810,40.1
13233,Polk County,2021-09-18,30,16840,40.2
13233,Polk County,2021-09-19,18,16858,40.2
13233,Polk County,2021-09-20,41,16899,40.3
13233,Polk County,2021-09-21,50,16949,40.4
13233,Polk County,2021-09-22,48,16997,40.6
13233,Polk County,2021-09-23,48,17045,40.7
13233,Polk County,2021-09-24,52,17097,40.8
13233,Polk County,2021-09-25,28,17125,40.9
13233,Polk County,2021-09-26,34,17159,40.9
13233,Polk County,2021-09-27,26,17185,41
13233,Polk County,2021-09-28,25,17210,41.1
13233,Polk County,2021-09-29,24,17234,41.1
13233,Polk County,2021-09-30,20,17254,41.2
13233,Polk County,2021-10-01,34,17288,41.3
13233,Polk County,2021-10-02,12,17300,41.3
13233,Polk County,2021-10-03,11,17311,41.3
13233,Polk County,2021-10-04,9,17320,41.3
13233,Polk County,2021-10-05,11,17331,41.4
13233,Polk County,2021-10-06,6,17337,41.4
13233,Polk County,2021-10-07,9,17346,41.4
13235,Pulaski County,2020-12-17,1,1,0
13235,Pulaski County,2020-12-18,2,3,0
13235,Pulaski County,2020-12-21,2,5,0
13235,Pulaski County,2020-12-22,3,8,0.1
13235,Pulaski County,2020-12-23,6,14,0.1
13235,Pulaski County,2020-12-24,4,18,0.2
13235,Pulaski County,2020-12-26,1,19,0.2
13235,Pulaski County,2020-12-27,1,20,0.2
13235,Pulaski County,2020-12-28,5,25,0.2
13235,Pulaski County,2020-12-29,31,56,0.5
13235,Pulaski County,2020-12-30,16,72,0.6
13235,Pulaski County,2020-12-31,1,73,0.7
13235,Pulaski County,2021-01-01,4,77,0.7
13235,Pulaski County,2021-01-02,1,78,0.7
13235,Pulaski County,2021-01-03,5,83,0.7
13235,Pulaski County,2021-01-04,13,96,0.9
13235,Pulaski County,2021-01-05,19,115,1
13235,Pulaski County,2021-01-06,90,205,1.8
13235,Pulaski County,2021-01-07,12,217,1.9
13235,Pulaski County,2021-01-08,31,248,2.2
13235,Pulaski County,2021-01-09,3,251,2.2
13235,Pulaski County,2021-01-10,1,252,2.2
13235,Pulaski County,2021-01-11,92,344,3.1
13235,Pulaski County,2021-01-12,40,384,3.4
13235,Pulaski County,2021-01-13,274,658,5.9
13235,Pulaski County,2021-01-14,75,733,6.5
13235,Pulaski County,2021-01-15,32,765,6.8
13235,Pulaski County,2021-01-16,4,769,6.9
13235,Pulaski County,2021-01-18,13,782,7
13235,Pulaski County,2021-01-19,14,796,7.1
13235,Pulaski County,2021-01-20,33,829,7.4
13235,Pulaski County,2021-01-21,89,918,8.2
13235,Pulaski County,2021-01-22,13,931,8.3
13235,Pulaski County,2021-01-23,2,933,8.3
13235,Pulaski County,2021-01-24,1,934,8.3
13235,Pulaski County,2021-01-25,51,985,8.8
13235,Pulaski County,2021-01-26,12,997,8.9
13235,Pulaski County,2021-01-27,6,1003,8.9
13235,Pulaski County,2021-01-28,112,1115,9.9
13235,Pulaski County,2021-01-29,11,1126,10
13235,Pulaski County,2021-01-30,2,1128,10.1
13235,Pulaski County,2021-02-01,16,1144,10.2
13235,Pulaski County,2021-02-02,6,1150,10.3
13235,Pulaski County,2021-02-03,35,1185,10.6
13235,Pulaski County,2021-02-04,51,1236,11
13235,Pulaski County,2021-02-05,11,1247,11.1
13235,Pulaski County,2021-02-08,23,1270,11.3
13235,Pulaski County,2021-02-09,17,1287,11.5
13235,Pulaski County,2021-02-10,20,1307,11.7
13235,Pulaski County,2021-02-11,22,1329,11.8
13235,Pulaski County,2021-02-12,16,1345,12
13235,Pulaski County,2021-02-15,6,1351,12
13235,Pulaski County,2021-02-16,6,1357,12.1
13235,Pulaski County,2021-02-17,6,1363,12.2
13235,Pulaski County,2021-02-18,33,1396,12.4
13235,Pulaski County,2021-02-19,1,1397,12.5
13235,Pulaski County,2021-02-20,3,1400,12.5
13235,Pulaski County,2021-02-22,5,1405,12.5
13235,Pulaski County,2021-02-23,10,1415,12.6
13235,Pulaski County,2021-02-24,4,1419,12.7
13235,Pulaski County,2021-02-25,71,1490,13.3
13235,Pulaski County,2021-02-26,11,1501,13.4
13235,Pulaski County,2021-02-27,2,1503,13.4
13235,Pulaski County,2021-02-28,2,1505,13.4
13235,Pulaski County,2021-03-01,3,1508,13.4
13235,Pulaski County,2021-03-02,14,1522,13.6
13235,Pulaski County,2021-03-03,7,1529,13.6
13235,Pulaski County,2021-03-04,95,1624,14.5
13235,Pulaski County,2021-03-05,10,1634,14.6
13235,Pulaski County,2021-03-06,2,1636,14.6
13235,Pulaski County,2021-03-07,3,1639,14.6
13235,Pulaski County,2021-03-08,17,1656,14.8
13235,Pulaski County,2021-03-09,7,1663,14.8
13235,Pulaski County,2021-03-10,18,1681,15
13235,Pulaski County,2021-03-11,69,1750,15.6
13235,Pulaski County,2021-03-12,29,1779,15.9
13235,Pulaski County,2021-03-13,6,1785,15.9
13235,Pulaski County,2021-03-14,22,1807,16.1
13235,Pulaski County,2021-03-15,27,1834,16.4
13235,Pulaski County,2021-03-16,61,1895,16.9
13235,Pulaski County,2021-03-17,21,1916,17.1
13235,Pulaski County,2021-03-18,101,2017,18
13235,Pulaski County,2021-03-19,32,2049,18.3
13235,Pulaski County,2021-03-20,2,2051,18.3
13235,Pulaski County,2021-03-21,2,2053,18.3
13235,Pulaski County,2021-03-22,19,2072,18.5
13235,Pulaski County,2021-03-23,21,2093,18.7
13235,Pulaski County,2021-03-24,43,2136,19
13235,Pulaski County,2021-03-25,102,2238,20
13235,Pulaski County,2021-03-26,33,2271,20.2
13235,Pulaski County,2021-03-27,5,2276,20.3
13235,Pulaski County,2021-03-28,6,2282,20.3
13235,Pulaski County,2021-03-29,17,2299,20.5
13235,Pulaski County,2021-03-30,20,2319,20.7
13235,Pulaski County,2021-03-31,32,2351,21
13235,Pulaski County,2021-04-01,66,2417,21.5
13235,Pulaski County,2021-04-02,23,2440,21.8
13235,Pulaski County,2021-04-03,3,2443,21.8
13235,Pulaski County,2021-04-04,3,2446,21.8
13235,Pulaski County,2021-04-05,21,2467,22
13235,Pulaski County,2021-04-06,12,2479,22.1
13235,Pulaski County,2021-04-07,32,2511,22.4
13235,Pulaski County,2021-04-08,70,2581,23
13235,Pulaski County,2021-04-09,25,2606,23.2
13235,Pulaski County,2021-04-10,7,2613,23.3
13235,Pulaski County,2021-04-12,11,2624,23.4
13235,Pulaski County,2021-04-13,15,2639,23.5
13235,Pulaski County,2021-04-14,16,2655,23.7
13235,Pulaski County,2021-04-15,24,2679,23.9
13235,Pulaski County,2021-04-16,15,2694,24
13235,Pulaski County,2021-04-17,2,2696,24
13235,Pulaski County,2021-04-18,2,2698,24.1
13235,Pulaski County,2021-04-19,7,2705,24.1
13235,Pulaski County,2021-04-20,20,2725,24.3
13235,Pulaski County,2021-04-21,10,2735,24.4
13235,Pulaski County,2021-04-22,19,2754,24.6
13235,Pulaski County,2021-04-23,9,2763,24.6
13235,Pulaski County,2021-04-24,4,2767,24.7
13235,Pulaski County,2021-04-25,4,2771,24.7
13235,Pulaski County,2021-04-26,6,2777,24.8
13235,Pulaski County,2021-04-27,15,2792,24.9
13235,Pulaski County,2021-04-28,10,2802,25
13235,Pulaski County,2021-04-29,20,2822,25.2
13235,Pulaski County,2021-04-30,73,2895,25.8
13235,Pulaski County,2021-05-01,4,2899,25.8
13235,Pulaski County,2021-05-02,2,2901,25.9
13235,Pulaski County,2021-05-03,12,2913,26
13235,Pulaski County,2021-05-04,3,2916,26
13235,Pulaski County,2021-05-05,9,2925,26.1
13235,Pulaski County,2021-05-06,18,2943,26.2
13235,Pulaski County,2021-05-07,16,2959,26.4
13235,Pulaski County,2021-05-08,5,2964,26.4
13235,Pulaski County,2021-05-09,2,2966,26.4
13235,Pulaski County,2021-05-10,3,2969,26.5
13235,Pulaski County,2021-05-11,14,2983,26.6
13235,Pulaski County,2021-05-12,3,2986,26.6
13235,Pulaski County,2021-05-13,13,2999,26.7
13235,Pulaski County,2021-05-14,20,3019,26.9
13235,Pulaski County,2021-05-15,8,3027,27
13235,Pulaski County,2021-05-16,5,3032,27
13235,Pulaski County,2021-05-17,8,3040,27.1
13235,Pulaski County,2021-05-18,9,3049,27.2
13235,Pulaski County,2021-05-19,10,3059,27.3
13235,Pulaski County,2021-05-20,10,3069,27.4
13235,Pulaski County,2021-05-21,6,3075,27.4
13235,Pulaski County,2021-05-22,5,3080,27.5
13235,Pulaski County,2021-05-23,2,3082,27.5
13235,Pulaski County,2021-05-24,11,3093,27.6
13235,Pulaski County,2021-05-25,12,3105,27.7
13235,Pulaski County,2021-05-26,4,3109,27.7
13235,Pulaski County,2021-05-27,8,3117,27.8
13235,Pulaski County,2021-05-28,3,3120,27.8
13235,Pulaski County,2021-05-29,4,3124,27.9
13235,Pulaski County,2021-05-30,2,3126,27.9
13235,Pulaski County,2021-05-31,1,3127,27.9
13235,Pulaski County,2021-06-01,8,3135,28
13235,Pulaski County,2021-06-02,7,3142,28
13235,Pulaski County,2021-06-03,8,3150,28.1
13235,Pulaski County,2021-06-04,11,3161,28.2
13235,Pulaski County,2021-06-05,2,3163,28.2
13235,Pulaski County,2021-06-06,3,3166,28.2
13235,Pulaski County,2021-06-07,5,3171,28.3
13235,Pulaski County,2021-06-08,5,3176,28.3
13235,Pulaski County,2021-06-09,4,3180,28.4
13235,Pulaski County,2021-06-10,5,3185,28.4
13235,Pulaski County,2021-06-11,5,3190,28.4
13235,Pulaski County,2021-06-12,4,3194,28.5
13235,Pulaski County,2021-06-14,2,3196,28.5
13235,Pulaski County,2021-06-15,8,3204,28.6
13235,Pulaski County,2021-06-16,4,3208,28.6
13235,Pulaski County,2021-06-17,4,3212,28.6
13235,Pulaski County,2021-06-18,4,3216,28.7
13235,Pulaski County,2021-06-19,2,3218,28.7
13235,Pulaski County,2021-06-21,4,3222,28.7
13235,Pulaski County,2021-06-22,9,3231,28.8
13235,Pulaski County,2021-06-23,6,3237,28.9
13235,Pulaski County,2021-06-24,2,3239,28.9
13235,Pulaski County,2021-06-25,6,3245,28.9
13235,Pulaski County,2021-06-26,1,3246,28.9
13235,Pulaski County,2021-06-28,4,3250,29
13235,Pulaski County,2021-06-29,3,3253,29
13235,Pulaski County,2021-06-30,5,3258,29
13235,Pulaski County,2021-07-01,6,3264,29.1
13235,Pulaski County,2021-07-02,5,3269,29.1
13235,Pulaski County,2021-07-03,1,3270,29.2
13235,Pulaski County,2021-07-05,1,3271,29.2
13235,Pulaski County,2021-07-06,4,3275,29.2
13235,Pulaski County,2021-07-07,1,3276,29.2
13235,Pulaski County,2021-07-08,3,3279,29.2
13235,Pulaski County,2021-07-09,2,3281,29.3
13235,Pulaski County,2021-07-10,3,3284,29.3
13235,Pulaski County,2021-07-11,1,3285,29.3
13235,Pulaski County,2021-07-12,3,3288,29.3
13235,Pulaski County,2021-07-13,5,3293,29.4
13235,Pulaski County,2021-07-14,6,3299,29.4
13235,Pulaski County,2021-07-15,6,3305,29.5
13235,Pulaski County,2021-07-16,6,3311,29.5
13235,Pulaski County,2021-07-17,1,3312,29.5
13235,Pulaski County,2021-07-19,5,3317,29.6
13235,Pulaski County,2021-07-20,7,3324,29.6
13235,Pulaski County,2021-07-21,14,3338,29.8
13235,Pulaski County,2021-07-22,8,3346,29.8
13235,Pulaski County,2021-07-23,20,3366,30
13235,Pulaski County,2021-07-24,12,3378,30.1
13235,Pulaski County,2021-07-25,3,3381,30.1
13235,Pulaski County,2021-07-26,12,3393,30.3
13235,Pulaski County,2021-07-27,13,3406,30.4
13235,Pulaski County,2021-07-28,15,3421,30.5
13235,Pulaski County,2021-07-29,22,3443,30.7
13235,Pulaski County,2021-07-30,26,3469,30.9
13235,Pulaski County,2021-07-31,2,3471,30.9
13235,Pulaski County,2021-08-01,9,3480,31
13235,Pulaski County,2021-08-02,17,3497,31.2
13235,Pulaski County,2021-08-03,24,3521,31.4
13235,Pulaski County,2021-08-04,25,3546,31.6
13235,Pulaski County,2021-08-05,15,3561,31.7
13235,Pulaski County,2021-08-06,32,3593,32
13235,Pulaski County,2021-08-07,15,3608,32.2
13235,Pulaski County,2021-08-08,14,3622,32.3
13235,Pulaski County,2021-08-09,32,3654,32.6
13235,Pulaski County,2021-08-10,28,3682,32.8
13235,Pulaski County,2021-08-11,23,3705,33
13235,Pulaski County,2021-08-12,20,3725,33.2
13235,Pulaski County,2021-08-13,48,3773,33.6
13235,Pulaski County,2021-08-14,13,3786,33.8
13235,Pulaski County,2021-08-15,9,3795,33.8
13235,Pulaski County,2021-08-16,26,3821,34.1
13235,Pulaski County,2021-08-17,26,3847,34.3
13235,Pulaski County,2021-08-18,16,3863,34.4
13235,Pulaski County,2021-08-19,27,3890,34.7
13235,Pulaski County,2021-08-20,47,3937,35.1
13235,Pulaski County,2021-08-21,10,3947,35.2
13235,Pulaski County,2021-08-22,11,3958,35.3
13235,Pulaski County,2021-08-23,20,3978,35.5
13235,Pulaski County,2021-08-24,22,4000,35.7
13235,Pulaski County,2021-08-25,19,4019,35.8
13235,Pulaski County,2021-08-26,20,4039,36
13235,Pulaski County,2021-08-27,31,4070,36.3
13235,Pulaski County,2021-08-28,4,4074,36.3
13235,Pulaski County,2021-08-29,8,4082,36.4
13235,Pulaski County,2021-08-30,17,4099,36.5
13235,Pulaski County,2021-08-31,16,4115,36.7
13235,Pulaski County,2021-09-01,34,4149,37
13235,Pulaski County,2021-09-02,28,4177,37.2
13235,Pulaski County,2021-09-03,26,4203,37.5
13235,Pulaski County,2021-09-04,8,4211,37.5
13235,Pulaski County,2021-09-05,3,4214,37.6
13235,Pulaski County,2021-09-07,19,4233,37.7
13235,Pulaski County,2021-09-08,17,4250,37.9
13235,Pulaski County,2021-09-09,13,4263,38
13235,Pulaski County,2021-09-10,22,4285,38.2
13235,Pulaski County,2021-09-11,4,4289,38.2
13235,Pulaski County,2021-09-12,2,4291,38.3
13235,Pulaski County,2021-09-13,8,4299,38.3
13235,Pulaski County,2021-09-14,15,4314,38.5
13235,Pulaski County,2021-09-15,5,4319,38.5
13235,Pulaski County,2021-09-16,14,4333,38.6
13235,Pulaski County,2021-09-17,13,4346,38.7
13235,Pulaski County,2021-09-18,11,4357,38.8
13235,Pulaski County,2021-09-20,6,4363,38.9
13235,Pulaski County,2021-09-21,11,4374,39
13235,Pulaski County,2021-09-22,6,4380,39.1
13235,Pulaski County,2021-09-23,5,4385,39.1
13235,Pulaski County,2021-09-24,10,4395,39.2
13235,Pulaski County,2021-09-25,4,4399,39.2
13235,Pulaski County,2021-09-26,1,4400,39.2
13235,Pulaski County,2021-09-27,5,4405,39.3
13235,Pulaski County,2021-09-28,7,4412,39.3
13235,Pulaski County,2021-09-29,2,4414,39.4
13235,Pulaski County,2021-09-30,4,4418,39.4
13235,Pulaski County,2021-10-01,3,4421,39.4
13235,Pulaski County,2021-10-02,2,4423,39.4
13235,Pulaski County,2021-10-03,2,4425,39.5
13235,Pulaski County,2021-10-04,7,4432,39.5
13235,Pulaski County,2021-10-05,2,4434,39.5
13235,Pulaski County,2021-10-06,4,4438,39.6
13237,Putnam County,2020-12-16,1,1,0
13237,Putnam County,2020-12-18,1,2,0
13237,Putnam County,2020-12-19,3,5,0
13237,Putnam County,2020-12-21,1,6,0
13237,Putnam County,2020-12-22,6,12,0.1
13237,Putnam County,2020-12-23,32,44,0.2
13237,Putnam County,2020-12-24,6,50,0.2
13237,Putnam County,2020-12-26,2,52,0.2
13237,Putnam County,2020-12-28,24,76,0.4
13237,Putnam County,2020-12-29,57,133,0.6
13237,Putnam County,2020-12-30,29,162,0.7
13237,Putnam County,2020-12-31,11,173,0.8
13237,Putnam County,2021-01-01,1,174,0.8
13237,Putnam County,2021-01-02,3,177,0.8
13237,Putnam County,2021-01-03,1,178,0.8
13237,Putnam County,2021-01-04,30,208,1
13237,Putnam County,2021-01-05,17,225,1
13237,Putnam County,2021-01-06,27,252,1.2
13237,Putnam County,2021-01-07,13,265,1.2
13237,Putnam County,2021-01-08,30,295,1.4
13237,Putnam County,2021-01-09,10,305,1.4
13237,Putnam County,2021-01-10,5,310,1.4
13237,Putnam County,2021-01-11,38,348,1.6
13237,Putnam County,2021-01-12,59,407,1.9
13237,Putnam County,2021-01-13,118,525,2.4
13237,Putnam County,2021-01-14,52,577,2.7
13237,Putnam County,2021-01-15,109,686,3.2
13237,Putnam County,2021-01-16,32,718,3.3
13237,Putnam County,2021-01-17,21,739,3.4
13237,Putnam County,2021-01-18,73,812,3.7
13237,Putnam County,2021-01-19,148,960,4.4
13237,Putnam County,2021-01-20,177,1137,5.2
13237,Putnam County,2021-01-21,167,1304,6
13237,Putnam County,2021-01-22,197,1501,6.9
13237,Putnam County,2021-01-23,82,1583,7.3
13237,Putnam County,2021-01-24,6,1589,7.3
13237,Putnam County,2021-01-25,100,1689,7.8
13237,Putnam County,2021-01-26,25,1714,7.9
13237,Putnam County,2021-01-27,93,1807,8.3
13237,Putnam County,2021-01-28,57,1864,8.6
13237,Putnam County,2021-01-29,93,1957,9
13237,Putnam County,2021-01-30,21,1978,9.1
13237,Putnam County,2021-01-31,9,1987,9.2
13237,Putnam County,2021-02-01,39,2026,9.3
13237,Putnam County,2021-02-02,22,2048,9.4
13237,Putnam County,2021-02-03,96,2144,9.9
13237,Putnam County,2021-02-04,32,2176,10
13237,Putnam County,2021-02-05,85,2261,10.4
13237,Putnam County,2021-02-06,17,2278,10.5
13237,Putnam County,2021-02-07,5,2283,10.5
13237,Putnam County,2021-02-08,46,2329,10.7
13237,Putnam County,2021-02-09,62,2391,11
13237,Putnam County,2021-02-10,84,2475,11.4
13237,Putnam County,2021-02-11,60,2535,11.7
13237,Putnam County,2021-02-12,36,2571,11.9
13237,Putnam County,2021-02-13,13,2584,11.9
13237,Putnam County,2021-02-14,13,2597,12
13237,Putnam County,2021-02-15,35,2632,12.1
13237,Putnam County,2021-02-16,40,2672,12.3
13237,Putnam County,2021-02-17,75,2747,12.7
13237,Putnam County,2021-02-18,62,2809,13
13237,Putnam County,2021-02-19,28,2837,13.1
13237,Putnam County,2021-02-20,24,2861,13.2
13237,Putnam County,2021-02-21,2,2863,13.2
13237,Putnam County,2021-02-22,18,2881,13.3
13237,Putnam County,2021-02-23,28,2909,13.4
13237,Putnam County,2021-02-24,54,2963,13.7
13237,Putnam County,2021-02-25,72,3035,14
13237,Putnam County,2021-02-26,60,3095,14.3
13237,Putnam County,2021-02-27,78,3173,14.6
13237,Putnam County,2021-02-28,31,3204,14.8
13237,Putnam County,2021-03-01,47,3251,15
13237,Putnam County,2021-03-02,66,3317,15.3
13237,Putnam County,2021-03-03,93,3410,15.7
13237,Putnam County,2021-03-04,75,3485,16.1
13237,Putnam County,2021-03-05,84,3569,16.5
13237,Putnam County,2021-03-06,14,3583,16.5
13237,Putnam County,2021-03-07,17,3600,16.6
13237,Putnam County,2021-03-08,55,3655,16.9
13237,Putnam County,2021-03-09,54,3709,17.1
13237,Putnam County,2021-03-10,115,3824,17.6
13237,Putnam County,2021-03-11,84,3908,18
13237,Putnam County,2021-03-12,125,4033,18.6
13237,Putnam County,2021-03-13,20,4053,18.7
13237,Putnam County,2021-03-14,9,4062,18.7
13237,Putnam County,2021-03-15,53,4115,19
13237,Putnam County,2021-03-16,210,4325,19.9
13237,Putnam County,2021-03-17,168,4493,20.7
13237,Putnam County,2021-03-18,75,4568,21.1
13237,Putnam County,2021-03-19,203,4771,22
13237,Putnam County,2021-03-20,93,4864,22.4
13237,Putnam County,2021-03-21,11,4875,22.5
13237,Putnam County,2021-03-22,42,4917,22.7
13237,Putnam County,2021-03-23,46,4963,22.9
13237,Putnam County,2021-03-24,154,5117,23.6
13237,Putnam County,2021-03-25,109,5226,24.1
13237,Putnam County,2021-03-26,229,5455,25.1
13237,Putnam County,2021-03-27,26,5481,25.3
13237,Putnam County,2021-03-28,15,5496,25.3
13237,Putnam County,2021-03-29,48,5544,25.6
13237,Putnam County,2021-03-30,82,5626,25.9
13237,Putnam County,2021-03-31,160,5786,26.7
13237,Putnam County,2021-04-01,108,5894,27.2
13237,Putnam County,2021-04-02,85,5979,27.6
13237,Putnam County,2021-04-03,10,5989,27.6
13237,Putnam County,2021-04-04,11,6000,27.7
13237,Putnam County,2021-04-05,37,6037,27.8
13237,Putnam County,2021-04-06,81,6118,28.2
13237,Putnam County,2021-04-07,100,6218,28.7
13237,Putnam County,2021-04-08,59,6277,28.9
13237,Putnam County,2021-04-09,40,6317,29.1
13237,Putnam County,2021-04-10,22,6339,29.2
13237,Putnam County,2021-04-11,20,6359,29.3
13237,Putnam County,2021-04-12,30,6389,29.5
13237,Putnam County,2021-04-13,52,6441,29.7
13237,Putnam County,2021-04-14,81,6522,30.1
13237,Putnam County,2021-04-15,42,6564,30.3
13237,Putnam County,2021-04-16,47,6611,30.5
13237,Putnam County,2021-04-17,13,6624,30.5
13237,Putnam County,2021-04-18,9,6633,30.6
13237,Putnam County,2021-04-19,23,6656,30.7
13237,Putnam County,2021-04-20,44,6700,30.9
13237,Putnam County,2021-04-21,52,6752,31.1
13237,Putnam County,2021-04-22,52,6804,31.4
13237,Putnam County,2021-04-23,39,6843,31.5
13237,Putnam County,2021-04-24,7,6850,31.6
13237,Putnam County,2021-04-25,8,6858,31.6
13237,Putnam County,2021-04-26,12,6870,31.7
13237,Putnam County,2021-04-27,29,6899,31.8
13237,Putnam County,2021-04-28,47,6946,32
13237,Putnam County,2021-04-29,41,6987,32.2
13237,Putnam County,2021-04-30,51,7038,32.4
13237,Putnam County,2021-05-01,12,7050,32.5
13237,Putnam County,2021-05-02,10,7060,32.5
13237,Putnam County,2021-05-03,12,7072,32.6
13237,Putnam County,2021-05-04,22,7094,32.7
13237,Putnam County,2021-05-05,29,7123,32.8
13237,Putnam County,2021-05-06,31,7154,33
13237,Putnam County,2021-05-07,28,7182,33.1
13237,Putnam County,2021-05-08,17,7199,33.2
13237,Putnam County,2021-05-09,3,7202,33.2
13237,Putnam County,2021-05-10,14,7216,33.3
13237,Putnam County,2021-05-11,22,7238,33.4
13237,Putnam County,2021-05-12,19,7257,33.5
13237,Putnam County,2021-05-13,12,7269,33.5
13237,Putnam County,2021-05-14,31,7300,33.7
13237,Putnam County,2021-05-15,24,7324,33.8
13237,Putnam County,2021-05-16,16,7340,33.8
13237,Putnam County,2021-05-17,30,7370,34
13237,Putnam County,2021-05-18,31,7401,34.1
13237,Putnam County,2021-05-19,34,7435,34.3
13237,Putnam County,2021-05-20,23,7458,34.4
13237,Putnam County,2021-05-21,25,7483,34.5
13237,Putnam County,2021-05-22,22,7505,34.6
13237,Putnam County,2021-05-23,8,7513,34.6
13237,Putnam County,2021-05-24,10,7523,34.7
13237,Putnam County,2021-05-25,11,7534,34.7
13237,Putnam County,2021-05-26,33,7567,34.9
13237,Putnam County,2021-05-27,15,7582,35
13237,Putnam County,2021-05-28,9,7591,35
13237,Putnam County,2021-05-29,9,7600,35
13237,Putnam County,2021-05-30,2,7602,35
13237,Putnam County,2021-05-31,5,7607,35.1
13237,Putnam County,2021-06-01,10,7617,35.1
13237,Putnam County,2021-06-02,19,7636,35.2
13237,Putnam County,2021-06-03,19,7655,35.3
13237,Putnam County,2021-06-04,11,7666,35.3
13237,Putnam County,2021-06-05,7,7673,35.4
13237,Putnam County,2021-06-06,2,7675,35.4
13237,Putnam County,2021-06-07,12,7687,35.4
13237,Putnam County,2021-06-08,14,7701,35.5
13237,Putnam County,2021-06-09,18,7719,35.6
13237,Putnam County,2021-06-10,19,7738,35.7
13237,Putnam County,2021-06-11,7,7745,35.7
13237,Putnam County,2021-06-12,10,7755,35.8
13237,Putnam County,2021-06-13,3,7758,35.8
13237,Putnam County,2021-06-14,14,7772,35.8
13237,Putnam County,2021-06-15,9,7781,35.9
13237,Putnam County,2021-06-16,17,7798,36
13237,Putnam County,2021-06-17,1,7799,36
13237,Putnam County,2021-06-18,15,7814,36
13237,Putnam County,2021-06-19,8,7822,36.1
13237,Putnam County,2021-06-20,4,7826,36.1
13237,Putnam County,2021-06-21,11,7837,36.1
13237,Putnam County,2021-06-22,5,7842,36.2
13237,Putnam County,2021-06-23,15,7857,36.2
13237,Putnam County,2021-06-24,9,7866,36.3
13237,Putnam County,2021-06-25,13,7879,36.3
13237,Putnam County,2021-06-26,7,7886,36.4
13237,Putnam County,2021-06-27,5,7891,36.4
13237,Putnam County,2021-06-28,8,7899,36.4
13237,Putnam County,2021-06-29,9,7908,36.5
13237,Putnam County,2021-06-30,9,7917,36.5
13237,Putnam County,2021-07-01,11,7928,36.5
13237,Putnam County,2021-07-02,12,7940,36.6
13237,Putnam County,2021-07-03,4,7944,36.6
13237,Putnam County,2021-07-04,1,7945,36.6
13237,Putnam County,2021-07-05,5,7950,36.7
13237,Putnam County,2021-07-06,3,7953,36.7
13237,Putnam County,2021-07-07,12,7965,36.7
13237,Putnam County,2021-07-08,8,7973,36.8
13237,Putnam County,2021-07-09,11,7984,36.8
13237,Putnam County,2021-07-10,6,7990,36.8
13237,Putnam County,2021-07-11,4,7994,36.9
13237,Putnam County,2021-07-12,11,8005,36.9
13237,Putnam County,2021-07-13,10,8015,37
13237,Putnam County,2021-07-14,25,8040,37.1
13237,Putnam County,2021-07-15,12,8052,37.1
13237,Putnam County,2021-07-16,9,8061,37.2
13237,Putnam County,2021-07-17,10,8071,37.2
13237,Putnam County,2021-07-18,6,8077,37.2
13237,Putnam County,2021-07-19,13,8090,37.3
13237,Putnam County,2021-07-20,14,8104,37.4
13237,Putnam County,2021-07-21,23,8127,37.5
13237,Putnam County,2021-07-22,30,8157,37.6
13237,Putnam County,2021-07-23,31,8188,37.7
13237,Putnam County,2021-07-24,21,8209,37.8
13237,Putnam County,2021-07-25,10,8219,37.9
13237,Putnam County,2021-07-26,27,8246,38
13237,Putnam County,2021-07-27,38,8284,38.2
13237,Putnam County,2021-07-28,43,8327,38.4
13237,Putnam County,2021-07-29,23,8350,38.5
13237,Putnam County,2021-07-30,39,8389,38.7
13237,Putnam County,2021-07-31,28,8417,38.8
13237,Putnam County,2021-08-01,11,8428,38.9
13237,Putnam County,2021-08-02,36,8464,39
13237,Putnam County,2021-08-03,39,8503,39.2
13237,Putnam County,2021-08-04,40,8543,39.4
13237,Putnam County,2021-08-05,53,8596,39.6
13237,Putnam County,2021-08-06,42,8638,39.8
13237,Putnam County,2021-08-07,25,8663,39.9
13237,Putnam County,2021-08-08,47,8710,40.2
13237,Putnam County,2021-08-09,36,8746,40.3
13237,Putnam County,2021-08-10,29,8775,40.5
13237,Putnam County,2021-08-11,51,8826,40.7
13237,Putnam County,2021-08-12,22,8848,40.8
13237,Putnam County,2021-08-13,47,8895,41
13237,Putnam County,2021-08-14,33,8928,41.2
13237,Putnam County,2021-08-15,18,8946,41.2
13237,Putnam County,2021-08-16,35,8981,41.4
13237,Putnam County,2021-08-17,42,9023,41.6
13237,Putnam County,2021-08-18,45,9068,41.8
13237,Putnam County,2021-08-19,32,9100,42
13237,Putnam County,2021-08-20,45,9145,42.2
13237,Putnam County,2021-08-21,17,9162,42.2
13237,Putnam County,2021-08-22,18,9180,42.3
13237,Putnam County,2021-08-23,36,9216,42.5
13237,Putnam County,2021-08-24,42,9258,42.7
13237,Putnam County,2021-08-25,45,9303,42.9
13237,Putnam County,2021-08-26,54,9357,43.1
13237,Putnam County,2021-08-27,39,9396,43.3
13237,Putnam County,2021-08-28,20,9416,43.4
13237,Putnam County,2021-08-29,24,9440,43.5
13237,Putnam County,2021-08-30,25,9465,43.6
13237,Putnam County,2021-08-31,40,9505,43.8
13237,Putnam County,2021-09-01,37,9542,44
13237,Putnam County,2021-09-02,21,9563,44.1
13237,Putnam County,2021-09-03,43,9606,44.3
13237,Putnam County,2021-09-04,22,9628,44.4
13237,Putnam County,2021-09-05,10,9638,44.4
13237,Putnam County,2021-09-06,8,9646,44.5
13237,Putnam County,2021-09-07,23,9669,44.6
13237,Putnam County,2021-09-08,30,9699,44.7
13237,Putnam County,2021-09-09,29,9728,44.8
13237,Putnam County,2021-09-10,60,9788,45.1
13237,Putnam County,2021-09-11,13,9801,45.2
13237,Putnam County,2021-09-12,9,9810,45.2
13237,Putnam County,2021-09-13,28,9838,45.4
13237,Putnam County,2021-09-14,23,9861,45.5
13237,Putnam County,2021-09-15,14,9875,45.5
13237,Putnam County,2021-09-16,15,9890,45.6
13237,Putnam County,2021-09-17,16,9906,45.7
13237,Putnam County,2021-09-18,9,9915,45.7
13237,Putnam County,2021-09-19,5,9920,45.7
13237,Putnam County,2021-09-20,12,9932,45.8
13237,Putnam County,2021-09-21,13,9945,45.8
13237,Putnam County,2021-09-22,25,9970,46
13237,Putnam County,2021-09-23,12,9982,46
13237,Putnam County,2021-09-24,18,10000,46.1
13237,Putnam County,2021-09-25,9,10009,46.1
13237,Putnam County,2021-09-26,4,10013,46.2
13237,Putnam County,2021-09-27,8,10021,46.2
13237,Putnam County,2021-09-28,7,10028,46.2
13237,Putnam County,2021-09-29,7,10035,46.3
13237,Putnam County,2021-09-30,7,10042,46.3
13237,Putnam County,2021-10-01,9,10051,46.3
13237,Putnam County,2021-10-02,6,10057,46.4
13237,Putnam County,2021-10-03,2,10059,46.4
13237,Putnam County,2021-10-04,7,10066,46.4
13237,Putnam County,2021-10-05,6,10072,46.4
13237,Putnam County,2021-10-06,6,10078,46.5
13237,Putnam County,2021-10-07,9,10087,46.5
13239,Quitman County,2020-12-18,1,1,0
13239,Quitman County,2020-12-21,1,2,0.1
13239,Quitman County,2020-12-22,1,3,0.1
13239,Quitman County,2020-12-24,1,4,0.2
13239,Quitman County,2020-12-26,2,6,0.3
13239,Quitman County,2020-12-28,2,8,0.3
13239,Quitman County,2020-12-29,1,9,0.4
13239,Quitman County,2021-01-01,1,10,0.4
13239,Quitman County,2021-01-02,1,11,0.5
13239,Quitman County,2021-01-04,1,12,0.5
13239,Quitman County,2021-01-05,2,14,0.6
13239,Quitman County,2021-01-06,2,16,0.7
13239,Quitman County,2021-01-07,7,23,1
13239,Quitman County,2021-01-08,1,24,1
13239,Quitman County,2021-01-11,6,30,1.3
13239,Quitman County,2021-01-12,24,54,2.4
13239,Quitman County,2021-01-13,3,57,2.5
13239,Quitman County,2021-01-14,4,61,2.7
13239,Quitman County,2021-01-15,62,123,5.4
13239,Quitman County,2021-01-18,3,126,5.5
13239,Quitman County,2021-01-19,3,129,5.6
13239,Quitman County,2021-01-20,18,147,6.4
13239,Quitman County,2021-01-21,52,199,8.7
13239,Quitman County,2021-01-22,1,200,8.7
13239,Quitman County,2021-01-23,2,202,8.8
13239,Quitman County,2021-01-25,2,204,8.9
13239,Quitman County,2021-01-26,20,224,9.8
13239,Quitman County,2021-01-27,7,231,10.1
13239,Quitman County,2021-01-28,8,239,10.4
13239,Quitman County,2021-01-29,1,240,10.5
13239,Quitman County,2021-02-01,3,243,10.6
13239,Quitman County,2021-02-02,20,263,11.5
13239,Quitman County,2021-02-03,2,265,11.6
13239,Quitman County,2021-02-04,3,268,11.7
13239,Quitman County,2021-02-05,2,270,11.8
13239,Quitman County,2021-02-06,1,271,11.8
13239,Quitman County,2021-02-09,46,317,13.8
13239,Quitman County,2021-02-11,1,318,13.9
13239,Quitman County,2021-02-12,4,322,14.1
13239,Quitman County,2021-02-16,18,340,14.9
13239,Quitman County,2021-02-17,2,342,14.9
13239,Quitman County,2021-02-18,1,343,15
13239,Quitman County,2021-02-19,2,345,15.1
13239,Quitman County,2021-02-23,26,371,16.2
13239,Quitman County,2021-02-24,5,376,16.4
13239,Quitman County,2021-02-25,3,379,16.6
13239,Quitman County,2021-02-26,2,381,16.6
13239,Quitman County,2021-02-27,1,382,16.7
13239,Quitman County,2021-02-28,1,383,16.7
13239,Quitman County,2021-03-01,5,388,17
13239,Quitman County,2021-03-02,19,407,17.8
13239,Quitman County,2021-03-03,1,408,17.8
13239,Quitman County,2021-03-05,9,417,18.2
13239,Quitman County,2021-03-08,6,423,18.5
13239,Quitman County,2021-03-09,14,437,19.1
13239,Quitman County,2021-03-10,6,443,19.4
13239,Quitman County,2021-03-15,4,447,19.5
13239,Quitman County,2021-03-16,38,485,21.2
13239,Quitman County,2021-03-17,1,486,21.2
13239,Quitman County,2021-03-18,3,489,21.4
13239,Quitman County,2021-03-19,5,494,21.6
13239,Quitman County,2021-03-22,1,495,21.6
13239,Quitman County,2021-03-23,24,519,22.7
13239,Quitman County,2021-03-24,1,520,22.7
13239,Quitman County,2021-03-25,3,523,22.8
13239,Quitman County,2021-03-26,2,525,22.9
13239,Quitman County,2021-03-28,1,526,23
13239,Quitman County,2021-03-29,3,529,23.1
13239,Quitman County,2021-03-30,36,565,24.7
13239,Quitman County,2021-03-31,8,573,25
13239,Quitman County,2021-04-01,4,577,25.2
13239,Quitman County,2021-04-02,2,579,25.3
13239,Quitman County,2021-04-05,2,581,25.4
13239,Quitman County,2021-04-06,20,601,26.3
13239,Quitman County,2021-04-07,3,604,26.4
13239,Quitman County,2021-04-08,5,609,26.6
13239,Quitman County,2021-04-09,2,611,26.7
13239,Quitman County,2021-04-10,5,616,26.9
13239,Quitman County,2021-04-11,2,618,27
13239,Quitman County,2021-04-13,2,620,27.1
13239,Quitman County,2021-04-14,2,622,27.2
13239,Quitman County,2021-04-15,5,627,27.4
13239,Quitman County,2021-04-16,4,631,27.6
13239,Quitman County,2021-04-19,2,633,27.7
13239,Quitman County,2021-04-20,4,637,27.8
13239,Quitman County,2021-04-21,2,639,27.9
13239,Quitman County,2021-04-22,1,640,28
13239,Quitman County,2021-04-23,2,642,28
13239,Quitman County,2021-04-27,15,657,28.7
13239,Quitman County,2021-04-28,4,661,28.9
13239,Quitman County,2021-04-29,1,662,28.9
13239,Quitman County,2021-04-30,5,667,29.1
13239,Quitman County,2021-05-02,1,668,29.2
13239,Quitman County,2021-05-03,1,669,29.2
13239,Quitman County,2021-05-04,8,677,29.6
13239,Quitman County,2021-05-05,2,679,29.7
13239,Quitman County,2021-05-06,2,681,29.8
13239,Quitman County,2021-05-07,1,682,29.8
13239,Quitman County,2021-05-11,11,693,30.3
13239,Quitman County,2021-05-12,1,694,30.3
13239,Quitman County,2021-05-13,1,695,30.4
13239,Quitman County,2021-05-14,2,697,30.4
13239,Quitman County,2021-05-15,2,699,30.5
13239,Quitman County,2021-05-16,1,700,30.6
13239,Quitman County,2021-05-17,1,701,30.6
13239,Quitman County,2021-05-18,1,702,30.7
13239,Quitman County,2021-05-19,1,703,30.7
13239,Quitman County,2021-05-20,2,705,30.8
13239,Quitman County,2021-05-25,11,716,31.3
13239,Quitman County,2021-05-27,1,717,31.3
13239,Quitman County,2021-05-28,2,719,31.4
13239,Quitman County,2021-05-29,1,720,31.5
13239,Quitman County,2021-06-01,1,721,31.5
13239,Quitman County,2021-06-07,1,722,31.5
13239,Quitman County,2021-06-08,3,725,31.7
13239,Quitman County,2021-06-10,1,726,31.7
13239,Quitman County,2021-06-11,1,727,31.8
13239,Quitman County,2021-06-14,1,728,31.8
13239,Quitman County,2021-06-15,2,730,31.9
13239,Quitman County,2021-06-16,1,731,31.9
13239,Quitman County,2021-06-18,1,732,32
13239,Quitman County,2021-06-21,1,733,32
13239,Quitman County,2021-06-23,1,734,32.1
13239,Quitman County,2021-06-24,1,735,32.1
13239,Quitman County,2021-06-29,6,741,32.4
13239,Quitman County,2021-07-01,2,743,32.5
13239,Quitman County,2021-07-05,1,744,32.5
13239,Quitman County,2021-07-07,1,745,32.5
13239,Quitman County,2021-07-08,1,746,32.6
13239,Quitman County,2021-07-13,2,748,32.7
13239,Quitman County,2021-07-14,1,749,32.7
13239,Quitman County,2021-07-16,1,750,32.8
13239,Quitman County,2021-07-19,2,752,32.9
13239,Quitman County,2021-07-20,1,753,32.9
13239,Quitman County,2021-07-21,1,754,32.9
13239,Quitman County,2021-07-27,9,763,33.3
13239,Quitman County,2021-07-29,4,767,33.5
13239,Quitman County,2021-07-30,3,770,33.6
13239,Quitman County,2021-07-31,2,772,33.7
13239,Quitman County,2021-08-03,1,773,33.8
13239,Quitman County,2021-08-04,1,774,33.8
13239,Quitman County,2021-08-05,3,777,33.9
13239,Quitman County,2021-08-06,1,778,34
13239,Quitman County,2021-08-08,2,780,34.1
13239,Quitman County,2021-08-10,3,783,34.2
13239,Quitman County,2021-08-12,1,784,34.3
13239,Quitman County,2021-08-13,4,788,34.4
13239,Quitman County,2021-08-14,1,789,34.5
13239,Quitman County,2021-08-16,7,796,34.8
13239,Quitman County,2021-08-17,3,799,34.9
13239,Quitman County,2021-08-18,1,800,34.9
13239,Quitman County,2021-08-19,2,802,35
13239,Quitman County,2021-08-23,3,805,35.2
13239,Quitman County,2021-08-24,4,809,35.3
13239,Quitman County,2021-08-26,1,810,35.4
13239,Quitman County,2021-08-27,1,811,35.4
13239,Quitman County,2021-08-28,1,812,35.5
13239,Quitman County,2021-08-29,1,813,35.5
13239,Quitman County,2021-08-30,2,815,35.6
13239,Quitman County,2021-08-31,1,816,35.6
13239,Quitman County,2021-09-01,2,818,35.7
13239,Quitman County,2021-09-02,2,820,35.8
13239,Quitman County,2021-09-03,1,821,35.9
13239,Quitman County,2021-09-04,1,822,35.9
13239,Quitman County,2021-09-07,1,823,36
13239,Quitman County,2021-09-10,3,826,36.1
13239,Quitman County,2021-09-11,1,827,36.1
13239,Quitman County,2021-09-12,4,831,36.3
13239,Quitman County,2021-09-13,1,832,36.3
13239,Quitman County,2021-09-14,1,833,36.4
13239,Quitman County,2021-09-15,2,835,36.5
13239,Quitman County,2021-09-16,1,836,36.5
13239,Quitman County,2021-09-18,1,837,36.6
13239,Quitman County,2021-09-19,2,839,36.7
13239,Quitman County,2021-09-22,3,842,36.8
13239,Quitman County,2021-09-29,2,844,36.9
13239,Quitman County,2021-10-01,4,848,37
13239,Quitman County,2021-10-03,1,849,37.1
13241,Rabun County,2020-12-18,4,4,0
13241,Rabun County,2020-12-19,4,8,0
13241,Rabun County,2020-12-20,1,9,0.1
13241,Rabun County,2020-12-21,6,15,0.1
13241,Rabun County,2020-12-22,9,24,0.1
13241,Rabun County,2020-12-23,14,38,0.2
13241,Rabun County,2020-12-24,7,45,0.3
13241,Rabun County,2020-12-27,1,46,0.3
13241,Rabun County,2020-12-28,25,71,0.4
13241,Rabun County,2020-12-29,42,113,0.7
13241,Rabun County,2020-12-30,41,154,0.9
13241,Rabun County,2020-12-31,8,162,1
13241,Rabun County,2021-01-01,15,177,1.1
13241,Rabun County,2021-01-03,2,179,1.1
13241,Rabun County,2021-01-04,42,221,1.3
13241,Rabun County,2021-01-05,48,269,1.6
13241,Rabun County,2021-01-06,20,289,1.7
13241,Rabun County,2021-01-07,25,314,1.9
13241,Rabun County,2021-01-08,22,336,2
13241,Rabun County,2021-01-09,3,339,2
13241,Rabun County,2021-01-10,6,345,2.1
13241,Rabun County,2021-01-11,50,395,2.4
13241,Rabun County,2021-01-12,74,469,2.8
13241,Rabun County,2021-01-13,114,583,3.5
13241,Rabun County,2021-01-14,111,694,4.2
13241,Rabun County,2021-01-15,69,763,4.6
13241,Rabun County,2021-01-16,28,791,4.8
13241,Rabun County,2021-01-17,10,801,4.8
13241,Rabun County,2021-01-18,114,915,5.5
13241,Rabun County,2021-01-19,607,1522,9.1
13241,Rabun County,2021-01-20,128,1650,9.9
13241,Rabun County,2021-01-21,86,1736,10.4
13241,Rabun County,2021-01-22,143,1879,11.3
13241,Rabun County,2021-01-23,12,1891,11.4
13241,Rabun County,2021-01-24,61,1952,11.7
13241,Rabun County,2021-01-25,91,2043,12.3
13241,Rabun County,2021-01-26,111,2154,12.9
13241,Rabun County,2021-01-27,110,2264,13.6
13241,Rabun County,2021-01-28,37,2301,13.8
13241,Rabun County,2021-01-29,34,2335,14
13241,Rabun County,2021-01-30,14,2349,14.1
13241,Rabun County,2021-01-31,1,2350,14.1
13241,Rabun County,2021-02-01,27,2377,14.3
13241,Rabun County,2021-02-02,154,2531,15.2
13241,Rabun County,2021-02-03,96,2627,15.8
13241,Rabun County,2021-02-04,64,2691,16.2
13241,Rabun County,2021-02-05,80,2771,16.6
13241,Rabun County,2021-02-06,3,2774,16.7
13241,Rabun County,2021-02-08,93,2867,17.2
13241,Rabun County,2021-02-09,71,2938,17.7
13241,Rabun County,2021-02-10,30,2968,17.8
13241,Rabun County,2021-02-11,13,2981,17.9
13241,Rabun County,2021-02-12,15,2996,18
13241,Rabun County,2021-02-13,11,3007,18.1
13241,Rabun County,2021-02-14,2,3009,18.1
13241,Rabun County,2021-02-15,28,3037,18.2
13241,Rabun County,2021-02-16,14,3051,18.3
13241,Rabun County,2021-02-17,13,3064,18.4
13241,Rabun County,2021-02-18,8,3072,18.5
13241,Rabun County,2021-02-19,7,3079,18.5
13241,Rabun County,2021-02-20,4,3083,18.5
13241,Rabun County,2021-02-21,3,3086,18.5
13241,Rabun County,2021-02-22,36,3122,18.8
13241,Rabun County,2021-02-23,65,3187,19.1
13241,Rabun County,2021-02-24,49,3236,19.4
13241,Rabun County,2021-02-25,78,3314,19.9
13241,Rabun County,2021-02-26,51,3365,20.2
13241,Rabun County,2021-02-27,7,3372,20.3
13241,Rabun County,2021-02-28,26,3398,20.4
13241,Rabun County,2021-03-01,41,3439,20.7
13241,Rabun County,2021-03-02,50,3489,21
13241,Rabun County,2021-03-03,70,3559,21.4
13241,Rabun County,2021-03-04,55,3614,21.7
13241,Rabun County,2021-03-05,64,3678,22.1
13241,Rabun County,2021-03-06,2,3680,22.1
13241,Rabun County,2021-03-07,23,3703,22.2
13241,Rabun County,2021-03-08,61,3764,22.6
13241,Rabun County,2021-03-09,70,3834,23
13241,Rabun County,2021-03-10,88,3922,23.6
13241,Rabun County,2021-03-11,58,3980,23.9
13241,Rabun County,2021-03-12,136,4116,24.7
13241,Rabun County,2021-03-13,26,4142,24.9
13241,Rabun County,2021-03-14,8,4150,24.9
13241,Rabun County,2021-03-15,93,4243,25.5
13241,Rabun County,2021-03-16,94,4337,26.1
13241,Rabun County,2021-03-17,139,4476,26.9
13241,Rabun County,2021-03-18,72,4548,27.3
13241,Rabun County,2021-03-19,129,4677,28.1
13241,Rabun County,2021-03-20,18,4695,28.2
13241,Rabun County,2021-03-21,24,4719,28.4
13241,Rabun County,2021-03-22,83,4802,28.8
13241,Rabun County,2021-03-23,81,4883,29.3
13241,Rabun County,2021-03-24,84,4967,29.8
13241,Rabun County,2021-03-25,75,5042,30.3
13241,Rabun County,2021-03-26,80,5122,30.8
13241,Rabun County,2021-03-27,17,5139,30.9
13241,Rabun County,2021-03-28,10,5149,30.9
13241,Rabun County,2021-03-29,51,5200,31.2
13241,Rabun County,2021-03-30,72,5272,31.7
13241,Rabun County,2021-03-31,84,5356,32.2
13241,Rabun County,2021-04-01,60,5416,32.5
13241,Rabun County,2021-04-02,110,5526,33.2
13241,Rabun County,2021-04-03,8,5534,33.2
13241,Rabun County,2021-04-04,16,5550,33.3
13241,Rabun County,2021-04-05,44,5594,33.6
13241,Rabun County,2021-04-06,34,5628,33.8
13241,Rabun County,2021-04-07,50,5678,34.1
13241,Rabun County,2021-04-08,53,5731,34.4
13241,Rabun County,2021-04-09,55,5786,34.8
13241,Rabun County,2021-04-10,14,5800,34.8
13241,Rabun County,2021-04-11,6,5806,34.9
13241,Rabun County,2021-04-12,32,5838,35.1
13241,Rabun County,2021-04-13,38,5876,35.3
13241,Rabun County,2021-04-14,50,5926,35.6
13241,Rabun County,2021-04-15,41,5967,35.8
13241,Rabun County,2021-04-16,60,6027,36.2
13241,Rabun County,2021-04-17,12,6039,36.3
13241,Rabun County,2021-04-18,5,6044,36.3
13241,Rabun County,2021-04-19,18,6062,36.4
13241,Rabun County,2021-04-20,28,6090,36.6
13241,Rabun County,2021-04-21,19,6109,36.7
13241,Rabun County,2021-04-22,53,6162,37
13241,Rabun County,2021-04-23,19,6181,37.1
13241,Rabun County,2021-04-24,6,6187,37.2
13241,Rabun County,2021-04-25,3,6190,37.2
13241,Rabun County,2021-04-26,18,6208,37.3
13241,Rabun County,2021-04-27,19,6227,37.4
13241,Rabun County,2021-04-28,23,6250,37.5
13241,Rabun County,2021-04-29,22,6272,37.7
13241,Rabun County,2021-04-30,49,6321,38
13241,Rabun County,2021-05-01,10,6331,38
13241,Rabun County,2021-05-02,4,6335,38.1
13241,Rabun County,2021-05-03,10,6345,38.1
13241,Rabun County,2021-05-04,14,6359,38.2
13241,Rabun County,2021-05-05,35,6394,38.4
13241,Rabun County,2021-05-06,18,6412,38.5
13241,Rabun County,2021-05-07,33,6445,38.7
13241,Rabun County,2021-05-08,3,6448,38.7
13241,Rabun County,2021-05-09,5,6453,38.8
13241,Rabun County,2021-05-10,22,6475,38.9
13241,Rabun County,2021-05-11,14,6489,39
13241,Rabun County,2021-05-12,20,6509,39.1
13241,Rabun County,2021-05-13,19,6528,39.2
13241,Rabun County,2021-05-14,25,6553,39.4
13241,Rabun County,2021-05-15,17,6570,39.5
13241,Rabun County,2021-05-16,9,6579,39.5
13241,Rabun County,2021-05-17,22,6601,39.7
13241,Rabun County,2021-05-18,17,6618,39.8
13241,Rabun County,2021-05-19,23,6641,39.9
13241,Rabun County,2021-05-20,16,6657,40
13241,Rabun County,2021-05-21,19,6676,40.1
13241,Rabun County,2021-05-22,12,6688,40.2
13241,Rabun County,2021-05-23,2,6690,40.2
13241,Rabun County,2021-05-24,14,6704,40.3
13241,Rabun County,2021-05-25,8,6712,40.3
13241,Rabun County,2021-05-26,23,6735,40.5
13241,Rabun County,2021-05-27,13,6748,40.5
13241,Rabun County,2021-05-28,15,6763,40.6
13241,Rabun County,2021-05-29,4,6767,40.7
13241,Rabun County,2021-05-30,2,6769,40.7
13241,Rabun County,2021-05-31,2,6771,40.7
13241,Rabun County,2021-06-01,12,6783,40.8
13241,Rabun County,2021-06-02,12,6795,40.8
13241,Rabun County,2021-06-03,10,6805,40.9
13241,Rabun County,2021-06-04,15,6820,41
13241,Rabun County,2021-06-05,5,6825,41
13241,Rabun County,2021-06-06,2,6827,41
13241,Rabun County,2021-06-07,9,6836,41.1
13241,Rabun County,2021-06-08,10,6846,41.1
13241,Rabun County,2021-06-09,7,6853,41.2
13241,Rabun County,2021-06-10,4,6857,41.2
13241,Rabun County,2021-06-11,14,6871,41.3
13241,Rabun County,2021-06-12,4,6875,41.3
13241,Rabun County,2021-06-13,1,6876,41.3
13241,Rabun County,2021-06-14,21,6897,41.4
13241,Rabun County,2021-06-15,21,6918,41.6
13241,Rabun County,2021-06-16,8,6926,41.6
13241,Rabun County,2021-06-17,4,6930,41.6
13241,Rabun County,2021-06-18,8,6938,41.7
13241,Rabun County,2021-06-19,3,6941,41.7
13241,Rabun County,2021-06-20,1,6942,41.7
13241,Rabun County,2021-06-21,6,6948,41.7
13241,Rabun County,2021-06-22,7,6955,41.8
13241,Rabun County,2021-06-23,9,6964,41.8
13241,Rabun County,2021-06-24,6,6970,41.9
13241,Rabun County,2021-06-25,4,6974,41.9
13241,Rabun County,2021-06-26,5,6979,41.9
13241,Rabun County,2021-06-27,2,6981,41.9
13241,Rabun County,2021-06-28,5,6986,42
13241,Rabun County,2021-06-29,14,7000,42.1
13241,Rabun County,2021-06-30,5,7005,42.1
13241,Rabun County,2021-07-01,5,7010,42.1
13241,Rabun County,2021-07-02,4,7014,42.1
13241,Rabun County,2021-07-03,1,7015,42.1
13241,Rabun County,2021-07-04,1,7016,42.2
13241,Rabun County,2021-07-05,9,7025,42.2
13241,Rabun County,2021-07-06,10,7035,42.3
13241,Rabun County,2021-07-07,5,7040,42.3
13241,Rabun County,2021-07-08,8,7048,42.3
13241,Rabun County,2021-07-09,9,7057,42.4
13241,Rabun County,2021-07-11,5,7062,42.4
13241,Rabun County,2021-07-12,5,7067,42.5
13241,Rabun County,2021-07-13,15,7082,42.5
13241,Rabun County,2021-07-14,9,7091,42.6
13241,Rabun County,2021-07-15,14,7105,42.7
13241,Rabun County,2021-07-16,10,7115,42.7
13241,Rabun County,2021-07-17,4,7119,42.8
13241,Rabun County,2021-07-18,5,7124,42.8
13241,Rabun County,2021-07-19,3,7127,42.8
13241,Rabun County,2021-07-20,13,7140,42.9
13241,Rabun County,2021-07-21,8,7148,42.9
13241,Rabun County,2021-07-22,14,7162,43
13241,Rabun County,2021-07-23,13,7175,43.1
13241,Rabun County,2021-07-24,5,7180,43.1
13241,Rabun County,2021-07-26,8,7188,43.2
13241,Rabun County,2021-07-27,18,7206,43.3
13241,Rabun County,2021-07-28,16,7222,43.4
13241,Rabun County,2021-07-29,20,7242,43.5
13241,Rabun County,2021-07-30,18,7260,43.6
13241,Rabun County,2021-07-31,11,7271,43.7
13241,Rabun County,2021-08-01,6,7277,43.7
13241,Rabun County,2021-08-02,24,7301,43.9
13241,Rabun County,2021-08-03,32,7333,44.1
13241,Rabun County,2021-08-04,36,7369,44.3
13241,Rabun County,2021-08-05,17,7386,44.4
13241,Rabun County,2021-08-06,22,7408,44.5
13241,Rabun County,2021-08-07,21,7429,44.6
13241,Rabun County,2021-08-08,8,7437,44.7
13241,Rabun County,2021-08-09,35,7472,44.9
13241,Rabun County,2021-08-10,21,7493,45
13241,Rabun County,2021-08-11,24,7517,45.2
13241,Rabun County,2021-08-12,20,7537,45.3
13241,Rabun County,2021-08-13,35,7572,45.5
13241,Rabun County,2021-08-14,15,7587,45.6
13241,Rabun County,2021-08-15,15,7602,45.7
13241,Rabun County,2021-08-16,24,7626,45.8
13241,Rabun County,2021-08-17,19,7645,45.9
13241,Rabun County,2021-08-18,26,7671,46.1
13241,Rabun County,2021-08-19,12,7683,46.2
13241,Rabun County,2021-08-20,29,7712,46.3
13241,Rabun County,2021-08-21,11,7723,46.4
13241,Rabun County,2021-08-22,4,7727,46.4
13241,Rabun County,2021-08-23,23,7750,46.6
13241,Rabun County,2021-08-24,23,7773,46.7
13241,Rabun County,2021-08-25,14,7787,46.8
13241,Rabun County,2021-08-26,33,7820,47
13241,Rabun County,2021-08-27,56,7876,47.3
13241,Rabun County,2021-08-28,19,7895,47.4
13241,Rabun County,2021-08-29,17,7912,47.5
13241,Rabun County,2021-08-30,18,7930,47.6
13241,Rabun County,2021-08-31,33,7963,47.8
13241,Rabun County,2021-09-01,31,7994,48
13241,Rabun County,2021-09-02,37,8031,48.2
13241,Rabun County,2021-09-03,43,8074,48.5
13241,Rabun County,2021-09-04,13,8087,48.6
13241,Rabun County,2021-09-05,17,8104,48.7
13241,Rabun County,2021-09-06,1,8105,48.7
13241,Rabun County,2021-09-07,13,8118,48.8
13241,Rabun County,2021-09-08,22,8140,48.9
13241,Rabun County,2021-09-09,7,8147,48.9
13241,Rabun County,2021-09-10,24,8171,49.1
13241,Rabun County,2021-09-11,23,8194,49.2
13241,Rabun County,2021-09-12,13,8207,49.3
13241,Rabun County,2021-09-13,21,8228,49.4
13241,Rabun County,2021-09-14,9,8237,49.5
13241,Rabun County,2021-09-15,9,8246,49.5
13241,Rabun County,2021-09-16,11,8257,49.6
13241,Rabun County,2021-09-17,16,8273,49.7
13241,Rabun County,2021-09-18,7,8280,49.7
13241,Rabun County,2021-09-19,3,8283,49.8
13241,Rabun County,2021-09-20,16,8299,49.9
13241,Rabun County,2021-09-21,9,8308,49.9
13241,Rabun County,2021-09-22,9,8317,50
13241,Rabun County,2021-09-23,11,8328,50
13241,Rabun County,2021-09-24,4,8332,50.1
13241,Rabun County,2021-09-25,4,8336,50.1
13241,Rabun County,2021-09-26,4,8340,50.1
13241,Rabun County,2021-09-27,6,8346,50.1
13241,Rabun County,2021-09-28,5,8351,50.2
13241,Rabun County,2021-09-29,10,8361,50.2
13241,Rabun County,2021-09-30,12,8373,50.3
13241,Rabun County,2021-10-01,11,8384,50.4
13241,Rabun County,2021-10-02,2,8386,50.4
13241,Rabun County,2021-10-04,5,8391,50.4
13241,Rabun County,2021-10-05,5,8396,50.4
13241,Rabun County,2021-10-06,2,8398,50.5
13243,Randolph County,2020-12-18,1,1,0
13243,Randolph County,2020-12-20,1,2,0
13243,Randolph County,2020-12-21,2,4,0.1
13243,Randolph County,2020-12-22,5,9,0.1
13243,Randolph County,2020-12-23,5,14,0.2
13243,Randolph County,2020-12-24,8,22,0.3
13243,Randolph County,2020-12-26,8,30,0.4
13243,Randolph County,2020-12-28,4,34,0.5
13243,Randolph County,2020-12-29,7,41,0.6
13243,Randolph County,2020-12-30,4,45,0.6
13243,Randolph County,2020-12-31,5,50,0.7
13243,Randolph County,2021-01-01,2,52,0.7
13243,Randolph County,2021-01-02,7,59,0.8
13243,Randolph County,2021-01-03,1,60,0.9
13243,Randolph County,2021-01-04,38,98,1.4
13243,Randolph County,2021-01-05,9,107,1.5
13243,Randolph County,2021-01-06,14,121,1.7
13243,Randolph County,2021-01-07,5,126,1.8
13243,Randolph County,2021-01-08,8,134,1.9
13243,Randolph County,2021-01-11,40,174,2.5
13243,Randolph County,2021-01-12,19,193,2.8
13243,Randolph County,2021-01-13,26,219,3.1
13243,Randolph County,2021-01-14,121,340,4.9
13243,Randolph County,2021-01-15,93,433,6.2
13243,Randolph County,2021-01-16,6,439,6.3
13243,Randolph County,2021-01-18,18,457,6.6
13243,Randolph County,2021-01-19,9,466,6.7
13243,Randolph County,2021-01-20,14,480,6.9
13243,Randolph County,2021-01-21,17,497,7.1
13243,Randolph County,2021-01-22,135,632,9.1
13243,Randolph County,2021-01-23,5,637,9.1
13243,Randolph County,2021-01-25,13,650,9.3
13243,Randolph County,2021-01-26,10,660,9.5
13243,Randolph County,2021-01-27,17,677,9.7
13243,Randolph County,2021-01-28,53,730,10.5
13243,Randolph County,2021-01-29,16,746,10.7
13243,Randolph County,2021-01-31,2,748,10.7
13243,Randolph County,2021-02-01,14,762,10.9
13243,Randolph County,2021-02-02,14,776,11.1
13243,Randolph County,2021-02-03,12,788,11.3
13243,Randolph County,2021-02-04,63,851,12.2
13243,Randolph County,2021-02-05,10,861,12.3
13243,Randolph County,2021-02-06,2,863,12.4
13243,Randolph County,2021-02-08,11,874,12.5
13243,Randolph County,2021-02-09,5,879,12.6
13243,Randolph County,2021-02-10,8,887,12.7
13243,Randolph County,2021-02-11,79,966,13.9
13243,Randolph County,2021-02-12,10,976,14
13243,Randolph County,2021-02-13,2,978,14
13243,Randolph County,2021-02-15,2,980,14.1
13243,Randolph County,2021-02-16,8,988,14.2
13243,Randolph County,2021-02-17,4,992,14.2
13243,Randolph County,2021-02-18,5,997,14.3
13243,Randolph County,2021-02-19,10,1007,14.4
13243,Randolph County,2021-02-22,2,1009,14.5
13243,Randolph County,2021-02-23,2,1011,14.5
13243,Randolph County,2021-02-24,12,1023,14.7
13243,Randolph County,2021-02-25,9,1032,14.8
13243,Randolph County,2021-02-26,63,1095,15.7
13243,Randolph County,2021-03-01,9,1104,15.8
13243,Randolph County,2021-03-02,7,1111,15.9
13243,Randolph County,2021-03-03,3,1114,16
13243,Randolph County,2021-03-04,8,1122,16.1
13243,Randolph County,2021-03-05,67,1189,17.1
13243,Randolph County,2021-03-06,2,1191,17.1
13243,Randolph County,2021-03-08,15,1206,17.3
13243,Randolph County,2021-03-09,20,1226,17.6
13243,Randolph County,2021-03-10,29,1255,18
13243,Randolph County,2021-03-11,67,1322,19
13243,Randolph County,2021-03-12,15,1337,19.2
13243,Randolph County,2021-03-13,1,1338,19.2
13243,Randolph County,2021-03-15,17,1355,19.4
13243,Randolph County,2021-03-16,19,1374,19.7
13243,Randolph County,2021-03-17,25,1399,20.1
13243,Randolph County,2021-03-18,12,1411,20.2
13243,Randolph County,2021-03-19,82,1493,21.4
13243,Randolph County,2021-03-20,5,1498,21.5
13243,Randolph County,2021-03-22,4,1502,21.5
13243,Randolph County,2021-03-23,18,1520,21.8
13243,Randolph County,2021-03-24,16,1536,22
13243,Randolph County,2021-03-25,88,1624,23.3
13243,Randolph County,2021-03-26,11,1635,23.4
13243,Randolph County,2021-03-27,1,1636,23.5
13243,Randolph County,2021-03-28,3,1639,23.5
13243,Randolph County,2021-03-29,14,1653,23.7
13243,Randolph County,2021-03-30,19,1672,24
13243,Randolph County,2021-03-31,17,1689,24.2
13243,Randolph County,2021-04-01,54,1743,25
13243,Randolph County,2021-04-02,8,1751,25.1
13243,Randolph County,2021-04-03,2,1753,25.1
13243,Randolph County,2021-04-04,3,1756,25.2
13243,Randolph County,2021-04-05,4,1760,25.2
13243,Randolph County,2021-04-06,8,1768,25.4
13243,Randolph County,2021-04-07,16,1784,25.6
13243,Randolph County,2021-04-08,25,1809,25.9
13243,Randolph County,2021-04-09,36,1845,26.5
13243,Randolph County,2021-04-10,56,1901,27.3
13243,Randolph County,2021-04-11,2,1903,27.3
13243,Randolph County,2021-04-12,4,1907,27.3
13243,Randolph County,2021-04-13,9,1916,27.5
13243,Randolph County,2021-04-14,10,1926,27.6
13243,Randolph County,2021-04-15,27,1953,28
13243,Randolph County,2021-04-16,13,1966,28.2
13243,Randolph County,2021-04-18,1,1967,28.2
13243,Randolph County,2021-04-19,8,1975,28.3
13243,Randolph County,2021-04-20,3,1978,28.4
13243,Randolph County,2021-04-21,2,1980,28.4
13243,Randolph County,2021-04-22,22,2002,28.7
13243,Randolph County,2021-04-23,42,2044,29.3
13243,Randolph County,2021-04-26,4,2048,29.4
13243,Randolph County,2021-04-27,6,2054,29.5
13243,Randolph County,2021-04-28,12,2066,29.6
13243,Randolph County,2021-04-29,3,2069,29.7
13243,Randolph County,2021-04-30,46,2115,30.3
13243,Randolph County,2021-05-01,4,2119,30.4
13243,Randolph County,2021-05-03,2,2121,30.4
13243,Randolph County,2021-05-04,5,2126,30.5
13243,Randolph County,2021-05-05,6,2132,30.6
13243,Randolph County,2021-05-06,10,2142,30.7
13243,Randolph County,2021-05-07,4,2146,30.8
13243,Randolph County,2021-05-08,4,2150,30.8
13243,Randolph County,2021-05-10,8,2158,30.9
13243,Randolph County,2021-05-11,3,2161,31
13243,Randolph County,2021-05-12,4,2165,31
13243,Randolph County,2021-05-13,5,2170,31.1
13243,Randolph County,2021-05-14,9,2179,31.2
13243,Randolph County,2021-05-15,21,2200,31.6
13243,Randolph County,2021-05-16,2,2202,31.6
13243,Randolph County,2021-05-17,10,2212,31.7
13243,Randolph County,2021-05-18,14,2226,31.9
13243,Randolph County,2021-05-19,9,2235,32.1
13243,Randolph County,2021-05-20,12,2247,32.2
13243,Randolph County,2021-05-21,5,2252,32.3
13243,Randolph County,2021-05-22,5,2257,32.4
13243,Randolph County,2021-05-24,13,2270,32.6
13243,Randolph County,2021-05-25,8,2278,32.7
13243,Randolph County,2021-05-26,6,2284,32.8
13243,Randolph County,2021-05-27,6,2290,32.8
13243,Randolph County,2021-05-28,11,2301,33
13243,Randolph County,2021-05-29,7,2308,33.1
13243,Randolph County,2021-05-30,2,2310,33.1
13243,Randolph County,2021-06-01,17,2327,33.4
13243,Randolph County,2021-06-02,6,2333,33.5
13243,Randolph County,2021-06-03,10,2343,33.6
13243,Randolph County,2021-06-04,3,2346,33.6
13243,Randolph County,2021-06-05,1,2347,33.7
13243,Randolph County,2021-06-07,3,2350,33.7
13243,Randolph County,2021-06-08,4,2354,33.8
13243,Randolph County,2021-06-09,4,2358,33.8
13243,Randolph County,2021-06-10,5,2363,33.9
13243,Randolph County,2021-06-11,10,2373,34
13243,Randolph County,2021-06-12,2,2375,34.1
13243,Randolph County,2021-06-14,2,2377,34.1
13243,Randolph County,2021-06-15,2,2379,34.1
13243,Randolph County,2021-06-16,8,2387,34.2
13243,Randolph County,2021-06-17,5,2392,34.3
13243,Randolph County,2021-06-18,6,2398,34.4
13243,Randolph County,2021-06-19,3,2401,34.4
13243,Randolph County,2021-06-20,2,2403,34.5
13243,Randolph County,2021-06-21,14,2417,34.7
13243,Randolph County,2021-06-22,3,2420,34.7
13243,Randolph County,2021-06-23,4,2424,34.8
13243,Randolph County,2021-06-24,7,2431,34.9
13243,Randolph County,2021-06-25,2,2433,34.9
13243,Randolph County,2021-06-26,10,2443,35
13243,Randolph County,2021-06-27,5,2448,35.1
13243,Randolph County,2021-06-28,4,2452,35.2
13243,Randolph County,2021-06-29,3,2455,35.2
13243,Randolph County,2021-06-30,4,2459,35.3
13243,Randolph County,2021-07-01,6,2465,35.4
13243,Randolph County,2021-07-02,3,2468,35.4
13243,Randolph County,2021-07-03,2,2470,35.4
13243,Randolph County,2021-07-05,2,2472,35.5
13243,Randolph County,2021-07-06,2,2474,35.5
13243,Randolph County,2021-07-07,9,2483,35.6
13243,Randolph County,2021-07-08,6,2489,35.7
13243,Randolph County,2021-07-09,10,2499,35.8
13243,Randolph County,2021-07-10,1,2500,35.9
13243,Randolph County,2021-07-11,1,2501,35.9
13243,Randolph County,2021-07-12,3,2504,35.9
13243,Randolph County,2021-07-13,1,2505,35.9
13243,Randolph County,2021-07-14,5,2510,36
13243,Randolph County,2021-07-15,9,2519,36.1
13243,Randolph County,2021-07-16,2,2521,36.2
13243,Randolph County,2021-07-17,3,2524,36.2
13243,Randolph County,2021-07-19,3,2527,36.2
13243,Randolph County,2021-07-20,3,2530,36.3
13243,Randolph County,2021-07-21,6,2536,36.4
13243,Randolph County,2021-07-22,6,2542,36.5
13243,Randolph County,2021-07-23,27,2569,36.8
13243,Randolph County,2021-07-24,9,2578,37
13243,Randolph County,2021-07-25,7,2585,37.1
13243,Randolph County,2021-07-26,10,2595,37.2
13243,Randolph County,2021-07-27,11,2606,37.4
13243,Randolph County,2021-07-28,10,2616,37.5
13243,Randolph County,2021-07-29,19,2635,37.8
13243,Randolph County,2021-07-30,14,2649,38
13243,Randolph County,2021-07-31,8,2657,38.1
13243,Randolph County,2021-08-01,3,2660,38.1
13243,Randolph County,2021-08-02,19,2679,38.4
13243,Randolph County,2021-08-03,9,2688,38.5
13243,Randolph County,2021-08-04,17,2705,38.8
13243,Randolph County,2021-08-05,29,2734,39.2
13243,Randolph County,2021-08-06,27,2761,39.6
13243,Randolph County,2021-08-07,8,2769,39.7
13243,Randolph County,2021-08-08,8,2777,39.8
13243,Randolph County,2021-08-09,21,2798,40.1
13243,Randolph County,2021-08-10,16,2814,40.4
13243,Randolph County,2021-08-11,21,2835,40.7
13243,Randolph County,2021-08-12,27,2862,41
13243,Randolph County,2021-08-13,21,2883,41.3
13243,Randolph County,2021-08-14,6,2889,41.4
13243,Randolph County,2021-08-15,4,2893,41.5
13243,Randolph County,2021-08-16,14,2907,41.7
13243,Randolph County,2021-08-17,22,2929,42
13243,Randolph County,2021-08-18,19,2948,42.3
13243,Randolph County,2021-08-19,40,2988,42.9
13243,Randolph County,2021-08-20,23,3011,43.2
13243,Randolph County,2021-08-21,30,3041,43.6
13243,Randolph County,2021-08-22,5,3046,43.7
13243,Randolph County,2021-08-23,15,3061,43.9
13243,Randolph County,2021-08-24,13,3074,44.1
13243,Randolph County,2021-08-25,10,3084,44.2
13243,Randolph County,2021-08-26,35,3119,44.7
13243,Randolph County,2021-08-27,13,3132,44.9
13243,Randolph County,2021-08-28,3,3135,45
13243,Randolph County,2021-08-29,6,3141,45
13243,Randolph County,2021-08-30,14,3155,45.2
13243,Randolph County,2021-08-31,9,3164,45.4
13243,Randolph County,2021-09-01,11,3175,45.5
13243,Randolph County,2021-09-02,21,3196,45.8
13243,Randolph County,2021-09-03,18,3214,46.1
13243,Randolph County,2021-09-04,6,3220,46.2
13243,Randolph County,2021-09-05,2,3222,46.2
13243,Randolph County,2021-09-07,13,3235,46.4
13243,Randolph County,2021-09-08,11,3246,46.6
13243,Randolph County,2021-09-09,9,3255,46.7
13243,Randolph County,2021-09-10,26,3281,47.1
13243,Randolph County,2021-09-11,10,3291,47.2
13243,Randolph County,2021-09-12,4,3295,47.3
13243,Randolph County,2021-09-13,12,3307,47.4
13243,Randolph County,2021-09-14,10,3317,47.6
13243,Randolph County,2021-09-15,8,3325,47.7
13243,Randolph County,2021-09-16,7,3332,47.8
13243,Randolph County,2021-09-17,2,3334,47.8
13243,Randolph County,2021-09-18,13,3347,48
13243,Randolph County,2021-09-19,6,3353,48.1
13243,Randolph County,2021-09-20,9,3362,48.2
13243,Randolph County,2021-09-21,7,3369,48.3
13243,Randolph County,2021-09-22,6,3375,48.4
13243,Randolph County,2021-09-23,5,3380,48.5
13243,Randolph County,2021-09-24,5,3385,48.5
13243,Randolph County,2021-09-25,3,3388,48.6
13243,Randolph County,2021-09-26,3,3391,48.6
13243,Randolph County,2021-09-27,8,3399,48.7
13243,Randolph County,2021-09-28,3,3402,48.8
13243,Randolph County,2021-09-29,2,3404,48.8
13243,Randolph County,2021-09-30,5,3409,48.9
13243,Randolph County,2021-10-01,4,3413,48.9
13243,Randolph County,2021-10-03,1,3414,49
13243,Randolph County,2021-10-04,3,3417,49
13243,Randolph County,2021-10-05,2,3419,49
13243,Randolph County,2021-10-06,1,3420,49
13243,Randolph County,2021-10-07,1,3421,49.1
13245,Richmond County,2020-12-15,1,1,0
13245,Richmond County,2020-12-16,6,7,0
13245,Richmond County,2020-12-17,110,117,0.1
13245,Richmond County,2020-12-18,265,382,0.2
13245,Richmond County,2020-12-19,105,487,0.2
13245,Richmond County,2020-12-20,8,495,0.2
13245,Richmond County,2020-12-21,52,547,0.3
13245,Richmond County,2020-12-22,645,1192,0.6
13245,Richmond County,2020-12-23,649,1841,0.9
13245,Richmond County,2020-12-24,108,1949,1
13245,Richmond County,2020-12-26,43,1992,1
13245,Richmond County,2020-12-27,21,2013,1
13245,Richmond County,2020-12-28,172,2185,1.1
13245,Richmond County,2020-12-29,386,2571,1.3
13245,Richmond County,2020-12-30,427,2998,1.5
13245,Richmond County,2020-12-31,271,3269,1.6
13245,Richmond County,2021-01-01,22,3291,1.6
13245,Richmond County,2021-01-02,70,3361,1.7
13245,Richmond County,2021-01-03,10,3371,1.7
13245,Richmond County,2021-01-04,428,3799,1.9
13245,Richmond County,2021-01-05,495,4294,2.1
13245,Richmond County,2021-01-06,409,4703,2.3
13245,Richmond County,2021-01-07,346,5049,2.5
13245,Richmond County,2021-01-08,371,5420,2.7
13245,Richmond County,2021-01-09,173,5593,2.8
13245,Richmond County,2021-01-10,30,5623,2.8
13245,Richmond County,2021-01-11,288,5911,2.9
13245,Richmond County,2021-01-12,422,6333,3.1
13245,Richmond County,2021-01-13,816,7149,3.5
13245,Richmond County,2021-01-14,855,8004,4
13245,Richmond County,2021-01-15,383,8387,4.2
13245,Richmond County,2021-01-16,159,8546,4.2
13245,Richmond County,2021-01-17,25,8571,4.2
13245,Richmond County,2021-01-18,224,8795,4.4
13245,Richmond County,2021-01-19,512,9307,4.6
13245,Richmond County,2021-01-20,521,9828,4.9
13245,Richmond County,2021-01-21,936,10764,5.3
13245,Richmond County,2021-01-22,686,11450,5.7
13245,Richmond County,2021-01-23,101,11551,5.7
13245,Richmond County,2021-01-24,144,11695,5.8
13245,Richmond County,2021-01-25,393,12088,6
13245,Richmond County,2021-01-26,378,12466,6.2
13245,Richmond County,2021-01-27,396,12862,6.4
13245,Richmond County,2021-01-28,1382,14244,7.1
13245,Richmond County,2021-01-29,443,14687,7.3
13245,Richmond County,2021-01-30,572,15259,7.6
13245,Richmond County,2021-01-31,11,15270,7.6
13245,Richmond County,2021-02-01,279,15549,7.7
13245,Richmond County,2021-02-02,777,16326,8.1
13245,Richmond County,2021-02-03,263,16589,8.2
13245,Richmond County,2021-02-04,673,17262,8.6
13245,Richmond County,2021-02-05,355,17617,8.7
13245,Richmond County,2021-02-06,75,17692,8.8
13245,Richmond County,2021-02-07,6,17698,8.8
13245,Richmond County,2021-02-08,192,17890,8.9
13245,Richmond County,2021-02-09,240,18130,9
13245,Richmond County,2021-02-10,488,18618,9.2
13245,Richmond County,2021-02-11,654,19272,9.5
13245,Richmond County,2021-02-12,195,19467,9.6
13245,Richmond County,2021-02-13,892,20359,10.1
13245,Richmond County,2021-02-14,39,20398,10.1
13245,Richmond County,2021-02-15,300,20698,10.3
13245,Richmond County,2021-02-16,289,20987,10.4
13245,Richmond County,2021-02-17,888,21875,10.8
13245,Richmond County,2021-02-18,225,22100,10.9
13245,Richmond County,2021-02-19,192,22292,11
13245,Richmond County,2021-02-20,88,22380,11.1
13245,Richmond County,2021-02-21,33,22413,11.1
13245,Richmond County,2021-02-22,175,22588,11.2
13245,Richmond County,2021-02-23,161,22749,11.3
13245,Richmond County,2021-02-24,136,22885,11.3
13245,Richmond County,2021-02-25,582,23467,11.6
13245,Richmond County,2021-02-26,201,23668,11.7
13245,Richmond County,2021-02-27,265,23933,11.9
13245,Richmond County,2021-02-28,78,24011,11.9
13245,Richmond County,2021-03-01,253,24264,12
13245,Richmond County,2021-03-02,382,24646,12.2
13245,Richmond County,2021-03-03,402,25048,12.4
13245,Richmond County,2021-03-04,339,25387,12.6
13245,Richmond County,2021-03-05,342,25729,12.7
13245,Richmond County,2021-03-06,156,25885,12.8
13245,Richmond County,2021-03-07,124,26009,12.9
13245,Richmond County,2021-03-08,426,26435,13.1
13245,Richmond County,2021-03-09,508,26943,13.3
13245,Richmond County,2021-03-10,483,27426,13.6
13245,Richmond County,2021-03-11,1819,29245,14.5
13245,Richmond County,2021-03-12,1273,30518,15.1
13245,Richmond County,2021-03-13,632,31150,15.4
13245,Richmond County,2021-03-14,134,31284,15.5
13245,Richmond County,2021-03-15,599,31883,15.8
13245,Richmond County,2021-03-16,651,32534,16.1
13245,Richmond County,2021-03-17,1205,33739,16.7
13245,Richmond County,2021-03-18,370,34109,16.9
13245,Richmond County,2021-03-19,625,34734,17.2
13245,Richmond County,2021-03-20,396,35130,17.4
13245,Richmond County,2021-03-21,157,35287,17.5
13245,Richmond County,2021-03-22,1252,36539,18.1
13245,Richmond County,2021-03-23,735,37274,18.5
13245,Richmond County,2021-03-24,727,38001,18.8
13245,Richmond County,2021-03-25,1537,39538,19.6
13245,Richmond County,2021-03-26,498,40036,19.8
13245,Richmond County,2021-03-27,861,40897,20.3
13245,Richmond County,2021-03-28,210,41107,20.4
13245,Richmond County,2021-03-29,688,41795,20.7
13245,Richmond County,2021-03-30,1213,43008,21.3
13245,Richmond County,2021-03-31,908,43916,21.8
13245,Richmond County,2021-04-01,1203,45119,22.4
13245,Richmond County,2021-04-02,404,45523,22.6
13245,Richmond County,2021-04-03,253,45776,22.7
13245,Richmond County,2021-04-04,198,45974,22.8
13245,Richmond County,2021-04-05,686,46660,23.1
13245,Richmond County,2021-04-06,724,47384,23.5
13245,Richmond County,2021-04-07,761,48145,23.9
13245,Richmond County,2021-04-08,756,48901,24.2
13245,Richmond County,2021-04-09,549,49450,24.5
13245,Richmond County,2021-04-10,332,49782,24.7
13245,Richmond County,2021-04-11,192,49974,24.8
13245,Richmond County,2021-04-12,309,50283,24.9
13245,Richmond County,2021-04-13,701,50984,25.3
13245,Richmond County,2021-04-14,372,51356,25.4
13245,Richmond County,2021-04-15,589,51945,25.7
13245,Richmond County,2021-04-16,331,52276,25.9
13245,Richmond County,2021-04-17,217,52493,26
13245,Richmond County,2021-04-18,59,52552,26
13245,Richmond County,2021-04-19,178,52730,26.1
13245,Richmond County,2021-04-20,655,53385,26.4
13245,Richmond County,2021-04-21,289,53674,26.6
13245,Richmond County,2021-04-22,452,54126,26.8
13245,Richmond County,2021-04-23,330,54456,27
13245,Richmond County,2021-04-24,137,54593,27
13245,Richmond County,2021-04-25,93,54686,27.1
13245,Richmond County,2021-04-26,250,54936,27.2
13245,Richmond County,2021-04-27,265,55201,27.3
13245,Richmond County,2021-04-28,417,55618,27.6
13245,Richmond County,2021-04-29,518,56136,27.8
13245,Richmond County,2021-04-30,407,56543,28
13245,Richmond County,2021-05-01,231,56774,28.1
13245,Richmond County,2021-05-02,82,56856,28.2
13245,Richmond County,2021-05-03,204,57060,28.3
13245,Richmond County,2021-05-04,206,57266,28.4
13245,Richmond County,2021-05-05,316,57582,28.5
13245,Richmond County,2021-05-06,332,57914,28.7
13245,Richmond County,2021-05-07,290,58204,28.8
13245,Richmond County,2021-05-08,187,58391,28.9
13245,Richmond County,2021-05-09,64,58455,29
13245,Richmond County,2021-05-10,127,58582,29
13245,Richmond County,2021-05-11,292,58874,29.2
13245,Richmond County,2021-05-12,209,59083,29.3
13245,Richmond County,2021-05-13,230,59313,29.4
13245,Richmond County,2021-05-14,350,59663,29.6
13245,Richmond County,2021-05-15,278,59941,29.7
13245,Richmond County,2021-05-16,130,60071,29.8
13245,Richmond County,2021-05-17,353,60424,29.9
13245,Richmond County,2021-05-18,429,60853,30.1
13245,Richmond County,2021-05-19,306,61159,30.3
13245,Richmond County,2021-05-20,347,61506,30.5
13245,Richmond County,2021-05-21,253,61759,30.6
13245,Richmond County,2021-05-22,293,62052,30.7
13245,Richmond County,2021-05-23,90,62142,30.8
13245,Richmond County,2021-05-24,212,62354,30.9
13245,Richmond County,2021-05-25,250,62604,31
13245,Richmond County,2021-05-26,254,62858,31.1
13245,Richmond County,2021-05-27,249,63107,31.3
13245,Richmond County,2021-05-28,181,63288,31.4
13245,Richmond County,2021-05-29,118,63406,31.4
13245,Richmond County,2021-05-30,58,63464,31.4
13245,Richmond County,2021-05-31,26,63490,31.5
13245,Richmond County,2021-06-01,197,63687,31.6
13245,Richmond County,2021-06-02,186,63873,31.6
13245,Richmond County,2021-06-03,227,64100,31.8
13245,Richmond County,2021-06-04,210,64310,31.9
13245,Richmond County,2021-06-05,140,64450,31.9
13245,Richmond County,2021-06-06,78,64528,32
13245,Richmond County,2021-06-07,183,64711,32.1
13245,Richmond County,2021-06-08,113,64824,32.1
13245,Richmond County,2021-06-09,158,64982,32.2
13245,Richmond County,2021-06-10,297,65279,32.3
13245,Richmond County,2021-06-11,197,65476,32.4
13245,Richmond County,2021-06-12,122,65598,32.5
13245,Richmond County,2021-06-13,49,65647,32.5
13245,Richmond County,2021-06-14,145,65792,32.6
13245,Richmond County,2021-06-15,139,65931,32.7
13245,Richmond County,2021-06-16,156,66087,32.7
13245,Richmond County,2021-06-17,191,66278,32.8
13245,Richmond County,2021-06-18,194,66472,32.9
13245,Richmond County,2021-06-19,77,66549,33
13245,Richmond County,2021-06-20,40,66589,33
13245,Richmond County,2021-06-21,102,66691,33
13245,Richmond County,2021-06-22,106,66797,33.1
13245,Richmond County,2021-06-23,149,66946,33.2
13245,Richmond County,2021-06-24,155,67101,33.2
13245,Richmond County,2021-06-25,175,67276,33.3
13245,Richmond County,2021-06-26,101,67377,33.4
13245,Richmond County,2021-06-27,54,67431,33.4
13245,Richmond County,2021-06-28,100,67531,33.5
13245,Richmond County,2021-06-29,136,67667,33.5
13245,Richmond County,2021-06-30,145,67812,33.6
13245,Richmond County,2021-07-01,167,67979,33.7
13245,Richmond County,2021-07-02,135,68114,33.7
13245,Richmond County,2021-07-03,75,68189,33.8
13245,Richmond County,2021-07-04,9,68198,33.8
13245,Richmond County,2021-07-05,102,68300,33.8
13245,Richmond County,2021-07-06,158,68458,33.9
13245,Richmond County,2021-07-07,105,68563,34
13245,Richmond County,2021-07-08,151,68714,34
13245,Richmond County,2021-07-09,135,68849,34.1
13245,Richmond County,2021-07-10,99,68948,34.2
13245,Richmond County,2021-07-11,48,68996,34.2
13245,Richmond County,2021-07-12,118,69114,34.2
13245,Richmond County,2021-07-13,130,69244,34.3
13245,Richmond County,2021-07-14,122,69366,34.4
13245,Richmond County,2021-07-15,164,69530,34.4
13245,Richmond County,2021-07-16,177,69707,34.5
13245,Richmond County,2021-07-17,107,69814,34.6
13245,Richmond County,2021-07-18,65,69879,34.6
13245,Richmond County,2021-07-19,182,70061,34.7
13245,Richmond County,2021-07-20,156,70217,34.8
13245,Richmond County,2021-07-21,181,70398,34.9
13245,Richmond County,2021-07-22,271,70669,35
13245,Richmond County,2021-07-23,250,70919,35.1
13245,Richmond County,2021-07-24,178,71097,35.2
13245,Richmond County,2021-07-25,129,71226,35.3
13245,Richmond County,2021-07-26,248,71474,35.4
13245,Richmond County,2021-07-27,257,71731,35.5
13245,Richmond County,2021-07-28,280,72011,35.7
13245,Richmond County,2021-07-29,294,72305,35.8
13245,Richmond County,2021-07-30,331,72636,36
13245,Richmond County,2021-07-31,215,72851,36.1
13245,Richmond County,2021-08-01,173,73024,36.2
13245,Richmond County,2021-08-02,292,73316,36.3
13245,Richmond County,2021-08-03,342,73658,36.5
13245,Richmond County,2021-08-04,342,74000,36.7
13245,Richmond County,2021-08-05,399,74399,36.9
13245,Richmond County,2021-08-06,348,74747,37
13245,Richmond County,2021-08-07,231,74978,37.1
13245,Richmond County,2021-08-08,154,75132,37.2
13245,Richmond County,2021-08-09,237,75369,37.3
13245,Richmond County,2021-08-10,382,75751,37.5
13245,Richmond County,2021-08-11,324,76075,37.7
13245,Richmond County,2021-08-12,333,76408,37.9
13245,Richmond County,2021-08-13,337,76745,38
13245,Richmond County,2021-08-14,197,76942,38.1
13245,Richmond County,2021-08-15,128,77070,38.2
13245,Richmond County,2021-08-16,302,77372,38.3
13245,Richmond County,2021-08-17,284,77656,38.5
13245,Richmond County,2021-08-18,259,77915,38.6
13245,Richmond County,2021-08-19,247,78162,38.7
13245,Richmond County,2021-08-20,263,78425,38.9
13245,Richmond County,2021-08-21,148,78573,38.9
13245,Richmond County,2021-08-22,71,78644,39
13245,Richmond County,2021-08-23,215,78859,39.1
13245,Richmond County,2021-08-24,235,79094,39.2
13245,Richmond County,2021-08-25,277,79371,39.3
13245,Richmond County,2021-08-26,285,79656,39.5
13245,Richmond County,2021-08-27,280,79936,39.6
13245,Richmond County,2021-08-28,142,80078,39.7
13245,Richmond County,2021-08-29,105,80183,39.7
13245,Richmond County,2021-08-30,263,80446,39.9
13245,Richmond County,2021-08-31,323,80769,40
13245,Richmond County,2021-09-01,244,81013,40.1
13245,Richmond County,2021-09-02,285,81298,40.3
13245,Richmond County,2021-09-03,280,81578,40.4
13245,Richmond County,2021-09-04,160,81738,40.5
13245,Richmond County,2021-09-05,112,81850,40.5
13245,Richmond County,2021-09-06,42,81892,40.6
13245,Richmond County,2021-09-07,232,82124,40.7
13245,Richmond County,2021-09-08,286,82410,40.8
13245,Richmond County,2021-09-09,251,82661,41
13245,Richmond County,2021-09-10,250,82911,41.1
13245,Richmond County,2021-09-11,150,83061,41.1
13245,Richmond County,2021-09-12,120,83181,41.2
13245,Richmond County,2021-09-13,227,83408,41.3
13245,Richmond County,2021-09-14,213,83621,41.4
13245,Richmond County,2021-09-15,211,83832,41.5
13245,Richmond County,2021-09-16,194,84026,41.6
13245,Richmond County,2021-09-17,200,84226,41.7
13245,Richmond County,2021-09-18,121,84347,41.8
13245,Richmond County,2021-09-19,78,84425,41.8
13245,Richmond County,2021-09-20,164,84589,41.9
13245,Richmond County,2021-09-21,164,84753,42
13245,Richmond County,2021-09-22,167,84920,42.1
13245,Richmond County,2021-09-23,140,85060,42.1
13245,Richmond County,2021-09-24,134,85194,42.2
13245,Richmond County,2021-09-25,98,85292,42.3
13245,Richmond County,2021-09-26,49,85341,42.3
13245,Richmond County,2021-09-27,86,85427,42.3
13245,Richmond County,2021-09-28,109,85536,42.4
13245,Richmond County,2021-09-29,101,85637,42.4
13245,Richmond County,2021-09-30,133,85770,42.5
13245,Richmond County,2021-10-01,108,85878,42.5
13245,Richmond County,2021-10-02,63,85941,42.6
13245,Richmond County,2021-10-03,31,85972,42.6
13245,Richmond County,2021-10-04,66,86038,42.6
13245,Richmond County,2021-10-05,69,86107,42.7
13245,Richmond County,2021-10-06,82,86189,42.7
13245,Richmond County,2021-10-07,35,86224,42.7
13247,Rockdale County,2020-12-16,1,1,0
13247,Rockdale County,2020-12-17,25,26,0
13247,Rockdale County,2020-12-18,21,47,0.1
13247,Rockdale County,2020-12-19,24,71,0.1
13247,Rockdale County,2020-12-20,19,90,0.1
13247,Rockdale County,2020-12-21,28,118,0.1
13247,Rockdale County,2020-12-22,47,165,0.2
13247,Rockdale County,2020-12-23,65,230,0.3
13247,Rockdale County,2020-12-24,21,251,0.3
13247,Rockdale County,2020-12-25,2,253,0.3
13247,Rockdale County,2020-12-26,12,265,0.3
13247,Rockdale County,2020-12-27,10,275,0.3
13247,Rockdale County,2020-12-28,90,365,0.4
13247,Rockdale County,2020-12-29,137,502,0.6
13247,Rockdale County,2020-12-30,102,604,0.7
13247,Rockdale County,2020-12-31,71,675,0.8
13247,Rockdale County,2021-01-01,14,689,0.8
13247,Rockdale County,2021-01-02,23,712,0.8
13247,Rockdale County,2021-01-03,85,797,0.9
13247,Rockdale County,2021-01-04,130,927,1
13247,Rockdale County,2021-01-05,99,1026,1.1
13247,Rockdale County,2021-01-06,100,1126,1.3
13247,Rockdale County,2021-01-07,87,1213,1.4
13247,Rockdale County,2021-01-08,101,1314,1.5
13247,Rockdale County,2021-01-09,35,1349,1.5
13247,Rockdale County,2021-01-10,24,1373,1.5
13247,Rockdale County,2021-01-11,124,1497,1.7
13247,Rockdale County,2021-01-12,119,1616,1.8
13247,Rockdale County,2021-01-13,243,1859,2.1
13247,Rockdale County,2021-01-14,211,2070,2.3
13247,Rockdale County,2021-01-15,273,2343,2.6
13247,Rockdale County,2021-01-16,162,2505,2.8
13247,Rockdale County,2021-01-17,52,2557,2.9
13247,Rockdale County,2021-01-18,222,2779,3.1
13247,Rockdale County,2021-01-19,322,3101,3.5
13247,Rockdale County,2021-01-20,311,3412,3.8
13247,Rockdale County,2021-01-21,322,3734,4.2
13247,Rockdale County,2021-01-22,249,3983,4.4
13247,Rockdale County,2021-01-23,76,4059,4.5
13247,Rockdale County,2021-01-24,52,4111,4.6
13247,Rockdale County,2021-01-25,292,4403,4.9
13247,Rockdale County,2021-01-26,267,4670,5.2
13247,Rockdale County,2021-01-27,298,4968,5.5
13247,Rockdale County,2021-01-28,350,5318,5.9
13247,Rockdale County,2021-01-29,255,5573,6.2
13247,Rockdale County,2021-01-30,140,5713,6.4
13247,Rockdale County,2021-01-31,9,5722,6.4
13247,Rockdale County,2021-02-01,151,5873,6.5
13247,Rockdale County,2021-02-02,135,6008,6.7
13247,Rockdale County,2021-02-03,151,6159,6.9
13247,Rockdale County,2021-02-04,222,6381,7.1
13247,Rockdale County,2021-02-05,162,6543,7.3
13247,Rockdale County,2021-02-06,84,6627,7.4
13247,Rockdale County,2021-02-07,23,6650,7.4
13247,Rockdale County,2021-02-08,173,6823,7.6
13247,Rockdale County,2021-02-09,141,6964,7.8
13247,Rockdale County,2021-02-10,169,7133,8
13247,Rockdale County,2021-02-11,200,7333,8.2
13247,Rockdale County,2021-02-12,103,7436,8.3
13247,Rockdale County,2021-02-13,80,7516,8.4
13247,Rockdale County,2021-02-14,31,7547,8.4
13247,Rockdale County,2021-02-15,169,7716,8.6
13247,Rockdale County,2021-02-16,159,7875,8.8
13247,Rockdale County,2021-02-17,189,8064,9
13247,Rockdale County,2021-02-18,178,8242,9.2
13247,Rockdale County,2021-02-19,160,8402,9.4
13247,Rockdale County,2021-02-20,146,8548,9.5
13247,Rockdale County,2021-02-21,19,8567,9.5
13247,Rockdale County,2021-02-22,197,8764,9.8
13247,Rockdale County,2021-02-23,235,8999,10
13247,Rockdale County,2021-02-24,242,9241,10.3
13247,Rockdale County,2021-02-25,238,9479,10.6
13247,Rockdale County,2021-02-26,232,9711,10.8
13247,Rockdale County,2021-02-27,80,9791,10.9
13247,Rockdale County,2021-02-28,56,9847,11
13247,Rockdale County,2021-03-01,197,10044,11.2
13247,Rockdale County,2021-03-02,274,10318,11.5
13247,Rockdale County,2021-03-03,275,10593,11.8
13247,Rockdale County,2021-03-04,326,10919,12.2
13247,Rockdale County,2021-03-05,320,11239,12.5
13247,Rockdale County,2021-03-06,136,11375,12.7
13247,Rockdale County,2021-03-07,72,11447,12.8
13247,Rockdale County,2021-03-08,391,11838,13.2
13247,Rockdale County,2021-03-09,446,12284,13.7
13247,Rockdale County,2021-03-10,437,12721,14.2
13247,Rockdale County,2021-03-11,438,13159,14.7
13247,Rockdale County,2021-03-12,463,13622,15.2
13247,Rockdale County,2021-03-13,153,13775,15.4
13247,Rockdale County,2021-03-14,93,13868,15.5
13247,Rockdale County,2021-03-15,365,14233,15.9
13247,Rockdale County,2021-03-16,539,14772,16.5
13247,Rockdale County,2021-03-17,552,15324,17.1
13247,Rockdale County,2021-03-18,449,15773,17.6
13247,Rockdale County,2021-03-19,566,16339,18.2
13247,Rockdale County,2021-03-20,297,16636,18.5
13247,Rockdale County,2021-03-21,200,16836,18.8
13247,Rockdale County,2021-03-22,538,17374,19.4
13247,Rockdale County,2021-03-23,592,17966,20
13247,Rockdale County,2021-03-24,657,18623,20.8
13247,Rockdale County,2021-03-25,653,19276,21.5
13247,Rockdale County,2021-03-26,684,19960,22.2
13247,Rockdale County,2021-03-27,261,20221,22.5
13247,Rockdale County,2021-03-28,146,20367,22.7
13247,Rockdale County,2021-03-29,528,20895,23.3
13247,Rockdale County,2021-03-30,578,21473,23.9
13247,Rockdale County,2021-03-31,634,22107,24.6
13247,Rockdale County,2021-04-01,641,22748,25.4
13247,Rockdale County,2021-04-02,487,23235,25.9
13247,Rockdale County,2021-04-03,277,23512,26.2
13247,Rockdale County,2021-04-04,93,23605,26.3
13247,Rockdale County,2021-04-05,400,24005,26.8
13247,Rockdale County,2021-04-06,602,24607,27.4
13247,Rockdale County,2021-04-07,598,25205,28.1
13247,Rockdale County,2021-04-08,568,25773,28.7
13247,Rockdale County,2021-04-09,584,26357,29.4
13247,Rockdale County,2021-04-10,347,26704,29.8
13247,Rockdale County,2021-04-11,107,26811,29.9
13247,Rockdale County,2021-04-12,284,27095,30.2
13247,Rockdale County,2021-04-13,405,27500,30.7
13247,Rockdale County,2021-04-14,333,27833,31
13247,Rockdale County,2021-04-15,315,28148,31.4
13247,Rockdale County,2021-04-16,412,28560,31.8
13247,Rockdale County,2021-04-17,137,28697,32
13247,Rockdale County,2021-04-18,133,28830,32.1
13247,Rockdale County,2021-04-19,201,29031,32.4
13247,Rockdale County,2021-04-20,304,29335,32.7
13247,Rockdale County,2021-04-21,252,29587,33
13247,Rockdale County,2021-04-22,241,29828,33.2
13247,Rockdale County,2021-04-23,293,30121,33.6
13247,Rockdale County,2021-04-24,133,30254,33.7
13247,Rockdale County,2021-04-25,88,30342,33.8
13247,Rockdale County,2021-04-26,191,30533,34
13247,Rockdale County,2021-04-27,208,30741,34.3
13247,Rockdale County,2021-04-28,242,30983,34.5
13247,Rockdale County,2021-04-29,201,31184,34.8
13247,Rockdale County,2021-04-30,240,31424,35
13247,Rockdale County,2021-05-01,200,31624,35.2
13247,Rockdale County,2021-05-02,76,31700,35.3
13247,Rockdale County,2021-05-03,139,31839,35.5
13247,Rockdale County,2021-05-04,167,32006,35.7
13247,Rockdale County,2021-05-05,177,32183,35.9
13247,Rockdale County,2021-05-06,135,32318,36
13247,Rockdale County,2021-05-07,184,32502,36.2
13247,Rockdale County,2021-05-08,99,32601,36.3
13247,Rockdale County,2021-05-09,45,32646,36.4
13247,Rockdale County,2021-05-10,109,32755,36.5
13247,Rockdale County,2021-05-11,170,32925,36.7
13247,Rockdale County,2021-05-12,133,33058,36.8
13247,Rockdale County,2021-05-13,175,33233,37
13247,Rockdale County,2021-05-14,212,33445,37.3
13247,Rockdale County,2021-05-15,268,33713,37.6
13247,Rockdale County,2021-05-16,141,33854,37.7
13247,Rockdale County,2021-05-17,239,34093,38
13247,Rockdale County,2021-05-18,220,34313,38.2
13247,Rockdale County,2021-05-19,177,34490,38.4
13247,Rockdale County,2021-05-20,174,34664,38.6
13247,Rockdale County,2021-05-21,208,34872,38.9
13247,Rockdale County,2021-05-22,146,35018,39
13247,Rockdale County,2021-05-23,74,35092,39.1
13247,Rockdale County,2021-05-24,131,35223,39.3
13247,Rockdale County,2021-05-25,105,35328,39.4
13247,Rockdale County,2021-05-26,137,35465,39.5
13247,Rockdale County,2021-05-27,103,35568,39.6
13247,Rockdale County,2021-05-28,99,35667,39.8
13247,Rockdale County,2021-05-29,74,35741,39.8
13247,Rockdale County,2021-05-30,34,35775,39.9
13247,Rockdale County,2021-05-31,17,35792,39.9
13247,Rockdale County,2021-06-01,94,35886,40
13247,Rockdale County,2021-06-02,100,35986,40.1
13247,Rockdale County,2021-06-03,100,36086,40.2
13247,Rockdale County,2021-06-04,115,36201,40.4
13247,Rockdale County,2021-06-05,161,36362,40.5
13247,Rockdale County,2021-06-06,55,36417,40.6
13247,Rockdale County,2021-06-07,85,36502,40.7
13247,Rockdale County,2021-06-08,78,36580,40.8
13247,Rockdale County,2021-06-09,82,36662,40.9
13247,Rockdale County,2021-06-10,92,36754,41
13247,Rockdale County,2021-06-11,104,36858,41.1
13247,Rockdale County,2021-06-12,120,36978,41.2
13247,Rockdale County,2021-06-13,25,37003,41.2
13247,Rockdale County,2021-06-14,68,37071,41.3
13247,Rockdale County,2021-06-15,65,37136,41.4
13247,Rockdale County,2021-06-16,89,37225,41.5
13247,Rockdale County,2021-06-17,87,37312,41.6
13247,Rockdale County,2021-06-18,100,37412,41.7
13247,Rockdale County,2021-06-19,58,37470,41.8
13247,Rockdale County,2021-06-20,9,37479,41.8
13247,Rockdale County,2021-06-21,80,37559,41.9
13247,Rockdale County,2021-06-22,69,37628,41.9
13247,Rockdale County,2021-06-23,97,37725,42
13247,Rockdale County,2021-06-24,73,37798,42.1
13247,Rockdale County,2021-06-25,100,37898,42.2
13247,Rockdale County,2021-06-26,67,37965,42.3
13247,Rockdale County,2021-06-27,38,38003,42.4
13247,Rockdale County,2021-06-28,73,38076,42.4
13247,Rockdale County,2021-06-29,70,38146,42.5
13247,Rockdale County,2021-06-30,79,38225,42.6
13247,Rockdale County,2021-07-01,65,38290,42.7
13247,Rockdale County,2021-07-02,79,38369,42.8
13247,Rockdale County,2021-07-03,64,38433,42.8
13247,Rockdale County,2021-07-04,6,38439,42.8
13247,Rockdale County,2021-07-05,60,38499,42.9
13247,Rockdale County,2021-07-06,78,38577,43
13247,Rockdale County,2021-07-07,64,38641,43.1
13247,Rockdale County,2021-07-08,67,38708,43.1
13247,Rockdale County,2021-07-09,87,38795,43.2
13247,Rockdale County,2021-07-10,105,38900,43.4
13247,Rockdale County,2021-07-11,39,38939,43.4
13247,Rockdale County,2021-07-12,83,39022,43.5
13247,Rockdale County,2021-07-13,48,39070,43.5
13247,Rockdale County,2021-07-14,79,39149,43.6
13247,Rockdale County,2021-07-15,62,39211,43.7
13247,Rockdale County,2021-07-16,99,39310,43.8
13247,Rockdale County,2021-07-17,49,39359,43.9
13247,Rockdale County,2021-07-18,40,39399,43.9
13247,Rockdale County,2021-07-19,87,39486,44
13247,Rockdale County,2021-07-20,93,39579,44.1
13247,Rockdale County,2021-07-21,94,39673,44.2
13247,Rockdale County,2021-07-22,109,39782,44.3
13247,Rockdale County,2021-07-23,153,39935,44.5
13247,Rockdale County,2021-07-24,96,40031,44.6
13247,Rockdale County,2021-07-25,68,40099,44.7
13247,Rockdale County,2021-07-26,118,40217,44.8
13247,Rockdale County,2021-07-27,150,40367,45
13247,Rockdale County,2021-07-28,143,40510,45.2
13247,Rockdale County,2021-07-29,130,40640,45.3
13247,Rockdale County,2021-07-30,140,40780,45.5
13247,Rockdale County,2021-07-31,182,40962,45.7
13247,Rockdale County,2021-08-01,71,41033,45.7
13247,Rockdale County,2021-08-02,164,41197,45.9
13247,Rockdale County,2021-08-03,151,41348,46.1
13247,Rockdale County,2021-08-04,174,41522,46.3
13247,Rockdale County,2021-08-05,162,41684,46.5
13247,Rockdale County,2021-08-06,192,41876,46.7
13247,Rockdale County,2021-08-07,112,41988,46.8
13247,Rockdale County,2021-08-08,128,42116,46.9
13247,Rockdale County,2021-08-09,155,42271,47.1
13247,Rockdale County,2021-08-10,179,42450,47.3
13247,Rockdale County,2021-08-11,154,42604,47.5
13247,Rockdale County,2021-08-12,144,42748,47.6
13247,Rockdale County,2021-08-13,161,42909,47.8
13247,Rockdale County,2021-08-14,133,43042,48
13247,Rockdale County,2021-08-15,60,43102,48
13247,Rockdale County,2021-08-16,137,43239,48.2
13247,Rockdale County,2021-08-17,141,43380,48.4
13247,Rockdale County,2021-08-18,123,43503,48.5
13247,Rockdale County,2021-08-19,137,43640,48.6
13247,Rockdale County,2021-08-20,136,43776,48.8
13247,Rockdale County,2021-08-21,95,43871,48.9
13247,Rockdale County,2021-08-22,129,44000,49
13247,Rockdale County,2021-08-23,137,44137,49.2
13247,Rockdale County,2021-08-24,131,44268,49.3
13247,Rockdale County,2021-08-25,130,44398,49.5
13247,Rockdale County,2021-08-26,131,44529,49.6
13247,Rockdale County,2021-08-27,154,44683,49.8
13247,Rockdale County,2021-08-28,184,44867,50
13247,Rockdale County,2021-08-29,94,44961,50.1
13247,Rockdale County,2021-08-30,125,45086,50.3
13247,Rockdale County,2021-08-31,124,45210,50.4
13247,Rockdale County,2021-09-01,130,45340,50.5
13247,Rockdale County,2021-09-02,99,45439,50.6
13247,Rockdale County,2021-09-03,127,45566,50.8
13247,Rockdale County,2021-09-04,99,45665,50.9
13247,Rockdale County,2021-09-05,60,45725,51
13247,Rockdale County,2021-09-06,18,45743,51
13247,Rockdale County,2021-09-07,93,45836,51.1
13247,Rockdale County,2021-09-08,116,45952,51.2
13247,Rockdale County,2021-09-09,128,46080,51.4
13247,Rockdale County,2021-09-10,137,46217,51.5
13247,Rockdale County,2021-09-11,106,46323,51.6
13247,Rockdale County,2021-09-12,61,46384,51.7
13247,Rockdale County,2021-09-13,104,46488,51.8
13247,Rockdale County,2021-09-14,86,46574,51.9
13247,Rockdale County,2021-09-15,119,46693,52
13247,Rockdale County,2021-09-16,98,46791,52.2
13247,Rockdale County,2021-09-17,109,46900,52.3
13247,Rockdale County,2021-09-18,101,47001,52.4
13247,Rockdale County,2021-09-19,56,47057,52.5
13247,Rockdale County,2021-09-20,85,47142,52.5
13247,Rockdale County,2021-09-21,77,47219,52.6
13247,Rockdale County,2021-09-22,76,47295,52.7
13247,Rockdale County,2021-09-23,72,47367,52.8
13247,Rockdale County,2021-09-24,63,47430,52.9
13247,Rockdale County,2021-09-25,36,47466,52.9
13247,Rockdale County,2021-09-26,31,47497,52.9
13247,Rockdale County,2021-09-27,47,47544,53
13247,Rockdale County,2021-09-28,37,47581,53
13247,Rockdale County,2021-09-29,39,47620,53.1
13247,Rockdale County,2021-09-30,39,47659,53.1
13247,Rockdale County,2021-10-01,50,47709,53.2
13247,Rockdale County,2021-10-02,43,47752,53.2
13247,Rockdale County,2021-10-03,17,47769,53.2
13247,Rockdale County,2021-10-04,18,47787,53.3
13247,Rockdale County,2021-10-05,23,47810,53.3
13247,Rockdale County,2021-10-06,28,47838,53.3
13247,Rockdale County,2021-10-07,14,47852,53.3
13249,Schley County,2020-12-17,1,1,0
13249,Schley County,2020-12-18,1,2,0
13249,Schley County,2020-12-21,1,3,0.1
13249,Schley County,2020-12-22,3,6,0.1
13249,Schley County,2020-12-23,9,15,0.3
13249,Schley County,2020-12-24,2,17,0.3
13249,Schley County,2020-12-26,5,22,0.4
13249,Schley County,2020-12-28,8,30,0.6
13249,Schley County,2020-12-29,6,36,0.7
13249,Schley County,2020-12-30,5,41,0.8
13249,Schley County,2020-12-31,6,47,0.9
13249,Schley County,2021-01-03,7,54,1
13249,Schley County,2021-01-04,8,62,1.2
13249,Schley County,2021-01-05,6,68,1.3
13249,Schley County,2021-01-06,8,76,1.5
13249,Schley County,2021-01-07,6,82,1.6
13249,Schley County,2021-01-09,1,83,1.6
13249,Schley County,2021-01-11,10,93,1.8
13249,Schley County,2021-01-12,48,141,2.7
13249,Schley County,2021-01-13,31,172,3.3
13249,Schley County,2021-01-14,48,220,4.2
13249,Schley County,2021-01-15,108,328,6.3
13249,Schley County,2021-01-16,2,330,6.3
13249,Schley County,2021-01-17,4,334,6.4
13249,Schley County,2021-01-18,16,350,6.7
13249,Schley County,2021-01-19,8,358,6.9
13249,Schley County,2021-01-20,16,374,7.2
13249,Schley County,2021-01-21,42,416,8
13249,Schley County,2021-01-22,52,468,9
13249,Schley County,2021-01-23,1,469,9
13249,Schley County,2021-01-25,8,477,9.1
13249,Schley County,2021-01-26,8,485,9.3
13249,Schley County,2021-01-27,6,491,9.4
13249,Schley County,2021-01-28,16,507,9.7
13249,Schley County,2021-01-29,10,517,9.9
13249,Schley County,2021-02-02,8,525,10.1
13249,Schley County,2021-02-03,9,534,10.2
13249,Schley County,2021-02-04,8,542,10.4
13249,Schley County,2021-02-05,8,550,10.5
13249,Schley County,2021-02-06,1,551,10.6
13249,Schley County,2021-02-07,3,554,10.6
13249,Schley County,2021-02-09,2,556,10.6
13249,Schley County,2021-02-10,5,561,10.7
13249,Schley County,2021-02-11,8,569,10.9
13249,Schley County,2021-02-12,5,574,11
13249,Schley County,2021-02-15,2,576,11
13249,Schley County,2021-02-16,6,582,11.1
13249,Schley County,2021-02-17,2,584,11.2
13249,Schley County,2021-02-18,3,587,11.2
13249,Schley County,2021-02-19,5,592,11.3
13249,Schley County,2021-02-22,1,593,11.4
13249,Schley County,2021-02-23,6,599,11.5
13249,Schley County,2021-02-24,7,606,11.6
13249,Schley County,2021-02-25,3,609,11.7
13249,Schley County,2021-02-26,3,612,11.7
13249,Schley County,2021-03-01,6,618,11.8
13249,Schley County,2021-03-02,6,624,12
13249,Schley County,2021-03-03,10,634,12.1
13249,Schley County,2021-03-04,4,638,12.2
13249,Schley County,2021-03-05,62,700,13.4
13249,Schley County,2021-03-06,2,702,13.4
13249,Schley County,2021-03-08,7,709,13.6
13249,Schley County,2021-03-09,10,719,13.8
13249,Schley County,2021-03-10,11,730,14
13249,Schley County,2021-03-11,5,735,14.1
13249,Schley County,2021-03-12,67,802,15.4
13249,Schley County,2021-03-13,1,803,15.4
13249,Schley County,2021-03-14,1,804,15.4
13249,Schley County,2021-03-15,19,823,15.8
13249,Schley County,2021-03-16,4,827,15.8
13249,Schley County,2021-03-17,12,839,16.1
13249,Schley County,2021-03-18,13,852,16.3
13249,Schley County,2021-03-19,72,924,17.7
13249,Schley County,2021-03-21,1,925,17.7
13249,Schley County,2021-03-22,11,936,17.9
13249,Schley County,2021-03-23,9,945,18.1
13249,Schley County,2021-03-24,2,947,18.1
13249,Schley County,2021-03-25,12,959,18.4
13249,Schley County,2021-03-26,25,984,18.8
13249,Schley County,2021-03-28,1,985,18.9
13249,Schley County,2021-03-29,9,994,19
13249,Schley County,2021-03-30,5,999,19.1
13249,Schley County,2021-03-31,16,1015,19.4
13249,Schley County,2021-04-01,39,1054,20.2
13249,Schley County,2021-04-02,8,1062,20.3
13249,Schley County,2021-04-03,2,1064,20.4
13249,Schley County,2021-04-05,7,1071,20.5
13249,Schley County,2021-04-06,11,1082,20.7
13249,Schley County,2021-04-07,5,1087,20.8
13249,Schley County,2021-04-08,24,1111,21.3
13249,Schley County,2021-04-09,10,1121,21.5
13249,Schley County,2021-04-10,1,1122,21.5
13249,Schley County,2021-04-11,1,1123,21.5
13249,Schley County,2021-04-12,5,1128,21.6
13249,Schley County,2021-04-13,6,1134,21.7
13249,Schley County,2021-04-14,5,1139,21.8
13249,Schley County,2021-04-15,22,1161,22.2
13249,Schley County,2021-04-16,9,1170,22.4
13249,Schley County,2021-04-17,2,1172,22.4
13249,Schley County,2021-04-19,1,1173,22.5
13249,Schley County,2021-04-20,2,1175,22.5
13249,Schley County,2021-04-21,5,1180,22.6
13249,Schley County,2021-04-22,4,1184,22.7
13249,Schley County,2021-04-23,2,1186,22.7
13249,Schley County,2021-04-24,2,1188,22.8
13249,Schley County,2021-04-25,1,1189,22.8
13249,Schley County,2021-04-26,5,1194,22.9
13249,Schley County,2021-04-27,3,1197,22.9
13249,Schley County,2021-04-28,9,1206,23.1
13249,Schley County,2021-04-29,7,1213,23.2
13249,Schley County,2021-04-30,5,1218,23.3
13249,Schley County,2021-05-03,1,1219,23.3
13249,Schley County,2021-05-04,2,1221,23.4
13249,Schley County,2021-05-05,3,1224,23.4
13249,Schley County,2021-05-06,8,1232,23.6
13249,Schley County,2021-05-07,3,1235,23.7
13249,Schley County,2021-05-10,1,1236,23.7
13249,Schley County,2021-05-11,4,1240,23.8
13249,Schley County,2021-05-12,1,1241,23.8
13249,Schley County,2021-05-13,5,1246,23.9
13249,Schley County,2021-05-14,6,1252,24
13249,Schley County,2021-05-17,1,1253,24
13249,Schley County,2021-05-18,2,1255,24
13249,Schley County,2021-05-19,2,1257,24.1
13249,Schley County,2021-05-20,13,1270,24.3
13249,Schley County,2021-05-21,4,1274,24.4
13249,Schley County,2021-05-24,1,1275,24.4
13249,Schley County,2021-05-25,2,1277,24.5
13249,Schley County,2021-05-26,3,1280,24.5
13249,Schley County,2021-05-27,3,1283,24.6
13249,Schley County,2021-05-28,6,1289,24.7
13249,Schley County,2021-05-29,1,1290,24.7
13249,Schley County,2021-06-01,2,1292,24.7
13249,Schley County,2021-06-02,1,1293,24.8
13249,Schley County,2021-06-03,6,1299,24.9
13249,Schley County,2021-06-04,1,1300,24.9
13249,Schley County,2021-06-07,3,1303,25
13249,Schley County,2021-06-08,2,1305,25
13249,Schley County,2021-06-09,2,1307,25
13249,Schley County,2021-06-10,2,1309,25.1
13249,Schley County,2021-06-11,2,1311,25.1
13249,Schley County,2021-06-12,3,1314,25.2
13249,Schley County,2021-06-14,1,1315,25.2
13249,Schley County,2021-06-15,2,1317,25.2
13249,Schley County,2021-06-17,2,1319,25.3
13249,Schley County,2021-06-18,3,1322,25.3
13249,Schley County,2021-06-20,1,1323,25.3
13249,Schley County,2021-06-21,2,1325,25.4
13249,Schley County,2021-06-23,3,1328,25.4
13249,Schley County,2021-06-24,2,1330,25.5
13249,Schley County,2021-06-25,7,1337,25.6
13249,Schley County,2021-06-26,3,1340,25.7
13249,Schley County,2021-06-28,3,1343,25.7
13249,Schley County,2021-06-30,3,1346,25.8
13249,Schley County,2021-07-01,2,1348,25.8
13249,Schley County,2021-07-03,1,1349,25.8
13249,Schley County,2021-07-05,3,1352,25.9
13249,Schley County,2021-07-06,3,1355,26
13249,Schley County,2021-07-08,7,1362,26.1
13249,Schley County,2021-07-09,6,1368,26.2
13249,Schley County,2021-07-10,1,1369,26.2
13249,Schley County,2021-07-13,3,1372,26.3
13249,Schley County,2021-07-15,2,1374,26.3
13249,Schley County,2021-07-16,4,1378,26.4
13249,Schley County,2021-07-17,2,1380,26.4
13249,Schley County,2021-07-19,3,1383,26.5
13249,Schley County,2021-07-21,1,1384,26.5
13249,Schley County,2021-07-22,17,1401,26.8
13249,Schley County,2021-07-23,14,1415,27.1
13249,Schley County,2021-07-26,4,1419,27.2
13249,Schley County,2021-07-27,3,1422,27.2
13249,Schley County,2021-07-28,3,1425,27.3
13249,Schley County,2021-07-29,27,1452,27.8
13249,Schley County,2021-07-30,4,1456,27.9
13249,Schley County,2021-07-31,2,1458,27.9
13249,Schley County,2021-08-01,1,1459,27.9
13249,Schley County,2021-08-02,3,1462,28
13249,Schley County,2021-08-03,6,1468,28.1
13249,Schley County,2021-08-04,4,1472,28.2
13249,Schley County,2021-08-05,12,1484,28.4
13249,Schley County,2021-08-06,9,1493,28.6
13249,Schley County,2021-08-07,7,1500,28.7
13249,Schley County,2021-08-08,3,1503,28.8
13249,Schley County,2021-08-09,17,1520,29.1
13249,Schley County,2021-08-10,6,1526,29.2
13249,Schley County,2021-08-11,4,1530,29.3
13249,Schley County,2021-08-12,9,1539,29.5
13249,Schley County,2021-08-13,7,1546,29.6
13249,Schley County,2021-08-14,4,1550,29.7
13249,Schley County,2021-08-15,4,1554,29.8
13249,Schley County,2021-08-16,4,1558,29.8
13249,Schley County,2021-08-17,13,1571,30.1
13249,Schley County,2021-08-18,11,1582,30.3
13249,Schley County,2021-08-19,49,1631,31.2
13249,Schley County,2021-08-20,40,1671,32
13249,Schley County,2021-08-21,5,1676,32.1
13249,Schley County,2021-08-23,12,1688,32.3
13249,Schley County,2021-08-24,15,1703,32.6
13249,Schley County,2021-08-25,17,1720,32.9
13249,Schley County,2021-08-26,14,1734,33.2
13249,Schley County,2021-08-27,31,1765,33.8
13249,Schley County,2021-08-28,3,1768,33.9
13249,Schley County,2021-08-29,2,1770,33.9
13249,Schley County,2021-08-30,8,1778,34.1
13249,Schley County,2021-08-31,12,1790,34.3
13249,Schley County,2021-09-01,6,1796,34.4
13249,Schley County,2021-09-02,3,1799,34.5
13249,Schley County,2021-09-03,10,1809,34.6
13249,Schley County,2021-09-05,3,1812,34.7
13249,Schley County,2021-09-07,4,1816,34.8
13249,Schley County,2021-09-08,7,1823,34.9
13249,Schley County,2021-09-09,1,1824,34.9
13249,Schley County,2021-09-10,19,1843,35.3
13249,Schley County,2021-09-11,4,1847,35.4
13249,Schley County,2021-09-12,3,1850,35.4
13249,Schley County,2021-09-13,5,1855,35.5
13249,Schley County,2021-09-14,2,1857,35.6
13249,Schley County,2021-09-15,6,1863,35.7
13249,Schley County,2021-09-16,4,1867,35.8
13249,Schley County,2021-09-17,4,1871,35.8
13249,Schley County,2021-09-20,4,1875,35.9
13249,Schley County,2021-09-21,3,1878,36
13249,Schley County,2021-09-22,3,1881,36
13249,Schley County,2021-09-23,2,1883,36.1
13249,Schley County,2021-09-24,4,1887,36.1
13249,Schley County,2021-09-25,1,1888,36.2
13249,Schley County,2021-09-27,1,1889,36.2
13249,Schley County,2021-09-28,4,1893,36.3
13249,Schley County,2021-09-29,1,1894,36.3
13249,Schley County,2021-09-30,2,1896,36.3
13249,Schley County,2021-10-01,5,1901,36.4
13249,Schley County,2021-10-03,2,1903,36.4
13249,Schley County,2021-10-04,2,1905,36.5
13249,Schley County,2021-10-06,4,1909,36.6
13249,Schley County,2021-10-07,2,1911,36.6
13251,Screven County,2020-12-18,2,2,0
13251,Screven County,2020-12-19,1,3,0
13251,Screven County,2020-12-20,1,4,0
13251,Screven County,2020-12-21,5,9,0.1
13251,Screven County,2020-12-22,5,14,0.1
13251,Screven County,2020-12-23,10,24,0.2
13251,Screven County,2020-12-24,4,28,0.2
13251,Screven County,2020-12-26,1,29,0.2
13251,Screven County,2020-12-27,3,32,0.2
13251,Screven County,2020-12-28,20,52,0.4
13251,Screven County,2020-12-29,23,75,0.5
13251,Screven County,2020-12-30,10,85,0.6
13251,Screven County,2020-12-31,13,98,0.7
13251,Screven County,2021-01-01,1,99,0.7
13251,Screven County,2021-01-04,5,104,0.7
13251,Screven County,2021-01-05,16,120,0.9
13251,Screven County,2021-01-06,63,183,1.3
13251,Screven County,2021-01-07,20,203,1.5
13251,Screven County,2021-01-08,27,230,1.6
13251,Screven County,2021-01-09,2,232,1.7
13251,Screven County,2021-01-10,4,236,1.7
13251,Screven County,2021-01-11,24,260,1.9
13251,Screven County,2021-01-12,168,428,3.1
13251,Screven County,2021-01-13,34,462,3.3
13251,Screven County,2021-01-14,50,512,3.7
13251,Screven County,2021-01-15,33,545,3.9
13251,Screven County,2021-01-16,6,551,3.9
13251,Screven County,2021-01-17,1,552,3.9
13251,Screven County,2021-01-18,45,597,4.3
13251,Screven County,2021-01-19,94,691,4.9
13251,Screven County,2021-01-20,54,745,5.3
13251,Screven County,2021-01-21,88,833,6
13251,Screven County,2021-01-22,35,868,6.2
13251,Screven County,2021-01-23,6,874,6.2
13251,Screven County,2021-01-25,40,914,6.5
13251,Screven County,2021-01-26,113,1027,7.3
13251,Screven County,2021-01-27,29,1056,7.5
13251,Screven County,2021-01-28,92,1148,8.2
13251,Screven County,2021-01-29,27,1175,8.4
13251,Screven County,2021-01-30,4,1179,8.4
13251,Screven County,2021-02-01,19,1198,8.6
13251,Screven County,2021-02-02,146,1344,9.6
13251,Screven County,2021-02-03,56,1400,10
13251,Screven County,2021-02-04,86,1486,10.6
13251,Screven County,2021-02-05,42,1528,10.9
13251,Screven County,2021-02-06,4,1532,11
13251,Screven County,2021-02-08,12,1544,11
13251,Screven County,2021-02-09,63,1607,11.5
13251,Screven County,2021-02-10,47,1654,11.8
13251,Screven County,2021-02-11,68,1722,12.3
13251,Screven County,2021-02-12,27,1749,12.5
13251,Screven County,2021-02-13,12,1761,12.6
13251,Screven County,2021-02-14,2,1763,12.6
13251,Screven County,2021-02-15,19,1782,12.7
13251,Screven County,2021-02-16,49,1831,13.1
13251,Screven County,2021-02-17,27,1858,13.3
13251,Screven County,2021-02-18,26,1884,13.5
13251,Screven County,2021-02-19,13,1897,13.6
13251,Screven County,2021-02-20,3,1900,13.6
13251,Screven County,2021-02-21,2,1902,13.6
13251,Screven County,2021-02-22,33,1935,13.8
13251,Screven County,2021-02-23,39,1974,14.1
13251,Screven County,2021-02-24,41,2015,14.4
13251,Screven County,2021-02-25,39,2054,14.7
13251,Screven County,2021-02-26,10,2064,14.8
13251,Screven County,2021-02-27,6,2070,14.8
13251,Screven County,2021-02-28,5,2075,14.8
13251,Screven County,2021-03-01,54,2129,15.2
13251,Screven County,2021-03-02,40,2169,15.5
13251,Screven County,2021-03-03,43,2212,15.8
13251,Screven County,2021-03-04,37,2249,16.1
13251,Screven County,2021-03-05,20,2269,16.2
13251,Screven County,2021-03-06,5,2274,16.3
13251,Screven County,2021-03-07,10,2284,16.3
13251,Screven County,2021-03-08,149,2433,17.4
13251,Screven County,2021-03-09,85,2518,18
13251,Screven County,2021-03-10,38,2556,18.3
13251,Screven County,2021-03-11,59,2615,18.7
13251,Screven County,2021-03-12,29,2644,18.9
13251,Screven County,2021-03-13,10,2654,19
13251,Screven County,2021-03-14,10,2664,19
13251,Screven County,2021-03-15,77,2741,19.6
13251,Screven County,2021-03-16,117,2858,20.4
13251,Screven County,2021-03-17,115,2973,21.3
13251,Screven County,2021-03-18,85,3058,21.9
13251,Screven County,2021-03-19,57,3115,22.3
13251,Screven County,2021-03-20,6,3121,22.3
13251,Screven County,2021-03-21,6,3127,22.4
13251,Screven County,2021-03-22,65,3192,22.8
13251,Screven County,2021-03-23,81,3273,23.4
13251,Screven County,2021-03-24,43,3316,23.7
13251,Screven County,2021-03-25,67,3383,24.2
13251,Screven County,2021-03-26,31,3414,24.4
13251,Screven County,2021-03-27,118,3532,25.2
13251,Screven County,2021-03-28,13,3545,25.3
13251,Screven County,2021-03-29,45,3590,25.7
13251,Screven County,2021-03-30,80,3670,26.2
13251,Screven County,2021-03-31,47,3717,26.6
13251,Screven County,2021-04-01,60,3777,27
13251,Screven County,2021-04-02,55,3832,27.4
13251,Screven County,2021-04-03,4,3836,27.4
13251,Screven County,2021-04-04,2,3838,27.4
13251,Screven County,2021-04-05,34,3872,27.7
13251,Screven County,2021-04-06,52,3924,28.1
13251,Screven County,2021-04-07,39,3963,28.3
13251,Screven County,2021-04-08,27,3990,28.5
13251,Screven County,2021-04-09,50,4040,28.9
13251,Screven County,2021-04-10,9,4049,28.9
13251,Screven County,2021-04-11,12,4061,29
13251,Screven County,2021-04-12,22,4083,29.2
13251,Screven County,2021-04-13,42,4125,29.5
13251,Screven County,2021-04-14,33,4158,29.7
13251,Screven County,2021-04-15,33,4191,30
13251,Screven County,2021-04-16,22,4213,30.1
13251,Screven County,2021-04-17,5,4218,30.2
13251,Screven County,2021-04-18,1,4219,30.2
13251,Screven County,2021-04-19,19,4238,30.3
13251,Screven County,2021-04-20,27,4265,30.5
13251,Screven County,2021-04-21,27,4292,30.7
13251,Screven County,2021-04-22,18,4310,30.8
13251,Screven County,2021-04-23,19,4329,30.9
13251,Screven County,2021-04-24,18,4347,31.1
13251,Screven County,2021-04-25,1,4348,31.1
13251,Screven County,2021-04-26,20,4368,31.2
13251,Screven County,2021-04-27,20,4388,31.4
13251,Screven County,2021-04-28,18,4406,31.5
13251,Screven County,2021-04-29,9,4415,31.6
13251,Screven County,2021-04-30,26,4441,31.7
13251,Screven County,2021-05-01,3,4444,31.8
13251,Screven County,2021-05-02,1,4445,31.8
13251,Screven County,2021-05-03,14,4459,31.9
13251,Screven County,2021-05-04,29,4488,32.1
13251,Screven County,2021-05-05,29,4517,32.3
13251,Screven County,2021-05-06,17,4534,32.4
13251,Screven County,2021-05-07,25,4559,32.6
13251,Screven County,2021-05-08,6,4565,32.6
13251,Screven County,2021-05-10,10,4575,32.7
13251,Screven County,2021-05-11,23,4598,32.9
13251,Screven County,2021-05-12,10,4608,32.9
13251,Screven County,2021-05-13,20,4628,33.1
13251,Screven County,2021-05-14,19,4647,33.2
13251,Screven County,2021-05-15,4,4651,33.2
13251,Screven County,2021-05-16,3,4654,33.3
13251,Screven County,2021-05-17,30,4684,33.5
13251,Screven County,2021-05-18,19,4703,33.6
13251,Screven County,2021-05-19,15,4718,33.7
13251,Screven County,2021-05-20,21,4739,33.9
13251,Screven County,2021-05-21,15,4754,34
13251,Screven County,2021-05-22,7,4761,34
13251,Screven County,2021-05-23,2,4763,34
13251,Screven County,2021-05-24,13,4776,34.1
13251,Screven County,2021-05-25,13,4789,34.2
13251,Screven County,2021-05-26,27,4816,34.4
13251,Screven County,2021-05-27,10,4826,34.5
13251,Screven County,2021-05-28,14,4840,34.6
13251,Screven County,2021-05-29,1,4841,34.6
13251,Screven County,2021-05-30,3,4844,34.6
13251,Screven County,2021-05-31,3,4847,34.6
13251,Screven County,2021-06-01,10,4857,34.7
13251,Screven County,2021-06-02,17,4874,34.8
13251,Screven County,2021-06-03,10,4884,34.9
13251,Screven County,2021-06-04,21,4905,35.1
13251,Screven County,2021-06-05,1,4906,35.1
13251,Screven County,2021-06-06,1,4907,35.1
13251,Screven County,2021-06-07,8,4915,35.1
13251,Screven County,2021-06-08,9,4924,35.2
13251,Screven County,2021-06-09,9,4933,35.3
13251,Screven County,2021-06-10,10,4943,35.3
13251,Screven County,2021-06-11,20,4963,35.5
13251,Screven County,2021-06-12,8,4971,35.5
13251,Screven County,2021-06-13,1,4972,35.5
13251,Screven County,2021-06-14,8,4980,35.6
13251,Screven County,2021-06-15,9,4989,35.7
13251,Screven County,2021-06-16,5,4994,35.7
13251,Screven County,2021-06-17,14,5008,35.8
13251,Screven County,2021-06-18,12,5020,35.9
13251,Screven County,2021-06-19,2,5022,35.9
13251,Screven County,2021-06-20,1,5023,35.9
13251,Screven County,2021-06-21,12,5035,36
13251,Screven County,2021-06-22,13,5048,36.1
13251,Screven County,2021-06-23,10,5058,36.2
13251,Screven County,2021-06-24,9,5067,36.2
13251,Screven County,2021-06-25,12,5079,36.3
13251,Screven County,2021-06-26,4,5083,36.3
13251,Screven County,2021-06-28,5,5088,36.4
13251,Screven County,2021-06-29,5,5093,36.4
13251,Screven County,2021-06-30,7,5100,36.5
13251,Screven County,2021-07-01,7,5107,36.5
13251,Screven County,2021-07-02,2,5109,36.5
13251,Screven County,2021-07-03,6,5115,36.6
13251,Screven County,2021-07-05,2,5117,36.6
13251,Screven County,2021-07-06,11,5128,36.7
13251,Screven County,2021-07-07,7,5135,36.7
13251,Screven County,2021-07-08,11,5146,36.8
13251,Screven County,2021-07-09,9,5155,36.9
13251,Screven County,2021-07-10,8,5163,36.9
13251,Screven County,2021-07-11,1,5164,36.9
13251,Screven County,2021-07-12,9,5173,37
13251,Screven County,2021-07-13,6,5179,37
13251,Screven County,2021-07-14,14,5193,37.1
13251,Screven County,2021-07-15,9,5202,37.2
13251,Screven County,2021-07-16,8,5210,37.2
13251,Screven County,2021-07-17,28,5238,37.4
13251,Screven County,2021-07-18,2,5240,37.5
13251,Screven County,2021-07-19,7,5247,37.5
13251,Screven County,2021-07-20,26,5273,37.7
13251,Screven County,2021-07-21,26,5299,37.9
13251,Screven County,2021-07-22,14,5313,38
13251,Screven County,2021-07-23,25,5338,38.2
13251,Screven County,2021-07-24,9,5347,38.2
13251,Screven County,2021-07-25,3,5350,38.2
13251,Screven County,2021-07-26,19,5369,38.4
13251,Screven County,2021-07-27,53,5422,38.8
13251,Screven County,2021-07-28,49,5471,39.1
13251,Screven County,2021-07-29,31,5502,39.3
13251,Screven County,2021-07-30,25,5527,39.5
13251,Screven County,2021-07-31,8,5535,39.6
13251,Screven County,2021-08-01,6,5541,39.6
13251,Screven County,2021-08-02,30,5571,39.8
13251,Screven County,2021-08-03,45,5616,40.1
13251,Screven County,2021-08-04,36,5652,40.4
13251,Screven County,2021-08-05,38,5690,40.7
13251,Screven County,2021-08-06,51,5741,41
13251,Screven County,2021-08-07,20,5761,41.2
13251,Screven County,2021-08-08,6,5767,41.2
13251,Screven County,2021-08-09,44,5811,41.5
13251,Screven County,2021-08-10,44,5855,41.9
13251,Screven County,2021-08-11,33,5888,42.1
13251,Screven County,2021-08-12,35,5923,42.3
13251,Screven County,2021-08-13,37,5960,42.6
13251,Screven County,2021-08-14,46,6006,42.9
13251,Screven County,2021-08-15,8,6014,43
13251,Screven County,2021-08-16,49,6063,43.3
13251,Screven County,2021-08-17,75,6138,43.9
13251,Screven County,2021-08-18,46,6184,44.2
13251,Screven County,2021-08-19,46,6230,44.5
13251,Screven County,2021-08-20,54,6284,44.9
13251,Screven County,2021-08-21,11,6295,45
13251,Screven County,2021-08-22,2,6297,45
13251,Screven County,2021-08-23,23,6320,45.2
13251,Screven County,2021-08-24,36,6356,45.4
13251,Screven County,2021-08-25,31,6387,45.7
13251,Screven County,2021-08-26,48,6435,46
13251,Screven County,2021-08-27,70,6505,46.5
13251,Screven County,2021-08-28,18,6523,46.6
13251,Screven County,2021-08-29,4,6527,46.7
13251,Screven County,2021-08-30,48,6575,47
13251,Screven County,2021-08-31,51,6626,47.4
13251,Screven County,2021-09-01,36,6662,47.6
13251,Screven County,2021-09-02,38,6700,47.9
13251,Screven County,2021-09-03,42,6742,48.2
13251,Screven County,2021-09-04,10,6752,48.3
13251,Screven County,2021-09-05,6,6758,48.3
13251,Screven County,2021-09-06,4,6762,48.3
13251,Screven County,2021-09-07,30,6792,48.6
13251,Screven County,2021-09-08,22,6814,48.7
13251,Screven County,2021-09-09,16,6830,48.8
13251,Screven County,2021-09-10,27,6857,49
13251,Screven County,2021-09-11,9,6866,49.1
13251,Screven County,2021-09-12,4,6870,49.1
13251,Screven County,2021-09-13,12,6882,49.2
13251,Screven County,2021-09-14,30,6912,49.4
13251,Screven County,2021-09-15,10,6922,49.5
13251,Screven County,2021-09-16,15,6937,49.6
13251,Screven County,2021-09-17,20,6957,49.7
13251,Screven County,2021-09-18,11,6968,49.8
13251,Screven County,2021-09-19,5,6973,49.8
13251,Screven County,2021-09-20,13,6986,49.9
13251,Screven County,2021-09-21,22,7008,50.1
13251,Screven County,2021-09-22,9,7017,50.2
13251,Screven County,2021-09-23,15,7032,50.3
13251,Screven County,2021-09-24,11,7043,50.3
13251,Screven County,2021-09-25,3,7046,50.4
13251,Screven County,2021-09-27,8,7054,50.4
13251,Screven County,2021-09-28,5,7059,50.5
13251,Screven County,2021-09-29,13,7072,50.6
13251,Screven County,2021-09-30,6,7078,50.6
13251,Screven County,2021-10-01,3,7081,50.6
13251,Screven County,2021-10-02,2,7083,50.6
13251,Screven County,2021-10-04,1,7084,50.6
13251,Screven County,2021-10-05,4,7088,50.7
13251,Screven County,2021-10-06,6,7094,50.7
13251,Screven County,2021-10-07,3,7097,50.7
13253,Seminole County,2020-12-16,1,1,0
13253,Seminole County,2020-12-18,1,2,0
13253,Seminole County,2020-12-19,1,3,0
13253,Seminole County,2020-12-21,1,4,0
13253,Seminole County,2020-12-22,19,23,0.3
13253,Seminole County,2020-12-23,9,32,0.4
13253,Seminole County,2020-12-24,1,33,0.4
13253,Seminole County,2020-12-27,2,35,0.4
13253,Seminole County,2020-12-28,14,49,0.6
13253,Seminole County,2020-12-29,28,77,0.9
13253,Seminole County,2020-12-30,22,99,1.2
13253,Seminole County,2020-12-31,4,103,1.2
13253,Seminole County,2021-01-04,15,118,1.4
13253,Seminole County,2021-01-05,18,136,1.6
13253,Seminole County,2021-01-06,55,191,2.3
13253,Seminole County,2021-01-07,47,238,2.9
13253,Seminole County,2021-01-08,12,250,3
13253,Seminole County,2021-01-10,1,251,3
13253,Seminole County,2021-01-11,64,315,3.8
13253,Seminole County,2021-01-12,52,367,4.4
13253,Seminole County,2021-01-13,48,415,5
13253,Seminole County,2021-01-14,65,480,5.8
13253,Seminole County,2021-01-15,52,532,6.4
13253,Seminole County,2021-01-16,2,534,6.4
13253,Seminole County,2021-01-17,1,535,6.4
13253,Seminole County,2021-01-18,47,582,7
13253,Seminole County,2021-01-19,71,653,7.8
13253,Seminole County,2021-01-20,35,688,8.3
13253,Seminole County,2021-01-21,50,738,8.9
13253,Seminole County,2021-01-22,46,784,9.4
13253,Seminole County,2021-01-23,1,785,9.4
13253,Seminole County,2021-01-25,46,831,10
13253,Seminole County,2021-01-26,45,876,10.5
13253,Seminole County,2021-01-27,42,918,11
13253,Seminole County,2021-01-28,43,961,11.5
13253,Seminole County,2021-01-29,33,994,11.9
13253,Seminole County,2021-02-01,47,1041,12.5
13253,Seminole County,2021-02-02,50,1091,13.1
13253,Seminole County,2021-02-03,39,1130,13.6
13253,Seminole County,2021-02-04,32,1162,14
13253,Seminole County,2021-02-05,29,1191,14.3
13253,Seminole County,2021-02-08,11,1202,14.4
13253,Seminole County,2021-02-09,41,1243,14.9
13253,Seminole County,2021-02-10,23,1266,15.2
13253,Seminole County,2021-02-11,7,1273,15.3
13253,Seminole County,2021-02-12,4,1277,15.3
13253,Seminole County,2021-02-15,14,1291,15.5
13253,Seminole County,2021-02-16,29,1320,15.9
13253,Seminole County,2021-02-17,16,1336,16.1
13253,Seminole County,2021-02-18,13,1349,16.2
13253,Seminole County,2021-02-19,7,1356,16.3
13253,Seminole County,2021-02-22,7,1363,16.4
13253,Seminole County,2021-02-23,11,1374,16.5
13253,Seminole County,2021-02-24,14,1388,16.7
13253,Seminole County,2021-02-25,19,1407,16.9
13253,Seminole County,2021-02-26,11,1418,17
13253,Seminole County,2021-02-27,2,1420,17.1
13253,Seminole County,2021-03-01,28,1448,17.4
13253,Seminole County,2021-03-02,15,1463,17.6
13253,Seminole County,2021-03-03,18,1481,17.8
13253,Seminole County,2021-03-04,13,1494,18
13253,Seminole County,2021-03-05,5,1499,18
13253,Seminole County,2021-03-07,1,1500,18
13253,Seminole County,2021-03-08,22,1522,18.3
13253,Seminole County,2021-03-09,20,1542,18.5
13253,Seminole County,2021-03-10,47,1589,19.1
13253,Seminole County,2021-03-11,32,1621,19.5
13253,Seminole County,2021-03-12,48,1669,20.1
13253,Seminole County,2021-03-14,7,1676,20.1
13253,Seminole County,2021-03-15,53,1729,20.8
13253,Seminole County,2021-03-16,42,1771,21.3
13253,Seminole County,2021-03-17,38,1809,21.7
13253,Seminole County,2021-03-18,34,1843,22.1
13253,Seminole County,2021-03-19,13,1856,22.3
13253,Seminole County,2021-03-20,3,1859,22.3
13253,Seminole County,2021-03-21,5,1864,22.4
13253,Seminole County,2021-03-22,47,1911,23
13253,Seminole County,2021-03-23,16,1927,23.2
13253,Seminole County,2021-03-24,41,1968,23.7
13253,Seminole County,2021-03-25,45,2013,24.2
13253,Seminole County,2021-03-26,6,2019,24.3
13253,Seminole County,2021-03-28,9,2028,24.4
13253,Seminole County,2021-03-29,22,2050,24.6
13253,Seminole County,2021-03-30,18,2068,24.9
13253,Seminole County,2021-03-31,61,2129,25.6
13253,Seminole County,2021-04-01,18,2147,25.8
13253,Seminole County,2021-04-02,6,2153,25.9
13253,Seminole County,2021-04-03,3,2156,25.9
13253,Seminole County,2021-04-04,6,2162,26
13253,Seminole County,2021-04-05,22,2184,26.2
13253,Seminole County,2021-04-06,28,2212,26.6
13253,Seminole County,2021-04-07,24,2236,26.9
13253,Seminole County,2021-04-08,11,2247,27
13253,Seminole County,2021-04-09,7,2254,27.1
13253,Seminole County,2021-04-10,3,2257,27.1
13253,Seminole County,2021-04-11,7,2264,27.2
13253,Seminole County,2021-04-12,22,2286,27.5
13253,Seminole County,2021-04-13,10,2296,27.6
13253,Seminole County,2021-04-14,29,2325,27.9
13253,Seminole County,2021-04-15,14,2339,28.1
13253,Seminole County,2021-04-16,4,2343,28.2
13253,Seminole County,2021-04-19,12,2355,28.3
13253,Seminole County,2021-04-20,10,2365,28.4
13253,Seminole County,2021-04-21,18,2383,28.6
13253,Seminole County,2021-04-22,15,2398,28.8
13253,Seminole County,2021-04-23,11,2409,29
13253,Seminole County,2021-04-26,16,2425,29.1
13253,Seminole County,2021-04-27,8,2433,29.2
13253,Seminole County,2021-04-28,20,2453,29.5
13253,Seminole County,2021-04-29,5,2458,29.5
13253,Seminole County,2021-04-30,6,2464,29.6
13253,Seminole County,2021-05-02,1,2465,29.6
13253,Seminole County,2021-05-03,10,2475,29.7
13253,Seminole County,2021-05-04,4,2479,29.8
13253,Seminole County,2021-05-05,18,2497,30
13253,Seminole County,2021-05-06,9,2506,30.1
13253,Seminole County,2021-05-07,11,2517,30.2
13253,Seminole County,2021-05-08,5,2522,30.3
13253,Seminole County,2021-05-10,9,2531,30.4
13253,Seminole County,2021-05-11,5,2536,30.5
13253,Seminole County,2021-05-12,4,2540,30.5
13253,Seminole County,2021-05-13,6,2546,30.6
13253,Seminole County,2021-05-14,6,2552,30.7
13253,Seminole County,2021-05-15,3,2555,30.7
13253,Seminole County,2021-05-16,2,2557,30.7
13253,Seminole County,2021-05-17,9,2566,30.8
13253,Seminole County,2021-05-18,11,2577,31
13253,Seminole County,2021-05-19,9,2586,31.1
13253,Seminole County,2021-05-20,8,2594,31.2
13253,Seminole County,2021-05-21,6,2600,31.2
13253,Seminole County,2021-05-22,5,2605,31.3
13253,Seminole County,2021-05-23,2,2607,31.3
13253,Seminole County,2021-05-24,6,2613,31.4
13253,Seminole County,2021-05-25,10,2623,31.5
13253,Seminole County,2021-05-26,12,2635,31.7
13253,Seminole County,2021-05-28,3,2638,31.7
13253,Seminole County,2021-05-29,1,2639,31.7
13253,Seminole County,2021-06-01,8,2647,31.8
13253,Seminole County,2021-06-02,8,2655,31.9
13253,Seminole County,2021-06-03,2,2657,31.9
13253,Seminole County,2021-06-04,5,2662,32
13253,Seminole County,2021-06-05,3,2665,32
13253,Seminole County,2021-06-06,2,2667,32.1
13253,Seminole County,2021-06-07,6,2673,32.1
13253,Seminole County,2021-06-08,1,2674,32.1
13253,Seminole County,2021-06-09,5,2679,32.2
13253,Seminole County,2021-06-10,51,2730,32.8
13253,Seminole County,2021-06-11,2,2732,32.8
13253,Seminole County,2021-06-12,2,2734,32.9
13253,Seminole County,2021-06-14,5,2739,32.9
13253,Seminole County,2021-06-15,2,2741,32.9
13253,Seminole County,2021-06-16,6,2747,33
13253,Seminole County,2021-06-17,11,2758,33.1
13253,Seminole County,2021-06-21,6,2764,33.2
13253,Seminole County,2021-06-22,4,2768,33.3
13253,Seminole County,2021-06-23,5,2773,33.3
13253,Seminole County,2021-06-24,2,2775,33.3
13253,Seminole County,2021-06-25,2,2777,33.4
13253,Seminole County,2021-06-26,1,2778,33.4
13253,Seminole County,2021-06-28,3,2781,33.4
13253,Seminole County,2021-06-29,3,2784,33.5
13253,Seminole County,2021-06-30,13,2797,33.6
13253,Seminole County,2021-07-01,4,2801,33.7
13253,Seminole County,2021-07-02,2,2803,33.7
13253,Seminole County,2021-07-03,1,2804,33.7
13253,Seminole County,2021-07-05,4,2808,33.7
13253,Seminole County,2021-07-06,4,2812,33.8
13253,Seminole County,2021-07-07,6,2818,33.9
13253,Seminole County,2021-07-08,4,2822,33.9
13253,Seminole County,2021-07-09,8,2830,34
13253,Seminole County,2021-07-10,3,2833,34
13253,Seminole County,2021-07-11,3,2836,34.1
13253,Seminole County,2021-07-12,5,2841,34.1
13253,Seminole County,2021-07-13,5,2846,34.2
13253,Seminole County,2021-07-14,10,2856,34.3
13253,Seminole County,2021-07-15,7,2863,34.4
13253,Seminole County,2021-07-16,2,2865,34.4
13253,Seminole County,2021-07-17,5,2870,34.5
13253,Seminole County,2021-07-19,21,2891,34.7
13253,Seminole County,2021-07-20,3,2894,34.8
13253,Seminole County,2021-07-21,16,2910,35
13253,Seminole County,2021-07-22,9,2919,35.1
13253,Seminole County,2021-07-23,19,2938,35.3
13253,Seminole County,2021-07-24,4,2942,35.4
13253,Seminole County,2021-07-25,5,2947,35.4
13253,Seminole County,2021-07-26,30,2977,35.8
13253,Seminole County,2021-07-27,13,2990,35.9
13253,Seminole County,2021-07-28,41,3031,36.4
13253,Seminole County,2021-07-29,18,3049,36.6
13253,Seminole County,2021-07-30,18,3067,36.9
13253,Seminole County,2021-07-31,9,3076,37
13253,Seminole County,2021-08-01,7,3083,37.1
13253,Seminole County,2021-08-02,44,3127,37.6
13253,Seminole County,2021-08-03,18,3145,37.8
13253,Seminole County,2021-08-04,44,3189,38.3
13253,Seminole County,2021-08-05,12,3201,38.5
13253,Seminole County,2021-08-06,19,3220,38.7
13253,Seminole County,2021-08-07,8,3228,38.8
13253,Seminole County,2021-08-08,4,3232,38.8
13253,Seminole County,2021-08-09,53,3285,39.5
13253,Seminole County,2021-08-10,17,3302,39.7
13253,Seminole County,2021-08-11,35,3337,40.1
13253,Seminole County,2021-08-12,24,3361,40.4
13253,Seminole County,2021-08-13,37,3398,40.8
13253,Seminole County,2021-08-14,9,3407,40.9
13253,Seminole County,2021-08-15,4,3411,41
13253,Seminole County,2021-08-16,32,3443,41.4
13253,Seminole County,2021-08-17,21,3464,41.6
13253,Seminole County,2021-08-18,44,3508,42.2
13253,Seminole County,2021-08-19,17,3525,42.4
13253,Seminole County,2021-08-20,10,3535,42.5
13253,Seminole County,2021-08-21,10,3545,42.6
13253,Seminole County,2021-08-22,10,3555,42.7
13253,Seminole County,2021-08-23,30,3585,43.1
13253,Seminole County,2021-08-24,31,3616,43.5
13253,Seminole County,2021-08-25,18,3634,43.7
13253,Seminole County,2021-08-26,36,3670,44.1
13253,Seminole County,2021-08-27,20,3690,44.3
13253,Seminole County,2021-08-28,9,3699,44.5
13253,Seminole County,2021-08-29,4,3703,44.5
13253,Seminole County,2021-08-30,25,3728,44.8
13253,Seminole County,2021-08-31,17,3745,45
13253,Seminole County,2021-09-01,31,3776,45.4
13253,Seminole County,2021-09-02,10,3786,45.5
13253,Seminole County,2021-09-03,11,3797,45.6
13253,Seminole County,2021-09-04,8,3805,45.7
13253,Seminole County,2021-09-05,6,3811,45.8
13253,Seminole County,2021-09-06,1,3812,45.8
13253,Seminole County,2021-09-07,8,3820,45.9
13253,Seminole County,2021-09-08,29,3849,46.3
13253,Seminole County,2021-09-09,14,3863,46.4
13253,Seminole County,2021-09-10,11,3874,46.6
13253,Seminole County,2021-09-11,4,3878,46.6
13253,Seminole County,2021-09-12,6,3884,46.7
13253,Seminole County,2021-09-13,12,3896,46.8
13253,Seminole County,2021-09-14,20,3916,47.1
13253,Seminole County,2021-09-15,13,3929,47.2
13253,Seminole County,2021-09-16,2,3931,47.2
13253,Seminole County,2021-09-17,6,3937,47.3
13253,Seminole County,2021-09-18,3,3940,47.4
13253,Seminole County,2021-09-19,1,3941,47.4
13253,Seminole County,2021-09-20,10,3951,47.5
13253,Seminole County,2021-09-21,5,3956,47.5
13253,Seminole County,2021-09-22,14,3970,47.7
13253,Seminole County,2021-09-23,6,3976,47.8
13253,Seminole County,2021-09-24,5,3981,47.8
13253,Seminole County,2021-09-25,2,3983,47.9
13253,Seminole County,2021-09-26,1,3984,47.9
13253,Seminole County,2021-09-27,8,3992,48
13253,Seminole County,2021-09-28,3,3995,48
13253,Seminole County,2021-09-29,6,4001,48.1
13253,Seminole County,2021-09-30,2,4003,48.1
13253,Seminole County,2021-10-01,5,4008,48.2
13253,Seminole County,2021-10-02,1,4009,48.2
13253,Seminole County,2021-10-04,1,4010,48.2
13253,Seminole County,2021-10-05,1,4011,48.2
13253,Seminole County,2021-10-06,2,4013,48.2
13253,Seminole County,2021-10-07,6,4019,48.3
13255,Spalding County,2020-12-17,1,1,0
13255,Spalding County,2020-12-18,7,8,0
13255,Spalding County,2020-12-19,62,70,0.1
13255,Spalding County,2020-12-20,3,73,0.1
13255,Spalding County,2020-12-21,23,96,0.1
13255,Spalding County,2020-12-22,29,125,0.2
13255,Spalding County,2020-12-23,59,184,0.3
13255,Spalding County,2020-12-24,5,189,0.3
13255,Spalding County,2020-12-26,1,190,0.3
13255,Spalding County,2020-12-27,4,194,0.3
13255,Spalding County,2020-12-28,60,254,0.4
13255,Spalding County,2020-12-29,80,334,0.5
13255,Spalding County,2020-12-30,56,390,0.6
13255,Spalding County,2020-12-31,46,436,0.7
13255,Spalding County,2021-01-01,30,466,0.7
13255,Spalding County,2021-01-03,51,517,0.8
13255,Spalding County,2021-01-04,44,561,0.9
13255,Spalding County,2021-01-05,40,601,0.9
13255,Spalding County,2021-01-06,40,641,1
13255,Spalding County,2021-01-07,53,694,1.1
13255,Spalding County,2021-01-08,44,738,1.1
13255,Spalding County,2021-01-09,77,815,1.2
13255,Spalding County,2021-01-10,65,880,1.3
13255,Spalding County,2021-01-11,64,944,1.4
13255,Spalding County,2021-01-12,170,1114,1.7
13255,Spalding County,2021-01-13,114,1228,1.9
13255,Spalding County,2021-01-14,185,1413,2.2
13255,Spalding County,2021-01-15,644,2057,3.1
13255,Spalding County,2021-01-16,85,2142,3.3
13255,Spalding County,2021-01-17,56,2198,3.4
13255,Spalding County,2021-01-18,131,2329,3.6
13255,Spalding County,2021-01-19,141,2470,3.8
13255,Spalding County,2021-01-20,183,2653,4.1
13255,Spalding County,2021-01-21,225,2878,4.4
13255,Spalding County,2021-01-22,307,3185,4.9
13255,Spalding County,2021-01-23,49,3234,5
13255,Spalding County,2021-01-24,60,3294,5
13255,Spalding County,2021-01-25,128,3422,5.2
13255,Spalding County,2021-01-26,94,3516,5.4
13255,Spalding County,2021-01-27,233,3749,5.7
13255,Spalding County,2021-01-28,207,3956,6.1
13255,Spalding County,2021-01-29,161,4117,6.3
13255,Spalding County,2021-01-30,40,4157,6.4
13255,Spalding County,2021-01-31,8,4165,6.4
13255,Spalding County,2021-02-01,112,4277,6.5
13255,Spalding County,2021-02-02,125,4402,6.7
13255,Spalding County,2021-02-03,105,4507,6.9
13255,Spalding County,2021-02-04,142,4649,7.1
13255,Spalding County,2021-02-05,77,4726,7.2
13255,Spalding County,2021-02-06,33,4759,7.3
13255,Spalding County,2021-02-07,14,4773,7.3
13255,Spalding County,2021-02-08,28,4801,7.4
13255,Spalding County,2021-02-09,76,4877,7.5
13255,Spalding County,2021-02-10,71,4948,7.6
13255,Spalding County,2021-02-11,82,5030,7.7
13255,Spalding County,2021-02-12,145,5175,7.9
13255,Spalding County,2021-02-13,13,5188,7.9
13255,Spalding County,2021-02-14,10,5198,8
13255,Spalding County,2021-02-15,35,5233,8
13255,Spalding County,2021-02-16,116,5349,8.2
13255,Spalding County,2021-02-17,103,5452,8.3
13255,Spalding County,2021-02-18,87,5539,8.5
13255,Spalding County,2021-02-19,278,5817,8.9
13255,Spalding County,2021-02-20,14,5831,8.9
13255,Spalding County,2021-02-21,9,5840,8.9
13255,Spalding County,2021-02-22,36,5876,9
13255,Spalding County,2021-02-23,188,6064,9.3
13255,Spalding County,2021-02-24,141,6205,9.5
13255,Spalding County,2021-02-25,145,6350,9.7
13255,Spalding County,2021-02-26,278,6628,10.1
13255,Spalding County,2021-02-27,44,6672,10.2
13255,Spalding County,2021-02-28,42,6714,10.3
13255,Spalding County,2021-03-01,111,6825,10.5
13255,Spalding County,2021-03-02,213,7038,10.8
13255,Spalding County,2021-03-03,234,7272,11.1
13255,Spalding County,2021-03-04,244,7516,11.5
13255,Spalding County,2021-03-05,354,7870,12.1
13255,Spalding County,2021-03-06,38,7908,12.1
13255,Spalding County,2021-03-07,34,7942,12.2
13255,Spalding County,2021-03-08,139,8081,12.4
13255,Spalding County,2021-03-09,236,8317,12.7
13255,Spalding County,2021-03-10,265,8582,13.1
13255,Spalding County,2021-03-11,313,8895,13.6
13255,Spalding County,2021-03-12,502,9397,14.4
13255,Spalding County,2021-03-13,68,9465,14.5
13255,Spalding County,2021-03-14,44,9509,14.6
13255,Spalding County,2021-03-15,186,9695,14.8
13255,Spalding County,2021-03-16,301,9996,15.3
13255,Spalding County,2021-03-17,224,10220,15.6
13255,Spalding County,2021-03-18,311,10531,16.1
13255,Spalding County,2021-03-19,475,11006,16.9
13255,Spalding County,2021-03-20,70,11076,17
13255,Spalding County,2021-03-21,66,11142,17.1
13255,Spalding County,2021-03-22,127,11269,17.3
13255,Spalding County,2021-03-23,212,11481,17.6
13255,Spalding County,2021-03-24,220,11701,17.9
13255,Spalding County,2021-03-25,440,12141,18.6
13255,Spalding County,2021-03-26,208,12349,18.9
13255,Spalding County,2021-03-27,66,12415,19
13255,Spalding County,2021-03-28,71,12486,19.1
13255,Spalding County,2021-03-29,170,12656,19.4
13255,Spalding County,2021-03-30,265,12921,19.8
13255,Spalding County,2021-03-31,227,13148,20.1
13255,Spalding County,2021-04-01,360,13508,20.7
13255,Spalding County,2021-04-02,209,13717,21
13255,Spalding County,2021-04-03,71,13788,21.1
13255,Spalding County,2021-04-04,80,13868,21.2
13255,Spalding County,2021-04-05,155,14023,21.5
13255,Spalding County,2021-04-06,458,14481,22.2
13255,Spalding County,2021-04-07,337,14818,22.7
13255,Spalding County,2021-04-08,337,15155,23.2
13255,Spalding County,2021-04-09,253,15408,23.6
13255,Spalding County,2021-04-10,118,15526,23.8
13255,Spalding County,2021-04-11,105,15631,23.9
13255,Spalding County,2021-04-12,184,15815,24.2
13255,Spalding County,2021-04-13,192,16007,24.5
13255,Spalding County,2021-04-14,156,16163,24.7
13255,Spalding County,2021-04-15,213,16376,25.1
13255,Spalding County,2021-04-16,154,16530,25.3
13255,Spalding County,2021-04-17,39,16569,25.4
13255,Spalding County,2021-04-18,44,16613,25.4
13255,Spalding County,2021-04-19,69,16682,25.5
13255,Spalding County,2021-04-20,121,16803,25.7
13255,Spalding County,2021-04-21,170,16973,26
13255,Spalding County,2021-04-22,149,17122,26.2
13255,Spalding County,2021-04-23,351,17473,26.8
13255,Spalding County,2021-04-24,58,17531,26.8
13255,Spalding County,2021-04-25,37,17568,26.9
13255,Spalding County,2021-04-26,84,17652,27
13255,Spalding County,2021-04-27,112,17764,27.2
13255,Spalding County,2021-04-28,104,17868,27.4
13255,Spalding County,2021-04-29,143,18011,27.6
13255,Spalding County,2021-04-30,229,18240,27.9
13255,Spalding County,2021-05-01,72,18312,28
13255,Spalding County,2021-05-02,35,18347,28.1
13255,Spalding County,2021-05-03,48,18395,28.2
13255,Spalding County,2021-05-04,132,18527,28.4
13255,Spalding County,2021-05-05,79,18606,28.5
13255,Spalding County,2021-05-06,112,18718,28.7
13255,Spalding County,2021-05-07,108,18826,28.8
13255,Spalding County,2021-05-08,69,18895,28.9
13255,Spalding County,2021-05-09,16,18911,29
13255,Spalding County,2021-05-10,34,18945,29
13255,Spalding County,2021-05-11,104,19049,29.2
13255,Spalding County,2021-05-12,97,19146,29.3
13255,Spalding County,2021-05-13,91,19237,29.5
13255,Spalding County,2021-05-14,134,19371,29.7
13255,Spalding County,2021-05-15,80,19451,29.8
13255,Spalding County,2021-05-16,47,19498,29.9
13255,Spalding County,2021-05-17,67,19565,30
13255,Spalding County,2021-05-18,154,19719,30.2
13255,Spalding County,2021-05-19,71,19790,30.3
13255,Spalding County,2021-05-20,105,19895,30.5
13255,Spalding County,2021-05-21,103,19998,30.6
13255,Spalding County,2021-05-22,67,20065,30.7
13255,Spalding County,2021-05-23,29,20094,30.8
13255,Spalding County,2021-05-24,51,20145,30.8
13255,Spalding County,2021-05-25,69,20214,31
13255,Spalding County,2021-05-26,64,20278,31.1
13255,Spalding County,2021-05-27,68,20346,31.2
13255,Spalding County,2021-05-28,64,20410,31.3
13255,Spalding County,2021-05-29,42,20452,31.3
13255,Spalding County,2021-05-30,16,20468,31.3
13255,Spalding County,2021-05-31,8,20476,31.4
13255,Spalding County,2021-06-01,61,20537,31.4
13255,Spalding County,2021-06-02,40,20577,31.5
13255,Spalding County,2021-06-03,65,20642,31.6
13255,Spalding County,2021-06-04,72,20714,31.7
13255,Spalding County,2021-06-05,34,20748,31.8
13255,Spalding County,2021-06-06,19,20767,31.8
13255,Spalding County,2021-06-07,40,20807,31.9
13255,Spalding County,2021-06-08,42,20849,31.9
13255,Spalding County,2021-06-09,39,20888,32
13255,Spalding County,2021-06-10,58,20946,32.1
13255,Spalding County,2021-06-11,53,20999,32.2
13255,Spalding County,2021-06-12,42,21041,32.2
13255,Spalding County,2021-06-13,6,21047,32.2
13255,Spalding County,2021-06-14,46,21093,32.3
13255,Spalding County,2021-06-15,40,21133,32.4
13255,Spalding County,2021-06-16,39,21172,32.4
13255,Spalding County,2021-06-17,51,21223,32.5
13255,Spalding County,2021-06-18,45,21268,32.6
13255,Spalding County,2021-06-19,24,21292,32.6
13255,Spalding County,2021-06-20,11,21303,32.6
13255,Spalding County,2021-06-21,35,21338,32.7
13255,Spalding County,2021-06-22,42,21380,32.7
13255,Spalding County,2021-06-23,30,21410,32.8
13255,Spalding County,2021-06-24,30,21440,32.8
13255,Spalding County,2021-06-25,48,21488,32.9
13255,Spalding County,2021-06-26,29,21517,32.9
13255,Spalding County,2021-06-27,18,21535,33
13255,Spalding County,2021-06-28,31,21566,33
13255,Spalding County,2021-06-29,53,21619,33.1
13255,Spalding County,2021-06-30,36,21655,33.2
13255,Spalding County,2021-07-01,35,21690,33.2
13255,Spalding County,2021-07-02,33,21723,33.3
13255,Spalding County,2021-07-03,33,21756,33.3
13255,Spalding County,2021-07-05,27,21783,33.4
13255,Spalding County,2021-07-06,22,21805,33.4
13255,Spalding County,2021-07-07,32,21837,33.4
13255,Spalding County,2021-07-08,31,21868,33.5
13255,Spalding County,2021-07-09,36,21904,33.5
13255,Spalding County,2021-07-10,24,21928,33.6
13255,Spalding County,2021-07-11,19,21947,33.6
13255,Spalding County,2021-07-12,37,21984,33.7
13255,Spalding County,2021-07-13,38,22022,33.7
13255,Spalding County,2021-07-14,35,22057,33.8
13255,Spalding County,2021-07-15,52,22109,33.9
13255,Spalding County,2021-07-16,36,22145,33.9
13255,Spalding County,2021-07-17,35,22180,34
13255,Spalding County,2021-07-18,22,22202,34
13255,Spalding County,2021-07-19,54,22256,34.1
13255,Spalding County,2021-07-20,49,22305,34.2
13255,Spalding County,2021-07-21,57,22362,34.2
13255,Spalding County,2021-07-22,84,22446,34.4
13255,Spalding County,2021-07-23,103,22549,34.5
13255,Spalding County,2021-07-24,57,22606,34.6
13255,Spalding County,2021-07-25,34,22640,34.7
13255,Spalding County,2021-07-26,92,22732,34.8
13255,Spalding County,2021-07-27,105,22837,35
13255,Spalding County,2021-07-28,74,22911,35.1
13255,Spalding County,2021-07-29,105,23016,35.2
13255,Spalding County,2021-07-30,117,23133,35.4
13255,Spalding County,2021-07-31,55,23188,35.5
13255,Spalding County,2021-08-01,81,23269,35.6
13255,Spalding County,2021-08-02,102,23371,35.8
13255,Spalding County,2021-08-03,112,23483,36
13255,Spalding County,2021-08-04,113,23596,36.1
13255,Spalding County,2021-08-05,89,23685,36.3
13255,Spalding County,2021-08-06,116,23801,36.4
13255,Spalding County,2021-08-07,83,23884,36.6
13255,Spalding County,2021-08-08,55,23939,36.7
13255,Spalding County,2021-08-09,141,24080,36.9
13255,Spalding County,2021-08-10,153,24233,37.1
13255,Spalding County,2021-08-11,110,24343,37.3
13255,Spalding County,2021-08-12,121,24464,37.5
13255,Spalding County,2021-08-13,150,24614,37.7
13255,Spalding County,2021-08-14,74,24688,37.8
13255,Spalding County,2021-08-15,41,24729,37.9
13255,Spalding County,2021-08-16,89,24818,38
13255,Spalding County,2021-08-17,135,24953,38.2
13255,Spalding County,2021-08-18,104,25057,38.4
13255,Spalding County,2021-08-19,119,25176,38.6
13255,Spalding County,2021-08-20,116,25292,38.7
13255,Spalding County,2021-08-21,59,25351,38.8
13255,Spalding County,2021-08-22,38,25389,38.9
13255,Spalding County,2021-08-23,92,25481,39
13255,Spalding County,2021-08-24,78,25559,39.1
13255,Spalding County,2021-08-25,137,25696,39.3
13255,Spalding County,2021-08-26,104,25800,39.5
13255,Spalding County,2021-08-27,126,25926,39.7
13255,Spalding County,2021-08-28,65,25991,39.8
13255,Spalding County,2021-08-29,37,26028,39.9
13255,Spalding County,2021-08-30,90,26118,40
13255,Spalding County,2021-08-31,116,26234,40.2
13255,Spalding County,2021-09-01,98,26332,40.3
13255,Spalding County,2021-09-02,101,26433,40.5
13255,Spalding County,2021-09-03,133,26566,40.7
13255,Spalding County,2021-09-04,78,26644,40.8
13255,Spalding County,2021-09-05,51,26695,40.9
13255,Spalding County,2021-09-06,16,26711,40.9
13255,Spalding County,2021-09-07,94,26805,41
13255,Spalding County,2021-09-08,119,26924,41.2
13255,Spalding County,2021-09-09,106,27030,41.4
13255,Spalding County,2021-09-10,158,27188,41.6
13255,Spalding County,2021-09-11,76,27264,41.7
13255,Spalding County,2021-09-12,54,27318,41.8
13255,Spalding County,2021-09-13,104,27422,42
13255,Spalding County,2021-09-14,89,27511,42.1
13255,Spalding County,2021-09-15,83,27594,42.3
13255,Spalding County,2021-09-16,106,27700,42.4
13255,Spalding County,2021-09-17,80,27780,42.5
13255,Spalding County,2021-09-18,72,27852,42.6
13255,Spalding County,2021-09-19,25,27877,42.7
13255,Spalding County,2021-09-20,64,27941,42.8
13255,Spalding County,2021-09-21,70,28011,42.9
13255,Spalding County,2021-09-22,72,28083,43
13255,Spalding County,2021-09-23,107,28190,43.2
13255,Spalding County,2021-09-24,76,28266,43.3
13255,Spalding County,2021-09-25,38,28304,43.3
13255,Spalding County,2021-09-26,9,28313,43.4
13255,Spalding County,2021-09-27,20,28333,43.4
13255,Spalding County,2021-09-28,30,28363,43.4
13255,Spalding County,2021-09-29,28,28391,43.5
13255,Spalding County,2021-09-30,32,28423,43.5
13255,Spalding County,2021-10-01,39,28462,43.6
13255,Spalding County,2021-10-02,21,28483,43.6
13255,Spalding County,2021-10-03,9,28492,43.6
13255,Spalding County,2021-10-04,10,28502,43.6
13255,Spalding County,2021-10-05,19,28521,43.7
13255,Spalding County,2021-10-06,15,28536,43.7
13255,Spalding County,2021-10-07,9,28545,43.7
13257,Stephens County,2020-12-18,7,7,0
13257,Stephens County,2020-12-19,1,8,0
13257,Stephens County,2020-12-20,3,11,0
13257,Stephens County,2020-12-21,10,21,0.1
13257,Stephens County,2020-12-22,19,40,0.2
13257,Stephens County,2020-12-23,31,71,0.3
13257,Stephens County,2020-12-24,6,77,0.3
13257,Stephens County,2020-12-26,3,80,0.3
13257,Stephens County,2020-12-27,2,82,0.3
13257,Stephens County,2020-12-28,38,120,0.5
13257,Stephens County,2020-12-29,53,173,0.7
13257,Stephens County,2020-12-30,75,248,1
13257,Stephens County,2020-12-31,4,252,1
13257,Stephens County,2021-01-01,7,259,1
13257,Stephens County,2021-01-02,4,263,1
13257,Stephens County,2021-01-03,7,270,1
13257,Stephens County,2021-01-04,52,322,1.3
13257,Stephens County,2021-01-05,73,395,1.5
13257,Stephens County,2021-01-06,83,478,1.9
13257,Stephens County,2021-01-07,104,582,2.3
13257,Stephens County,2021-01-08,56,638,2.5
13257,Stephens County,2021-01-09,2,640,2.5
13257,Stephens County,2021-01-10,94,734,2.9
13257,Stephens County,2021-01-11,96,830,3.2
13257,Stephens County,2021-01-12,119,949,3.7
13257,Stephens County,2021-01-13,566,1515,5.9
13257,Stephens County,2021-01-14,182,1697,6.6
13257,Stephens County,2021-01-15,100,1797,7
13257,Stephens County,2021-01-16,15,1812,7
13257,Stephens County,2021-01-17,3,1815,7
13257,Stephens County,2021-01-18,147,1962,7.6
13257,Stephens County,2021-01-19,152,2114,8.2
13257,Stephens County,2021-01-20,225,2339,9.1
13257,Stephens County,2021-01-21,156,2495,9.7
13257,Stephens County,2021-01-22,90,2585,10
13257,Stephens County,2021-01-23,7,2592,10.1
13257,Stephens County,2021-01-24,13,2605,10.1
13257,Stephens County,2021-01-25,114,2719,10.6
13257,Stephens County,2021-01-26,139,2858,11.1
13257,Stephens County,2021-01-27,90,2948,11.4
13257,Stephens County,2021-01-28,143,3091,12
13257,Stephens County,2021-01-29,47,3138,12.2
13257,Stephens County,2021-01-30,9,3147,12.2
13257,Stephens County,2021-01-31,25,3172,12.3
13257,Stephens County,2021-02-01,63,3235,12.6
13257,Stephens County,2021-02-02,104,3339,13
13257,Stephens County,2021-02-03,68,3407,13.2
13257,Stephens County,2021-02-04,44,3451,13.4
13257,Stephens County,2021-02-05,31,3482,13.5
13257,Stephens County,2021-02-06,4,3486,13.5
13257,Stephens County,2021-02-08,39,3525,13.7
13257,Stephens County,2021-02-09,50,3575,13.9
13257,Stephens County,2021-02-10,45,3620,14.1
13257,Stephens County,2021-02-11,20,3640,14.1
13257,Stephens County,2021-02-12,28,3668,14.2
13257,Stephens County,2021-02-13,3,3671,14.3
13257,Stephens County,2021-02-14,3,3674,14.3
13257,Stephens County,2021-02-15,40,3714,14.4
13257,Stephens County,2021-02-16,39,3753,14.6
13257,Stephens County,2021-02-17,42,3795,14.7
13257,Stephens County,2021-02-18,19,3814,14.8
13257,Stephens County,2021-02-19,34,3848,14.9
13257,Stephens County,2021-02-22,48,3896,15.1
13257,Stephens County,2021-02-23,43,3939,15.3
13257,Stephens County,2021-02-24,49,3988,15.5
13257,Stephens County,2021-02-25,31,4019,15.6
13257,Stephens County,2021-02-26,47,4066,15.8
13257,Stephens County,2021-02-27,6,4072,15.8
13257,Stephens County,2021-02-28,16,4088,15.9
13257,Stephens County,2021-03-01,30,4118,16
13257,Stephens County,2021-03-02,27,4145,16.1
13257,Stephens County,2021-03-03,63,4208,16.3
13257,Stephens County,2021-03-04,62,4270,16.6
13257,Stephens County,2021-03-05,71,4341,16.9
13257,Stephens County,2021-03-06,11,4352,16.9
13257,Stephens County,2021-03-07,13,4365,17
13257,Stephens County,2021-03-08,70,4435,17.2
13257,Stephens County,2021-03-09,79,4514,17.5
13257,Stephens County,2021-03-10,80,4594,17.8
13257,Stephens County,2021-03-11,80,4674,18.2
13257,Stephens County,2021-03-12,154,4828,18.7
13257,Stephens County,2021-03-13,111,4939,19.2
13257,Stephens County,2021-03-14,11,4950,19.2
13257,Stephens County,2021-03-15,107,5057,19.6
13257,Stephens County,2021-03-16,131,5188,20.1
13257,Stephens County,2021-03-17,134,5322,20.7
13257,Stephens County,2021-03-18,94,5416,21
13257,Stephens County,2021-03-19,86,5502,21.4
13257,Stephens County,2021-03-20,20,5522,21.4
13257,Stephens County,2021-03-21,16,5538,21.5
13257,Stephens County,2021-03-22,141,5679,22.1
13257,Stephens County,2021-03-23,91,5770,22.4
13257,Stephens County,2021-03-24,91,5861,22.8
13257,Stephens County,2021-03-25,79,5940,23.1
13257,Stephens County,2021-03-26,79,6019,23.4
13257,Stephens County,2021-03-27,12,6031,23.4
13257,Stephens County,2021-03-28,26,6057,23.5
13257,Stephens County,2021-03-29,93,6150,23.9
13257,Stephens County,2021-03-30,120,6270,24.3
13257,Stephens County,2021-03-31,89,6359,24.7
13257,Stephens County,2021-04-01,119,6478,25.2
13257,Stephens County,2021-04-02,39,6517,25.3
13257,Stephens County,2021-04-03,66,6583,25.6
13257,Stephens County,2021-04-04,16,6599,25.6
13257,Stephens County,2021-04-05,58,6657,25.9
13257,Stephens County,2021-04-06,77,6734,26.2
13257,Stephens County,2021-04-07,61,6795,26.4
13257,Stephens County,2021-04-08,53,6848,26.6
13257,Stephens County,2021-04-09,67,6915,26.9
13257,Stephens County,2021-04-10,15,6930,26.9
13257,Stephens County,2021-04-11,9,6939,26.9
13257,Stephens County,2021-04-12,35,6974,27.1
13257,Stephens County,2021-04-13,47,7021,27.3
13257,Stephens County,2021-04-14,41,7062,27.4
13257,Stephens County,2021-04-15,40,7102,27.6
13257,Stephens County,2021-04-16,38,7140,27.7
13257,Stephens County,2021-04-17,26,7166,27.8
13257,Stephens County,2021-04-18,4,7170,27.8
13257,Stephens County,2021-04-19,30,7200,28
13257,Stephens County,2021-04-20,27,7227,28.1
13257,Stephens County,2021-04-21,42,7269,28.2
13257,Stephens County,2021-04-22,42,7311,28.4
13257,Stephens County,2021-04-23,44,7355,28.6
13257,Stephens County,2021-04-24,15,7370,28.6
13257,Stephens County,2021-04-25,18,7388,28.7
13257,Stephens County,2021-04-26,21,7409,28.8
13257,Stephens County,2021-04-27,39,7448,28.9
13257,Stephens County,2021-04-28,36,7484,29.1
13257,Stephens County,2021-04-29,40,7524,29.2
13257,Stephens County,2021-04-30,52,7576,29.4
13257,Stephens County,2021-05-01,11,7587,29.5
13257,Stephens County,2021-05-02,6,7593,29.5
13257,Stephens County,2021-05-03,16,7609,29.5
13257,Stephens County,2021-05-04,31,7640,29.7
13257,Stephens County,2021-05-05,20,7660,29.7
13257,Stephens County,2021-05-06,28,7688,29.9
13257,Stephens County,2021-05-07,41,7729,30
13257,Stephens County,2021-05-08,20,7749,30.1
13257,Stephens County,2021-05-09,3,7752,30.1
13257,Stephens County,2021-05-10,9,7761,30.1
13257,Stephens County,2021-05-11,29,7790,30.3
13257,Stephens County,2021-05-12,14,7804,30.3
13257,Stephens County,2021-05-13,28,7832,30.4
13257,Stephens County,2021-05-14,33,7865,30.5
13257,Stephens County,2021-05-15,16,7881,30.6
13257,Stephens County,2021-05-16,5,7886,30.6
13257,Stephens County,2021-05-17,26,7912,30.7
13257,Stephens County,2021-05-18,33,7945,30.9
13257,Stephens County,2021-05-19,33,7978,31
13257,Stephens County,2021-05-20,25,8003,31.1
13257,Stephens County,2021-05-21,30,8033,31.2
13257,Stephens County,2021-05-22,11,8044,31.2
13257,Stephens County,2021-05-23,8,8052,31.3
13257,Stephens County,2021-05-24,19,8071,31.3
13257,Stephens County,2021-05-25,32,8103,31.5
13257,Stephens County,2021-05-26,11,8114,31.5
13257,Stephens County,2021-05-27,14,8128,31.6
13257,Stephens County,2021-05-28,26,8154,31.7
13257,Stephens County,2021-05-29,16,8170,31.7
13257,Stephens County,2021-05-30,4,8174,31.7
13257,Stephens County,2021-05-31,1,8175,31.7
13257,Stephens County,2021-06-01,25,8200,31.8
13257,Stephens County,2021-06-02,12,8212,31.9
13257,Stephens County,2021-06-03,14,8226,31.9
13257,Stephens County,2021-06-04,16,8242,32
13257,Stephens County,2021-06-05,10,8252,32
13257,Stephens County,2021-06-06,8,8260,32.1
13257,Stephens County,2021-06-07,14,8274,32.1
13257,Stephens County,2021-06-08,13,8287,32.2
13257,Stephens County,2021-06-09,13,8300,32.2
13257,Stephens County,2021-06-10,23,8323,32.3
13257,Stephens County,2021-06-11,9,8332,32.4
13257,Stephens County,2021-06-12,19,8351,32.4
13257,Stephens County,2021-06-13,6,8357,32.5
13257,Stephens County,2021-06-14,15,8372,32.5
13257,Stephens County,2021-06-15,14,8386,32.6
13257,Stephens County,2021-06-16,10,8396,32.6
13257,Stephens County,2021-06-17,11,8407,32.6
13257,Stephens County,2021-06-18,23,8430,32.7
13257,Stephens County,2021-06-19,3,8433,32.7
13257,Stephens County,2021-06-20,3,8436,32.8
13257,Stephens County,2021-06-21,14,8450,32.8
13257,Stephens County,2021-06-22,26,8476,32.9
13257,Stephens County,2021-06-23,11,8487,33
13257,Stephens County,2021-06-24,19,8506,33
13257,Stephens County,2021-06-25,24,8530,33.1
13257,Stephens County,2021-06-26,7,8537,33.2
13257,Stephens County,2021-06-27,5,8542,33.2
13257,Stephens County,2021-06-28,8,8550,33.2
13257,Stephens County,2021-06-29,10,8560,33.2
13257,Stephens County,2021-06-30,27,8587,33.3
13257,Stephens County,2021-07-01,12,8599,33.4
13257,Stephens County,2021-07-02,7,8606,33.4
13257,Stephens County,2021-07-03,3,8609,33.4
13257,Stephens County,2021-07-04,2,8611,33.4
13257,Stephens County,2021-07-05,6,8617,33.5
13257,Stephens County,2021-07-06,9,8626,33.5
13257,Stephens County,2021-07-07,12,8638,33.5
13257,Stephens County,2021-07-08,31,8669,33.7
13257,Stephens County,2021-07-09,7,8676,33.7
13257,Stephens County,2021-07-10,10,8686,33.7
13257,Stephens County,2021-07-11,3,8689,33.7
13257,Stephens County,2021-07-12,9,8698,33.8
13257,Stephens County,2021-07-13,23,8721,33.9
13257,Stephens County,2021-07-14,14,8735,33.9
13257,Stephens County,2021-07-15,10,8745,34
13257,Stephens County,2021-07-16,16,8761,34
13257,Stephens County,2021-07-17,7,8768,34.1
13257,Stephens County,2021-07-18,4,8772,34.1
13257,Stephens County,2021-07-19,14,8786,34.1
13257,Stephens County,2021-07-20,11,8797,34.2
13257,Stephens County,2021-07-21,34,8831,34.3
13257,Stephens County,2021-07-22,30,8861,34.4
13257,Stephens County,2021-07-23,26,8887,34.5
13257,Stephens County,2021-07-24,20,8907,34.6
13257,Stephens County,2021-07-25,8,8915,34.6
13257,Stephens County,2021-07-26,22,8937,34.7
13257,Stephens County,2021-07-27,27,8964,34.8
13257,Stephens County,2021-07-28,43,9007,35
13257,Stephens County,2021-07-29,36,9043,35.1
13257,Stephens County,2021-07-30,42,9085,35.3
13257,Stephens County,2021-07-31,33,9118,35.4
13257,Stephens County,2021-08-01,8,9126,35.4
13257,Stephens County,2021-08-02,47,9173,35.6
13257,Stephens County,2021-08-03,35,9208,35.8
13257,Stephens County,2021-08-04,53,9261,36
13257,Stephens County,2021-08-05,48,9309,36.2
13257,Stephens County,2021-08-06,46,9355,36.3
13257,Stephens County,2021-08-07,28,9383,36.4
13257,Stephens County,2021-08-08,14,9397,36.5
13257,Stephens County,2021-08-09,37,9434,36.6
13257,Stephens County,2021-08-10,45,9479,36.8
13257,Stephens County,2021-08-11,68,9547,37.1
13257,Stephens County,2021-08-12,78,9625,37.4
13257,Stephens County,2021-08-13,66,9691,37.6
13257,Stephens County,2021-08-14,19,9710,37.7
13257,Stephens County,2021-08-15,23,9733,37.8
13257,Stephens County,2021-08-16,37,9770,37.9
13257,Stephens County,2021-08-17,37,9807,38.1
13257,Stephens County,2021-08-18,46,9853,38.3
13257,Stephens County,2021-08-19,46,9899,38.4
13257,Stephens County,2021-08-20,62,9961,38.7
13257,Stephens County,2021-08-21,30,9991,38.8
13257,Stephens County,2021-08-22,19,10010,38.9
13257,Stephens County,2021-08-23,66,10076,39.1
13257,Stephens County,2021-08-24,59,10135,39.4
13257,Stephens County,2021-08-25,44,10179,39.5
13257,Stephens County,2021-08-26,80,10259,39.8
13257,Stephens County,2021-08-27,68,10327,40.1
13257,Stephens County,2021-08-28,34,10361,40.2
13257,Stephens County,2021-08-29,17,10378,40.3
13257,Stephens County,2021-08-30,58,10436,40.5
13257,Stephens County,2021-08-31,49,10485,40.7
13257,Stephens County,2021-09-01,46,10531,40.9
13257,Stephens County,2021-09-02,36,10567,41
13257,Stephens County,2021-09-03,62,10629,41.3
13257,Stephens County,2021-09-04,27,10656,41.4
13257,Stephens County,2021-09-05,8,10664,41.4
13257,Stephens County,2021-09-06,5,10669,41.4
13257,Stephens County,2021-09-07,39,10708,41.6
13257,Stephens County,2021-09-08,36,10744,41.7
13257,Stephens County,2021-09-09,39,10783,41.9
13257,Stephens County,2021-09-10,48,10831,42.1
13257,Stephens County,2021-09-11,21,10852,42.1
13257,Stephens County,2021-09-12,12,10864,42.2
13257,Stephens County,2021-09-13,25,10889,42.3
13257,Stephens County,2021-09-14,35,10924,42.4
13257,Stephens County,2021-09-15,25,10949,42.5
13257,Stephens County,2021-09-16,29,10978,42.6
13257,Stephens County,2021-09-17,39,11017,42.8
13257,Stephens County,2021-09-18,7,11024,42.8
13257,Stephens County,2021-09-19,12,11036,42.9
13257,Stephens County,2021-09-20,13,11049,42.9
13257,Stephens County,2021-09-21,26,11075,43
13257,Stephens County,2021-09-22,30,11105,43.1
13257,Stephens County,2021-09-23,22,11127,43.2
13257,Stephens County,2021-09-24,13,11140,43.3
13257,Stephens County,2021-09-25,7,11147,43.3
13257,Stephens County,2021-09-26,4,11151,43.3
13257,Stephens County,2021-09-27,19,11170,43.4
13257,Stephens County,2021-09-28,22,11192,43.5
13257,Stephens County,2021-09-29,17,11209,43.5
13257,Stephens County,2021-09-30,14,11223,43.6
13257,Stephens County,2021-10-01,9,11232,43.6
13257,Stephens County,2021-10-02,2,11234,43.6
13257,Stephens County,2021-10-04,9,11243,43.7
13257,Stephens County,2021-10-05,17,11260,43.7
13257,Stephens County,2021-10-06,5,11265,43.7
13257,Stephens County,2021-10-07,4,11269,43.8
13259,Stewart County,2020-12-18,1,1,0
13259,Stewart County,2020-12-22,2,3,0
13259,Stewart County,2020-12-23,2,5,0.1
13259,Stewart County,2020-12-27,1,6,0.1
13259,Stewart County,2020-12-28,2,8,0.1
13259,Stewart County,2020-12-29,2,10,0.2
13259,Stewart County,2020-12-30,1,11,0.2
13259,Stewart County,2020-12-31,2,13,0.2
13259,Stewart County,2021-01-04,5,18,0.3
13259,Stewart County,2021-01-05,10,28,0.4
13259,Stewart County,2021-01-06,44,72,1.1
13259,Stewart County,2021-01-07,4,76,1.2
13259,Stewart County,2021-01-08,1,77,1.2
13259,Stewart County,2021-01-09,1,78,1.2
13259,Stewart County,2021-01-11,71,149,2.4
13259,Stewart County,2021-01-12,3,152,2.4
13259,Stewart County,2021-01-13,2,154,2.4
13259,Stewart County,2021-01-14,49,203,3.2
13259,Stewart County,2021-01-15,98,301,4.8
13259,Stewart County,2021-01-16,1,302,4.8
13259,Stewart County,2021-01-18,8,310,4.9
13259,Stewart County,2021-01-19,4,314,5
13259,Stewart County,2021-01-20,2,316,5
13259,Stewart County,2021-01-21,19,335,5.3
13259,Stewart County,2021-01-22,44,379,6
13259,Stewart County,2021-01-25,7,386,6.1
13259,Stewart County,2021-01-26,6,392,6.2
13259,Stewart County,2021-01-27,28,420,6.7
13259,Stewart County,2021-01-28,30,450,7.2
13259,Stewart County,2021-01-29,67,517,8.2
13259,Stewart County,2021-02-01,3,520,8.3
13259,Stewart County,2021-02-02,5,525,8.3
13259,Stewart County,2021-02-03,9,534,8.5
13259,Stewart County,2021-02-04,15,549,8.7
13259,Stewart County,2021-02-05,49,598,9.5
13259,Stewart County,2021-02-07,1,599,9.5
13259,Stewart County,2021-02-08,2,601,9.6
13259,Stewart County,2021-02-09,4,605,9.6
13259,Stewart County,2021-02-10,1,606,9.6
13259,Stewart County,2021-02-11,55,661,10.5
13259,Stewart County,2021-02-12,5,666,10.6
13259,Stewart County,2021-02-15,8,674,10.7
13259,Stewart County,2021-02-16,1,675,10.7
13259,Stewart County,2021-02-17,1,676,10.7
13259,Stewart County,2021-02-18,1,677,10.8
13259,Stewart County,2021-02-19,29,706,11.2
13259,Stewart County,2021-02-22,4,710,11.3
13259,Stewart County,2021-02-23,8,718,11.4
13259,Stewart County,2021-02-24,3,721,11.5
13259,Stewart County,2021-02-25,39,760,12.1
13259,Stewart County,2021-02-26,1,761,12.1
13259,Stewart County,2021-03-01,2,763,12.1
13259,Stewart County,2021-03-02,6,769,12.2
13259,Stewart County,2021-03-03,8,777,12.3
13259,Stewart County,2021-03-04,5,782,12.4
13259,Stewart County,2021-03-05,13,795,12.6
13259,Stewart County,2021-03-06,1,796,12.6
13259,Stewart County,2021-03-08,42,838,13.3
13259,Stewart County,2021-03-09,18,856,13.6
13259,Stewart County,2021-03-10,5,861,13.7
13259,Stewart County,2021-03-11,31,892,14.2
13259,Stewart County,2021-03-12,18,910,14.5
13259,Stewart County,2021-03-13,3,913,14.5
13259,Stewart County,2021-03-15,47,960,15.3
13259,Stewart County,2021-03-16,23,983,15.6
13259,Stewart County,2021-03-17,12,995,15.8
13259,Stewart County,2021-03-18,14,1009,16
13259,Stewart County,2021-03-19,26,1035,16.4
13259,Stewart County,2021-03-20,5,1040,16.5
13259,Stewart County,2021-03-21,1,1041,16.5
13259,Stewart County,2021-03-22,13,1054,16.7
13259,Stewart County,2021-03-23,14,1068,17
13259,Stewart County,2021-03-24,4,1072,17
13259,Stewart County,2021-03-25,30,1102,17.5
13259,Stewart County,2021-03-26,62,1164,18.5
13259,Stewart County,2021-03-27,2,1166,18.5
13259,Stewart County,2021-03-29,13,1179,18.7
13259,Stewart County,2021-03-30,14,1193,19
13259,Stewart County,2021-03-31,15,1208,19.2
13259,Stewart County,2021-04-01,9,1217,19.3
13259,Stewart County,2021-04-02,14,1231,19.6
13259,Stewart County,2021-04-03,4,1235,19.6
13259,Stewart County,2021-04-04,1,1236,19.6
13259,Stewart County,2021-04-05,3,1239,19.7
13259,Stewart County,2021-04-06,24,1263,20.1
13259,Stewart County,2021-04-07,6,1269,20.2
13259,Stewart County,2021-04-08,22,1291,20.5
13259,Stewart County,2021-04-09,19,1310,20.8
13259,Stewart County,2021-04-10,5,1315,20.9
13259,Stewart County,2021-04-12,9,1324,21
13259,Stewart County,2021-04-13,18,1342,21.3
13259,Stewart County,2021-04-14,34,1376,21.9
13259,Stewart County,2021-04-15,6,1382,22
13259,Stewart County,2021-04-16,27,1409,22.4
13259,Stewart County,2021-04-17,6,1415,22.5
13259,Stewart County,2021-04-19,15,1430,22.7
13259,Stewart County,2021-04-20,7,1437,22.8
13259,Stewart County,2021-04-21,11,1448,23
13259,Stewart County,2021-04-22,9,1457,23.2
13259,Stewart County,2021-04-23,13,1470,23.4
13259,Stewart County,2021-04-24,2,1472,23.4
13259,Stewart County,2021-04-25,2,1474,23.4
13259,Stewart County,2021-04-26,7,1481,23.5
13259,Stewart County,2021-04-27,10,1491,23.7
13259,Stewart County,2021-04-28,10,1501,23.9
13259,Stewart County,2021-04-29,12,1513,24
13259,Stewart County,2021-04-30,5,1518,24.1
13259,Stewart County,2021-05-01,4,1522,24.2
13259,Stewart County,2021-05-02,1,1523,24.2
13259,Stewart County,2021-05-03,1,1524,24.2
13259,Stewart County,2021-05-04,2,1526,24.2
13259,Stewart County,2021-05-05,4,1530,24.3
13259,Stewart County,2021-05-06,13,1543,24.5
13259,Stewart County,2021-05-07,9,1552,24.7
13259,Stewart County,2021-05-08,4,1556,24.7
13259,Stewart County,2021-05-10,4,1560,24.8
13259,Stewart County,2021-05-11,6,1566,24.9
13259,Stewart County,2021-05-12,3,1569,24.9
13259,Stewart County,2021-05-13,20,1589,25.3
13259,Stewart County,2021-05-14,7,1596,25.4
13259,Stewart County,2021-05-16,2,1598,25.4
13259,Stewart County,2021-05-17,10,1608,25.6
13259,Stewart County,2021-05-18,6,1614,25.6
13259,Stewart County,2021-05-19,6,1620,25.7
13259,Stewart County,2021-05-20,8,1628,25.9
13259,Stewart County,2021-05-21,7,1635,26
13259,Stewart County,2021-05-22,3,1638,26
13259,Stewart County,2021-05-23,1,1639,26
13259,Stewart County,2021-05-24,7,1646,26.2
13259,Stewart County,2021-05-25,3,1649,26.2
13259,Stewart County,2021-05-27,3,1652,26.3
13259,Stewart County,2021-05-28,5,1657,26.3
13259,Stewart County,2021-05-29,1,1658,26.3
13259,Stewart County,2021-05-30,1,1659,26.4
13259,Stewart County,2021-06-01,2,1661,26.4
13259,Stewart County,2021-06-02,1,1662,26.4
13259,Stewart County,2021-06-03,4,1666,26.5
13259,Stewart County,2021-06-04,4,1670,26.5
13259,Stewart County,2021-06-07,4,1674,26.6
13259,Stewart County,2021-06-08,1,1675,26.6
13259,Stewart County,2021-06-09,8,1683,26.7
13259,Stewart County,2021-06-10,7,1690,26.9
13259,Stewart County,2021-06-11,2,1692,26.9
13259,Stewart County,2021-06-14,3,1695,26.9
13259,Stewart County,2021-06-15,1,1696,27
13259,Stewart County,2021-06-16,2,1698,27
13259,Stewart County,2021-06-17,6,1704,27.1
13259,Stewart County,2021-06-18,1,1705,27.1
13259,Stewart County,2021-06-20,2,1707,27.1
13259,Stewart County,2021-06-21,7,1714,27.2
13259,Stewart County,2021-06-24,1,1715,27.3
13259,Stewart County,2021-06-25,3,1718,27.3
13259,Stewart County,2021-06-26,1,1719,27.3
13259,Stewart County,2021-06-28,3,1722,27.4
13259,Stewart County,2021-06-29,2,1724,27.4
13259,Stewart County,2021-06-30,2,1726,27.4
13259,Stewart County,2021-07-02,1,1727,27.4
13259,Stewart County,2021-07-06,3,1730,27.5
13259,Stewart County,2021-07-07,4,1734,27.6
13259,Stewart County,2021-07-08,6,1740,27.6
13259,Stewart County,2021-07-09,3,1743,27.7
13259,Stewart County,2021-07-10,3,1746,27.7
13259,Stewart County,2021-07-12,21,1767,28.1
13259,Stewart County,2021-07-13,1,1768,28.1
13259,Stewart County,2021-07-14,5,1773,28.2
13259,Stewart County,2021-07-16,1,1774,28.2
13259,Stewart County,2021-07-19,2,1776,28.2
13259,Stewart County,2021-07-20,6,1782,28.3
13259,Stewart County,2021-07-21,4,1786,28.4
13259,Stewart County,2021-07-22,7,1793,28.5
13259,Stewart County,2021-07-23,8,1801,28.6
13259,Stewart County,2021-07-24,6,1807,28.7
13259,Stewart County,2021-07-26,2,1809,28.7
13259,Stewart County,2021-07-27,12,1821,28.9
13259,Stewart County,2021-07-28,8,1829,29.1
13259,Stewart County,2021-07-29,5,1834,29.1
13259,Stewart County,2021-07-30,5,1839,29.2
13259,Stewart County,2021-07-31,3,1842,29.3
13259,Stewart County,2021-08-01,2,1844,29.3
13259,Stewart County,2021-08-03,2,1846,29.3
13259,Stewart County,2021-08-04,20,1866,29.7
13259,Stewart County,2021-08-05,8,1874,29.8
13259,Stewart County,2021-08-06,6,1880,29.9
13259,Stewart County,2021-08-07,1,1881,29.9
13259,Stewart County,2021-08-08,1,1882,29.9
13259,Stewart County,2021-08-09,4,1886,30
13259,Stewart County,2021-08-10,9,1895,30.1
13259,Stewart County,2021-08-11,21,1916,30.4
13259,Stewart County,2021-08-12,6,1922,30.5
13259,Stewart County,2021-08-13,14,1936,30.8
13259,Stewart County,2021-08-14,2,1938,30.8
13259,Stewart County,2021-08-15,1,1939,30.8
13259,Stewart County,2021-08-16,2,1941,30.8
13259,Stewart County,2021-08-17,5,1946,30.9
13259,Stewart County,2021-08-18,15,1961,31.2
13259,Stewart County,2021-08-19,7,1968,31.3
13259,Stewart County,2021-08-20,10,1978,31.4
13259,Stewart County,2021-08-21,4,1982,31.5
13259,Stewart County,2021-08-22,4,1986,31.6
13259,Stewart County,2021-08-23,5,1991,31.6
13259,Stewart County,2021-08-24,10,2001,31.8
13259,Stewart County,2021-08-25,13,2014,32
13259,Stewart County,2021-08-26,15,2029,32.2
13259,Stewart County,2021-08-27,4,2033,32.3
13259,Stewart County,2021-08-28,2,2035,32.3
13259,Stewart County,2021-08-30,8,2043,32.5
13259,Stewart County,2021-08-31,6,2049,32.6
13259,Stewart County,2021-09-01,4,2053,32.6
13259,Stewart County,2021-09-02,8,2061,32.8
13259,Stewart County,2021-09-03,6,2067,32.8
13259,Stewart County,2021-09-04,2,2069,32.9
13259,Stewart County,2021-09-05,2,2071,32.9
13259,Stewart County,2021-09-06,1,2072,32.9
13259,Stewart County,2021-09-07,11,2083,33.1
13259,Stewart County,2021-09-08,4,2087,33.2
13259,Stewart County,2021-09-09,9,2096,33.3
13259,Stewart County,2021-09-10,5,2101,33.4
13259,Stewart County,2021-09-11,2,2103,33.4
13259,Stewart County,2021-09-12,1,2104,33.4
13259,Stewart County,2021-09-13,3,2107,33.5
13259,Stewart County,2021-09-14,5,2112,33.6
13259,Stewart County,2021-09-15,10,2122,33.7
13259,Stewart County,2021-09-16,1,2123,33.7
13259,Stewart County,2021-09-17,5,2128,33.8
13259,Stewart County,2021-09-20,4,2132,33.9
13259,Stewart County,2021-09-21,1,2133,33.9
13259,Stewart County,2021-09-22,2,2135,33.9
13259,Stewart County,2021-09-23,1,2136,33.9
13259,Stewart County,2021-09-24,2,2138,34
13259,Stewart County,2021-09-25,1,2139,34
13259,Stewart County,2021-09-27,2,2141,34
13259,Stewart County,2021-09-28,1,2142,34
13259,Stewart County,2021-09-29,6,2148,34.1
13259,Stewart County,2021-09-30,2,2150,34.2
13259,Stewart County,2021-10-01,1,2151,34.2
13259,Stewart County,2021-10-02,1,2152,34.2
13259,Stewart County,2021-10-04,1,2153,34.2
13259,Stewart County,2021-10-05,1,2154,34.2
13259,Stewart County,2021-10-06,4,2158,34.3
13259,Stewart County,2021-10-07,1,2159,34.3
13261,Sumter County,2020-12-17,3,3,0
13261,Sumter County,2020-12-18,13,16,0.1
13261,Sumter County,2020-12-19,4,20,0.1
13261,Sumter County,2020-12-20,2,22,0.1
13261,Sumter County,2020-12-21,12,34,0.1
13261,Sumter County,2020-12-22,29,63,0.2
13261,Sumter County,2020-12-23,102,165,0.5
13261,Sumter County,2020-12-24,35,200,0.7
13261,Sumter County,2020-12-26,37,237,0.8
13261,Sumter County,2020-12-27,2,239,0.8
13261,Sumter County,2020-12-28,60,299,1
13261,Sumter County,2020-12-29,54,353,1.2
13261,Sumter County,2020-12-30,36,389,1.3
13261,Sumter County,2020-12-31,43,432,1.4
13261,Sumter County,2021-01-01,6,438,1.5
13261,Sumter County,2021-01-02,1,439,1.5
13261,Sumter County,2021-01-03,21,460,1.5
13261,Sumter County,2021-01-04,31,491,1.6
13261,Sumter County,2021-01-05,33,524,1.7
13261,Sumter County,2021-01-06,30,554,1.8
13261,Sumter County,2021-01-07,24,578,1.9
13261,Sumter County,2021-01-08,12,590,2
13261,Sumter County,2021-01-09,2,592,2
13261,Sumter County,2021-01-10,10,602,2
13261,Sumter County,2021-01-11,104,706,2.3
13261,Sumter County,2021-01-12,309,1015,3.4
13261,Sumter County,2021-01-13,190,1205,4
13261,Sumter County,2021-01-14,381,1586,5.3
13261,Sumter County,2021-01-15,250,1836,6.1
13261,Sumter County,2021-01-16,65,1901,6.3
13261,Sumter County,2021-01-17,100,2001,6.7
13261,Sumter County,2021-01-18,194,2195,7.3
13261,Sumter County,2021-01-19,235,2430,8.1
13261,Sumter County,2021-01-20,163,2593,8.6
13261,Sumter County,2021-01-21,174,2767,9.2
13261,Sumter County,2021-01-22,212,2979,9.9
13261,Sumter County,2021-01-23,7,2986,9.9
13261,Sumter County,2021-01-24,4,2990,9.9
13261,Sumter County,2021-01-25,145,3135,10.4
13261,Sumter County,2021-01-26,166,3301,11
13261,Sumter County,2021-01-27,162,3463,11.5
13261,Sumter County,2021-01-28,196,3659,12.2
13261,Sumter County,2021-01-29,133,3792,12.6
13261,Sumter County,2021-01-30,3,3795,12.6
13261,Sumter County,2021-01-31,2,3797,12.6
13261,Sumter County,2021-02-01,19,3816,12.7
13261,Sumter County,2021-02-02,173,3989,13.3
13261,Sumter County,2021-02-03,105,4094,13.6
13261,Sumter County,2021-02-04,172,4266,14.2
13261,Sumter County,2021-02-05,44,4310,14.3
13261,Sumter County,2021-02-06,5,4315,14.4
13261,Sumter County,2021-02-07,13,4328,14.4
13261,Sumter County,2021-02-08,51,4379,14.6
13261,Sumter County,2021-02-09,56,4435,14.8
13261,Sumter County,2021-02-10,36,4471,14.9
13261,Sumter County,2021-02-11,48,4519,15
13261,Sumter County,2021-02-12,33,4552,15.1
13261,Sumter County,2021-02-13,5,4557,15.2
13261,Sumter County,2021-02-14,7,4564,15.2
13261,Sumter County,2021-02-15,54,4618,15.4
13261,Sumter County,2021-02-16,96,4714,15.7
13261,Sumter County,2021-02-17,71,4785,15.9
13261,Sumter County,2021-02-18,50,4835,16.1
13261,Sumter County,2021-02-19,52,4887,16.3
13261,Sumter County,2021-02-20,2,4889,16.3
13261,Sumter County,2021-02-22,39,4928,16.4
13261,Sumter County,2021-02-23,82,5010,16.7
13261,Sumter County,2021-02-24,54,5064,16.8
13261,Sumter County,2021-02-25,94,5158,17.2
13261,Sumter County,2021-02-26,33,5191,17.3
13261,Sumter County,2021-02-27,3,5194,17.3
13261,Sumter County,2021-02-28,1,5195,17.3
13261,Sumter County,2021-03-01,44,5239,17.4
13261,Sumter County,2021-03-02,72,5311,17.7
13261,Sumter County,2021-03-03,86,5397,18
13261,Sumter County,2021-03-04,85,5482,18.2
13261,Sumter County,2021-03-05,57,5539,18.4
13261,Sumter County,2021-03-06,6,5545,18.4
13261,Sumter County,2021-03-07,9,5554,18.5
13261,Sumter County,2021-03-08,163,5717,19
13261,Sumter County,2021-03-09,194,5911,19.7
13261,Sumter County,2021-03-10,103,6014,20
13261,Sumter County,2021-03-11,159,6173,20.5
13261,Sumter County,2021-03-12,171,6344,21.1
13261,Sumter County,2021-03-13,10,6354,21.1
13261,Sumter County,2021-03-14,14,6368,21.2
13261,Sumter County,2021-03-15,216,6584,21.9
13261,Sumter County,2021-03-16,175,6759,22.5
13261,Sumter County,2021-03-17,145,6904,23
13261,Sumter County,2021-03-18,136,7040,23.4
13261,Sumter County,2021-03-19,187,7227,24
13261,Sumter County,2021-03-20,22,7249,24.1
13261,Sumter County,2021-03-21,16,7265,24.2
13261,Sumter County,2021-03-22,129,7394,24.6
13261,Sumter County,2021-03-23,156,7550,25.1
13261,Sumter County,2021-03-24,57,7607,25.3
13261,Sumter County,2021-03-25,290,7897,26.3
13261,Sumter County,2021-03-26,113,8010,26.6
13261,Sumter County,2021-03-27,30,8040,26.7
13261,Sumter County,2021-03-28,11,8051,26.8
13261,Sumter County,2021-03-29,121,8172,27.2
13261,Sumter County,2021-03-30,156,8328,27.7
13261,Sumter County,2021-03-31,92,8420,28
13261,Sumter County,2021-04-01,177,8597,28.6
13261,Sumter County,2021-04-02,94,8691,28.9
13261,Sumter County,2021-04-03,16,8707,29
13261,Sumter County,2021-04-04,5,8712,29
13261,Sumter County,2021-04-05,107,8819,29.3
13261,Sumter County,2021-04-06,129,8948,29.8
13261,Sumter County,2021-04-07,46,8994,29.9
13261,Sumter County,2021-04-08,182,9176,30.5
13261,Sumter County,2021-04-09,83,9259,30.8
13261,Sumter County,2021-04-10,15,9274,30.8
13261,Sumter County,2021-04-11,6,9280,30.9
13261,Sumter County,2021-04-12,37,9317,31
13261,Sumter County,2021-04-13,128,9445,31.4
13261,Sumter County,2021-04-14,33,9478,31.5
13261,Sumter County,2021-04-15,105,9583,31.9
13261,Sumter County,2021-04-16,63,9646,32.1
13261,Sumter County,2021-04-17,14,9660,32.1
13261,Sumter County,2021-04-18,4,9664,32.1
13261,Sumter County,2021-04-19,31,9695,32.2
13261,Sumter County,2021-04-20,89,9784,32.5
13261,Sumter County,2021-04-21,45,9829,32.7
13261,Sumter County,2021-04-22,122,9951,33.1
13261,Sumter County,2021-04-23,35,9986,33.2
13261,Sumter County,2021-04-24,4,9990,33.2
13261,Sumter County,2021-04-25,4,9994,33.2
13261,Sumter County,2021-04-26,22,10016,33.3
13261,Sumter County,2021-04-27,76,10092,33.6
13261,Sumter County,2021-04-28,29,10121,33.7
13261,Sumter County,2021-04-29,103,10224,34
13261,Sumter County,2021-04-30,62,10286,34.2
13261,Sumter County,2021-05-01,15,10301,34.3
13261,Sumter County,2021-05-02,6,10307,34.3
13261,Sumter County,2021-05-03,33,10340,34.4
13261,Sumter County,2021-05-04,45,10385,34.5
13261,Sumter County,2021-05-05,19,10404,34.6
13261,Sumter County,2021-05-06,48,10452,34.8
13261,Sumter County,2021-05-07,40,10492,34.9
13261,Sumter County,2021-05-08,12,10504,34.9
13261,Sumter County,2021-05-09,1,10505,34.9
13261,Sumter County,2021-05-10,30,10535,35
13261,Sumter County,2021-05-11,42,10577,35.2
13261,Sumter County,2021-05-12,33,10610,35.3
13261,Sumter County,2021-05-13,50,10660,35.5
13261,Sumter County,2021-05-14,85,10745,35.7
13261,Sumter County,2021-05-15,20,10765,35.8
13261,Sumter County,2021-05-16,8,10773,35.8
13261,Sumter County,2021-05-17,40,10813,36
13261,Sumter County,2021-05-18,68,10881,36.2
13261,Sumter County,2021-05-19,62,10943,36.4
13261,Sumter County,2021-05-20,62,11005,36.6
13261,Sumter County,2021-05-21,73,11078,36.8
13261,Sumter County,2021-05-22,8,11086,36.9
13261,Sumter County,2021-05-23,4,11090,36.9
13261,Sumter County,2021-05-24,45,11135,37
13261,Sumter County,2021-05-25,40,11175,37.2
13261,Sumter County,2021-05-26,43,11218,37.3
13261,Sumter County,2021-05-27,33,11251,37.4
13261,Sumter County,2021-05-28,51,11302,37.6
13261,Sumter County,2021-05-29,16,11318,37.6
13261,Sumter County,2021-05-30,5,11323,37.7
13261,Sumter County,2021-05-31,2,11325,37.7
13261,Sumter County,2021-06-01,30,11355,37.8
13261,Sumter County,2021-06-02,35,11390,37.9
13261,Sumter County,2021-06-03,39,11429,38
13261,Sumter County,2021-06-04,35,11464,38.1
13261,Sumter County,2021-06-05,13,11477,38.2
13261,Sumter County,2021-06-06,2,11479,38.2
13261,Sumter County,2021-06-07,30,11509,38.3
13261,Sumter County,2021-06-08,41,11550,38.4
13261,Sumter County,2021-06-09,35,11585,38.5
13261,Sumter County,2021-06-10,28,11613,38.6
13261,Sumter County,2021-06-11,19,11632,38.7
13261,Sumter County,2021-06-12,12,11644,38.7
13261,Sumter County,2021-06-14,27,11671,38.8
13261,Sumter County,2021-06-15,26,11697,38.9
13261,Sumter County,2021-06-16,23,11720,39
13261,Sumter County,2021-06-17,18,11738,39
13261,Sumter County,2021-06-18,60,11798,39.2
13261,Sumter County,2021-06-19,9,11807,39.3
13261,Sumter County,2021-06-20,5,11812,39.3
13261,Sumter County,2021-06-21,16,11828,39.3
13261,Sumter County,2021-06-22,19,11847,39.4
13261,Sumter County,2021-06-23,14,11861,39.5
13261,Sumter County,2021-06-24,26,11887,39.5
13261,Sumter County,2021-06-25,29,11916,39.6
13261,Sumter County,2021-06-26,10,11926,39.7
13261,Sumter County,2021-06-27,3,11929,39.7
13261,Sumter County,2021-06-28,14,11943,39.7
13261,Sumter County,2021-06-29,17,11960,39.8
13261,Sumter County,2021-06-30,17,11977,39.8
13261,Sumter County,2021-07-01,27,12004,39.9
13261,Sumter County,2021-07-02,22,12026,40
13261,Sumter County,2021-07-03,2,12028,40
13261,Sumter County,2021-07-04,1,12029,40
13261,Sumter County,2021-07-05,8,12037,40
13261,Sumter County,2021-07-06,24,12061,40.1
13261,Sumter County,2021-07-07,16,12077,40.2
13261,Sumter County,2021-07-08,22,12099,40.2
13261,Sumter County,2021-07-09,32,12131,40.4
13261,Sumter County,2021-07-10,10,12141,40.4
13261,Sumter County,2021-07-12,13,12154,40.4
13261,Sumter County,2021-07-13,25,12179,40.5
13261,Sumter County,2021-07-14,14,12193,40.6
13261,Sumter County,2021-07-15,22,12215,40.6
13261,Sumter County,2021-07-16,36,12251,40.7
13261,Sumter County,2021-07-17,12,12263,40.8
13261,Sumter County,2021-07-18,4,12267,40.8
13261,Sumter County,2021-07-19,27,12294,40.9
13261,Sumter County,2021-07-20,32,12326,41
13261,Sumter County,2021-07-21,37,12363,41.1
13261,Sumter County,2021-07-22,45,12408,41.3
13261,Sumter County,2021-07-23,59,12467,41.5
13261,Sumter County,2021-07-24,39,12506,41.6
13261,Sumter County,2021-07-25,10,12516,41.6
13261,Sumter County,2021-07-26,36,12552,41.8
13261,Sumter County,2021-07-27,39,12591,41.9
13261,Sumter County,2021-07-28,57,12648,42.1
13261,Sumter County,2021-07-29,65,12713,42.3
13261,Sumter County,2021-07-30,69,12782,42.5
13261,Sumter County,2021-07-31,34,12816,42.6
13261,Sumter County,2021-08-01,15,12831,42.7
13261,Sumter County,2021-08-02,66,12897,42.9
13261,Sumter County,2021-08-03,49,12946,43.1
13261,Sumter County,2021-08-04,57,13003,43.3
13261,Sumter County,2021-08-05,67,13070,43.5
13261,Sumter County,2021-08-06,64,13134,43.7
13261,Sumter County,2021-08-07,27,13161,43.8
13261,Sumter County,2021-08-08,20,13181,43.8
13261,Sumter County,2021-08-09,51,13232,44
13261,Sumter County,2021-08-10,58,13290,44.2
13261,Sumter County,2021-08-11,63,13353,44.4
13261,Sumter County,2021-08-12,68,13421,44.6
13261,Sumter County,2021-08-13,106,13527,45
13261,Sumter County,2021-08-14,74,13601,45.2
13261,Sumter County,2021-08-15,20,13621,45.3
13261,Sumter County,2021-08-16,55,13676,45.5
13261,Sumter County,2021-08-17,100,13776,45.8
13261,Sumter County,2021-08-18,58,13834,46
13261,Sumter County,2021-08-19,68,13902,46.2
13261,Sumter County,2021-08-20,97,13999,46.6
13261,Sumter County,2021-08-21,31,14030,46.7
13261,Sumter County,2021-08-22,16,14046,46.7
13261,Sumter County,2021-08-23,57,14103,46.9
13261,Sumter County,2021-08-24,87,14190,47.2
13261,Sumter County,2021-08-25,55,14245,47.4
13261,Sumter County,2021-08-26,70,14315,47.6
13261,Sumter County,2021-08-27,69,14384,47.8
13261,Sumter County,2021-08-28,33,14417,48
13261,Sumter County,2021-08-29,16,14433,48
13261,Sumter County,2021-08-30,45,14478,48.2
13261,Sumter County,2021-08-31,60,14538,48.4
13261,Sumter County,2021-09-01,33,14571,48.5
13261,Sumter County,2021-09-02,59,14630,48.7
13261,Sumter County,2021-09-03,96,14726,49
13261,Sumter County,2021-09-04,23,14749,49.1
13261,Sumter County,2021-09-05,12,14761,49.1
13261,Sumter County,2021-09-06,7,14768,49.1
13261,Sumter County,2021-09-07,50,14818,49.3
13261,Sumter County,2021-09-08,33,14851,49.4
13261,Sumter County,2021-09-09,42,14893,49.5
13261,Sumter County,2021-09-10,83,14976,49.8
13261,Sumter County,2021-09-11,18,14994,49.9
13261,Sumter County,2021-09-12,20,15014,49.9
13261,Sumter County,2021-09-13,28,15042,50
13261,Sumter County,2021-09-14,41,15083,50.2
13261,Sumter County,2021-09-15,36,15119,50.3
13261,Sumter County,2021-09-16,34,15153,50.4
13261,Sumter County,2021-09-17,70,15223,50.6
13261,Sumter County,2021-09-18,21,15244,50.7
13261,Sumter County,2021-09-19,14,15258,50.8
13261,Sumter County,2021-09-20,29,15287,50.8
13261,Sumter County,2021-09-21,34,15321,51
13261,Sumter County,2021-09-22,28,15349,51.1
13261,Sumter County,2021-09-23,13,15362,51.1
13261,Sumter County,2021-09-24,36,15398,51.2
13261,Sumter County,2021-09-25,12,15410,51.3
13261,Sumter County,2021-09-26,4,15414,51.3
13261,Sumter County,2021-09-27,10,15424,51.3
13261,Sumter County,2021-09-28,17,15441,51.4
13261,Sumter County,2021-09-29,11,15452,51.4
13261,Sumter County,2021-09-30,17,15469,51.5
13261,Sumter County,2021-10-01,15,15484,51.5
13261,Sumter County,2021-10-02,4,15488,51.5
13261,Sumter County,2021-10-03,5,15493,51.5
13261,Sumter County,2021-10-04,11,15504,51.6
13261,Sumter County,2021-10-05,11,15515,51.6
13261,Sumter County,2021-10-06,11,15526,51.6
13261,Sumter County,2021-10-07,14,15540,51.7
13263,Talbot County,2020-12-20,1,1,0
13263,Talbot County,2020-12-21,2,3,0
13263,Talbot County,2020-12-22,5,8,0.1
13263,Talbot County,2020-12-23,4,12,0.2
13263,Talbot County,2020-12-27,1,13,0.2
13263,Talbot County,2020-12-29,24,37,0.6
13263,Talbot County,2020-12-30,9,46,0.7
13263,Talbot County,2020-12-31,6,52,0.8
13263,Talbot County,2021-01-03,1,53,0.8
13263,Talbot County,2021-01-04,7,60,0.9
13263,Talbot County,2021-01-05,7,67,1.1
13263,Talbot County,2021-01-06,7,74,1.2
13263,Talbot County,2021-01-07,22,96,1.5
13263,Talbot County,2021-01-08,16,112,1.8
13263,Talbot County,2021-01-09,1,113,1.8
13263,Talbot County,2021-01-10,1,114,1.8
13263,Talbot County,2021-01-11,23,137,2.2
13263,Talbot County,2021-01-12,13,150,2.4
13263,Talbot County,2021-01-13,48,198,3.1
13263,Talbot County,2021-01-14,34,232,3.7
13263,Talbot County,2021-01-15,47,279,4.4
13263,Talbot County,2021-01-16,6,285,4.5
13263,Talbot County,2021-01-17,2,287,4.5
13263,Talbot County,2021-01-18,12,299,4.7
13263,Talbot County,2021-01-19,39,338,5.3
13263,Talbot County,2021-01-20,36,374,5.9
13263,Talbot County,2021-01-21,14,388,6.1
13263,Talbot County,2021-01-22,8,396,6.3
13263,Talbot County,2021-01-24,3,399,6.3
13263,Talbot County,2021-01-25,10,409,6.5
13263,Talbot County,2021-01-26,5,414,6.5
13263,Talbot County,2021-01-27,9,423,6.7
13263,Talbot County,2021-01-28,10,433,6.9
13263,Talbot County,2021-01-29,92,525,8.3
13263,Talbot County,2021-01-30,1,526,8.3
13263,Talbot County,2021-02-01,7,533,8.4
13263,Talbot County,2021-02-02,59,592,9.4
13263,Talbot County,2021-02-03,33,625,9.9
13263,Talbot County,2021-02-04,38,663,10.5
13263,Talbot County,2021-02-05,7,670,10.6
13263,Talbot County,2021-02-06,1,671,10.6
13263,Talbot County,2021-02-07,1,672,10.6
13263,Talbot County,2021-02-08,7,679,10.7
13263,Talbot County,2021-02-09,53,732,11.6
13263,Talbot County,2021-02-10,23,755,11.9
13263,Talbot County,2021-02-11,13,768,12.1
13263,Talbot County,2021-02-12,3,771,12.2
13263,Talbot County,2021-02-13,4,775,12.3
13263,Talbot County,2021-02-15,9,784,12.4
13263,Talbot County,2021-02-16,36,820,13
13263,Talbot County,2021-02-17,9,829,13.1
13263,Talbot County,2021-02-18,15,844,13.4
13263,Talbot County,2021-02-19,14,858,13.6
13263,Talbot County,2021-02-20,5,863,13.7
13263,Talbot County,2021-02-22,31,894,14.1
13263,Talbot County,2021-02-23,1,895,14.2
13263,Talbot County,2021-02-24,12,907,14.3
13263,Talbot County,2021-02-25,15,922,14.6
13263,Talbot County,2021-02-26,14,936,14.8
13263,Talbot County,2021-02-27,2,938,14.8
13263,Talbot County,2021-03-01,5,943,14.9
13263,Talbot County,2021-03-02,3,946,15
13263,Talbot County,2021-03-03,30,976,15.4
13263,Talbot County,2021-03-04,40,1016,16.1
13263,Talbot County,2021-03-05,26,1042,16.5
13263,Talbot County,2021-03-06,5,1047,16.6
13263,Talbot County,2021-03-07,1,1048,16.6
13263,Talbot County,2021-03-08,15,1063,16.8
13263,Talbot County,2021-03-09,10,1073,17
13263,Talbot County,2021-03-10,37,1110,17.6
13263,Talbot County,2021-03-11,22,1132,17.9
13263,Talbot County,2021-03-12,37,1169,18.5
13263,Talbot County,2021-03-13,2,1171,18.5
13263,Talbot County,2021-03-15,11,1182,18.7
13263,Talbot County,2021-03-16,15,1197,18.9
13263,Talbot County,2021-03-17,21,1218,19.3
13263,Talbot County,2021-03-18,67,1285,20.3
13263,Talbot County,2021-03-19,43,1328,21
13263,Talbot County,2021-03-20,1,1329,21
13263,Talbot County,2021-03-21,2,1331,21.1
13263,Talbot County,2021-03-22,11,1342,21.2
13263,Talbot County,2021-03-23,14,1356,21.5
13263,Talbot County,2021-03-24,15,1371,21.7
13263,Talbot County,2021-03-25,70,1441,22.8
13263,Talbot County,2021-03-26,72,1513,23.9
13263,Talbot County,2021-03-27,4,1517,24
13263,Talbot County,2021-03-28,1,1518,24
13263,Talbot County,2021-03-29,23,1541,24.4
13263,Talbot County,2021-03-30,23,1564,24.7
13263,Talbot County,2021-03-31,25,1589,25.1
13263,Talbot County,2021-04-01,55,1644,26
13263,Talbot County,2021-04-02,21,1665,26.3
13263,Talbot County,2021-04-03,10,1675,26.5
13263,Talbot County,2021-04-04,4,1679,26.6
13263,Talbot County,2021-04-05,14,1693,26.8
13263,Talbot County,2021-04-06,12,1705,27
13263,Talbot County,2021-04-07,37,1742,27.6
13263,Talbot County,2021-04-08,57,1799,28.5
13263,Talbot County,2021-04-09,25,1824,28.9
13263,Talbot County,2021-04-10,11,1835,29
13263,Talbot County,2021-04-11,3,1838,29.1
13263,Talbot County,2021-04-12,26,1864,29.5
13263,Talbot County,2021-04-13,11,1875,29.7
13263,Talbot County,2021-04-14,44,1919,30.4
13263,Talbot County,2021-04-15,22,1941,30.7
13263,Talbot County,2021-04-16,23,1964,31.1
13263,Talbot County,2021-04-17,2,1966,31.1
13263,Talbot County,2021-04-18,1,1967,31.1
13263,Talbot County,2021-04-19,16,1983,31.4
13263,Talbot County,2021-04-20,5,1988,31.5
13263,Talbot County,2021-04-21,24,2012,31.8
13263,Talbot County,2021-04-22,10,2022,32
13263,Talbot County,2021-04-23,20,2042,32.3
13263,Talbot County,2021-04-25,3,2045,32.4
13263,Talbot County,2021-04-26,13,2058,32.6
13263,Talbot County,2021-04-27,6,2064,32.7
13263,Talbot County,2021-04-28,6,2070,32.7
13263,Talbot County,2021-04-29,22,2092,33.1
13263,Talbot County,2021-04-30,9,2101,33.2
13263,Talbot County,2021-05-01,5,2106,33.3
13263,Talbot County,2021-05-02,2,2108,33.3
13263,Talbot County,2021-05-03,5,2113,33.4
13263,Talbot County,2021-05-04,7,2120,33.5
13263,Talbot County,2021-05-05,23,2143,33.9
13263,Talbot County,2021-05-06,10,2153,34.1
13263,Talbot County,2021-05-07,8,2161,34.2
13263,Talbot County,2021-05-08,4,2165,34.3
13263,Talbot County,2021-05-09,2,2167,34.3
13263,Talbot County,2021-05-10,10,2177,34.4
13263,Talbot County,2021-05-11,6,2183,34.5
13263,Talbot County,2021-05-12,12,2195,34.7
13263,Talbot County,2021-05-13,4,2199,34.8
13263,Talbot County,2021-05-14,6,2205,34.9
13263,Talbot County,2021-05-15,10,2215,35
13263,Talbot County,2021-05-16,6,2221,35.1
13263,Talbot County,2021-05-17,10,2231,35.3
13263,Talbot County,2021-05-18,6,2237,35.4
13263,Talbot County,2021-05-19,14,2251,35.6
13263,Talbot County,2021-05-20,15,2266,35.8
13263,Talbot County,2021-05-21,12,2278,36
13263,Talbot County,2021-05-22,4,2282,36.1
13263,Talbot County,2021-05-23,3,2285,36.1
13263,Talbot County,2021-05-24,10,2295,36.3
13263,Talbot County,2021-05-25,3,2298,36.4
13263,Talbot County,2021-05-26,11,2309,36.5
13263,Talbot County,2021-05-27,6,2315,36.6
13263,Talbot County,2021-05-28,5,2320,36.7
13263,Talbot County,2021-05-29,3,2323,36.8
13263,Talbot County,2021-05-31,2,2325,36.8
13263,Talbot County,2021-06-01,3,2328,36.8
13263,Talbot County,2021-06-02,1,2329,36.8
13263,Talbot County,2021-06-03,6,2335,36.9
13263,Talbot County,2021-06-04,7,2342,37.1
13263,Talbot County,2021-06-05,3,2345,37.1
13263,Talbot County,2021-06-06,6,2351,37.2
13263,Talbot County,2021-06-07,9,2360,37.3
13263,Talbot County,2021-06-08,5,2365,37.4
13263,Talbot County,2021-06-09,5,2370,37.5
13263,Talbot County,2021-06-10,9,2379,37.6
13263,Talbot County,2021-06-11,5,2384,37.7
13263,Talbot County,2021-06-12,4,2388,37.8
13263,Talbot County,2021-06-13,3,2391,37.8
13263,Talbot County,2021-06-14,4,2395,37.9
13263,Talbot County,2021-06-15,4,2399,38
13263,Talbot County,2021-06-16,8,2407,38.1
13263,Talbot County,2021-06-17,7,2414,38.2
13263,Talbot County,2021-06-18,8,2422,38.3
13263,Talbot County,2021-06-19,1,2423,38.3
13263,Talbot County,2021-06-20,2,2425,38.4
13263,Talbot County,2021-06-21,3,2428,38.4
13263,Talbot County,2021-06-22,8,2436,38.5
13263,Talbot County,2021-06-23,2,2438,38.6
13263,Talbot County,2021-06-24,5,2443,38.6
13263,Talbot County,2021-06-25,5,2448,38.7
13263,Talbot County,2021-06-26,1,2449,38.7
13263,Talbot County,2021-06-27,3,2452,38.8
13263,Talbot County,2021-06-28,6,2458,38.9
13263,Talbot County,2021-06-30,2,2460,38.9
13263,Talbot County,2021-07-01,1,2461,38.9
13263,Talbot County,2021-07-02,2,2463,39
13263,Talbot County,2021-07-03,3,2466,39
13263,Talbot County,2021-07-04,2,2468,39
13263,Talbot County,2021-07-05,2,2470,39.1
13263,Talbot County,2021-07-06,5,2475,39.2
13263,Talbot County,2021-07-07,1,2476,39.2
13263,Talbot County,2021-07-08,8,2484,39.3
13263,Talbot County,2021-07-09,7,2491,39.4
13263,Talbot County,2021-07-10,2,2493,39.4
13263,Talbot County,2021-07-12,5,2498,39.5
13263,Talbot County,2021-07-13,6,2504,39.6
13263,Talbot County,2021-07-14,4,2508,39.7
13263,Talbot County,2021-07-15,6,2514,39.8
13263,Talbot County,2021-07-16,3,2517,39.8
13263,Talbot County,2021-07-17,4,2521,39.9
13263,Talbot County,2021-07-18,3,2524,39.9
13263,Talbot County,2021-07-19,8,2532,40.1
13263,Talbot County,2021-07-20,4,2536,40.1
13263,Talbot County,2021-07-21,6,2542,40.2
13263,Talbot County,2021-07-22,5,2547,40.3
13263,Talbot County,2021-07-23,5,2552,40.4
13263,Talbot County,2021-07-24,6,2558,40.5
13263,Talbot County,2021-07-25,5,2563,40.5
13263,Talbot County,2021-07-26,7,2570,40.7
13263,Talbot County,2021-07-27,9,2579,40.8
13263,Talbot County,2021-07-28,10,2589,41
13263,Talbot County,2021-07-29,9,2598,41.1
13263,Talbot County,2021-07-30,9,2607,41.2
13263,Talbot County,2021-07-31,8,2615,41.4
13263,Talbot County,2021-08-01,4,2619,41.4
13263,Talbot County,2021-08-02,7,2626,41.5
13263,Talbot County,2021-08-03,13,2639,41.7
13263,Talbot County,2021-08-04,9,2648,41.9
13263,Talbot County,2021-08-05,12,2660,42.1
13263,Talbot County,2021-08-06,7,2667,42.2
13263,Talbot County,2021-08-07,7,2674,42.3
13263,Talbot County,2021-08-08,7,2681,42.4
13263,Talbot County,2021-08-09,19,2700,42.7
13263,Talbot County,2021-08-10,17,2717,43
13263,Talbot County,2021-08-11,15,2732,43.2
13263,Talbot County,2021-08-12,11,2743,43.4
13263,Talbot County,2021-08-13,21,2764,43.7
13263,Talbot County,2021-08-14,5,2769,43.8
13263,Talbot County,2021-08-15,3,2772,43.9
13263,Talbot County,2021-08-16,3,2775,43.9
13263,Talbot County,2021-08-17,13,2788,44.1
13263,Talbot County,2021-08-18,8,2796,44.2
13263,Talbot County,2021-08-19,9,2805,44.4
13263,Talbot County,2021-08-20,9,2814,44.5
13263,Talbot County,2021-08-21,9,2823,44.7
13263,Talbot County,2021-08-22,9,2832,44.8
13263,Talbot County,2021-08-23,10,2842,45
13263,Talbot County,2021-08-24,11,2853,45.1
13263,Talbot County,2021-08-25,8,2861,45.3
13263,Talbot County,2021-08-26,17,2878,45.5
13263,Talbot County,2021-08-27,12,2890,45.7
13263,Talbot County,2021-08-28,5,2895,45.8
13263,Talbot County,2021-08-29,1,2896,45.8
13263,Talbot County,2021-08-30,14,2910,46
13263,Talbot County,2021-08-31,4,2914,46.1
13263,Talbot County,2021-09-01,9,2923,46.2
13263,Talbot County,2021-09-02,7,2930,46.4
13263,Talbot County,2021-09-03,9,2939,46.5
13263,Talbot County,2021-09-04,11,2950,46.7
13263,Talbot County,2021-09-05,3,2953,46.7
13263,Talbot County,2021-09-06,2,2955,46.7
13263,Talbot County,2021-09-07,15,2970,47
13263,Talbot County,2021-09-08,9,2979,47.1
13263,Talbot County,2021-09-09,7,2986,47.2
13263,Talbot County,2021-09-10,7,2993,47.4
13263,Talbot County,2021-09-11,5,2998,47.4
13263,Talbot County,2021-09-12,6,3004,47.5
13263,Talbot County,2021-09-13,9,3013,47.7
13263,Talbot County,2021-09-14,18,3031,48
13263,Talbot County,2021-09-15,11,3042,48.1
13263,Talbot County,2021-09-16,7,3049,48.2
13263,Talbot County,2021-09-17,12,3061,48.4
13263,Talbot County,2021-09-18,6,3067,48.5
13263,Talbot County,2021-09-19,2,3069,48.6
13263,Talbot County,2021-09-20,4,3073,48.6
13263,Talbot County,2021-09-21,5,3078,48.7
13263,Talbot County,2021-09-22,10,3088,48.9
13263,Talbot County,2021-09-23,5,3093,48.9
13263,Talbot County,2021-09-24,2,3095,49
13263,Talbot County,2021-09-25,6,3101,49.1
13263,Talbot County,2021-09-26,1,3102,49.1
13263,Talbot County,2021-09-27,2,3104,49.1
13263,Talbot County,2021-09-28,3,3107,49.2
13263,Talbot County,2021-09-29,5,3112,49.2
13263,Talbot County,2021-09-30,4,3116,49.3
13263,Talbot County,2021-10-01,5,3121,49.4
13263,Talbot County,2021-10-02,3,3124,49.4
13263,Talbot County,2021-10-03,1,3125,49.4
13263,Talbot County,2021-10-05,2,3127,49.5
13263,Talbot County,2021-10-06,1,3128,49.5
13265,Taliaferro County,2020-12-18,1,1,0.1
13265,Taliaferro County,2020-12-22,2,3,0.2
13265,Taliaferro County,2020-12-23,1,4,0.2
13265,Taliaferro County,2020-12-28,1,5,0.3
13265,Taliaferro County,2020-12-29,1,6,0.4
13265,Taliaferro County,2021-01-02,1,7,0.4
13265,Taliaferro County,2021-01-03,1,8,0.5
13265,Taliaferro County,2021-01-04,1,9,0.6
13265,Taliaferro County,2021-01-06,4,13,0.8
13265,Taliaferro County,2021-01-07,1,14,0.9
13265,Taliaferro County,2021-01-09,1,15,0.9
13265,Taliaferro County,2021-01-10,1,16,1
13265,Taliaferro County,2021-01-12,1,17,1.1
13265,Taliaferro County,2021-01-14,2,19,1.2
13265,Taliaferro County,2021-01-15,3,22,1.4
13265,Taliaferro County,2021-01-16,1,23,1.4
13265,Taliaferro County,2021-01-17,1,24,1.5
13265,Taliaferro County,2021-01-19,3,27,1.7
13265,Taliaferro County,2021-01-20,5,32,2
13265,Taliaferro County,2021-01-21,7,39,2.4
13265,Taliaferro County,2021-01-22,1,40,2.5
13265,Taliaferro County,2021-01-25,4,44,2.7
13265,Taliaferro County,2021-01-26,43,87,5.4
13265,Taliaferro County,2021-01-27,1,88,5.5
13265,Taliaferro County,2021-01-28,52,140,8.7
13265,Taliaferro County,2021-01-30,1,141,8.8
13265,Taliaferro County,2021-01-31,1,142,8.8
13265,Taliaferro County,2021-02-01,3,145,9
13265,Taliaferro County,2021-02-04,5,150,9.3
13265,Taliaferro County,2021-02-05,1,151,9.4
13265,Taliaferro County,2021-02-09,4,155,9.6
13265,Taliaferro County,2021-02-11,35,190,11.8
13265,Taliaferro County,2021-02-13,1,191,11.9
13265,Taliaferro County,2021-02-15,1,192,11.9
13265,Taliaferro County,2021-02-16,17,209,13
13265,Taliaferro County,2021-02-18,3,212,13.2
13265,Taliaferro County,2021-02-23,3,215,13.3
13265,Taliaferro County,2021-02-25,5,220,13.7
13265,Taliaferro County,2021-02-27,2,222,13.8
13265,Taliaferro County,2021-03-01,1,223,13.8
13265,Taliaferro County,2021-03-02,4,227,14.1
13265,Taliaferro County,2021-03-03,2,229,14.2
13265,Taliaferro County,2021-03-04,4,233,14.5
13265,Taliaferro County,2021-03-05,1,234,14.5
13265,Taliaferro County,2021-03-07,1,235,14.6
13265,Taliaferro County,2021-03-09,6,241,15
13265,Taliaferro County,2021-03-10,2,243,15.1
13265,Taliaferro County,2021-03-11,20,263,16.3
13265,Taliaferro County,2021-03-12,6,269,16.7
13265,Taliaferro County,2021-03-13,2,271,16.8
13265,Taliaferro County,2021-03-15,7,278,17.3
13265,Taliaferro County,2021-03-16,7,285,17.7
13265,Taliaferro County,2021-03-17,5,290,18
13265,Taliaferro County,2021-03-18,7,297,18.4
13265,Taliaferro County,2021-03-19,2,299,18.6
13265,Taliaferro County,2021-03-21,1,300,18.6
13265,Taliaferro County,2021-03-22,1,301,18.7
13265,Taliaferro County,2021-03-23,34,335,20.8
13265,Taliaferro County,2021-03-24,1,336,20.9
13265,Taliaferro County,2021-03-25,19,355,22
13265,Taliaferro County,2021-03-26,9,364,22.6
13265,Taliaferro County,2021-03-27,2,366,22.7
13265,Taliaferro County,2021-03-29,5,371,23
13265,Taliaferro County,2021-03-30,3,374,23.2
13265,Taliaferro County,2021-03-31,8,382,23.7
13265,Taliaferro County,2021-04-01,7,389,24.1
13265,Taliaferro County,2021-04-02,9,398,24.7
13265,Taliaferro County,2021-04-03,1,399,24.8
13265,Taliaferro County,2021-04-04,1,400,24.8
13265,Taliaferro County,2021-04-05,4,404,25.1
13265,Taliaferro County,2021-04-06,12,416,25.8
13265,Taliaferro County,2021-04-07,1,417,25.9
13265,Taliaferro County,2021-04-08,8,425,26.4
13265,Taliaferro County,2021-04-09,7,432,26.8
13265,Taliaferro County,2021-04-11,5,437,27.1
13265,Taliaferro County,2021-04-12,4,441,27.4
13265,Taliaferro County,2021-04-13,6,447,27.7
13265,Taliaferro County,2021-04-14,4,451,28
13265,Taliaferro County,2021-04-16,2,453,28.1
13265,Taliaferro County,2021-04-19,3,456,28.3
13265,Taliaferro County,2021-04-20,14,470,29.2
13265,Taliaferro County,2021-04-21,3,473,29.4
13265,Taliaferro County,2021-04-22,6,479,29.7
13265,Taliaferro County,2021-04-26,1,480,29.8
13265,Taliaferro County,2021-04-28,1,481,29.9
13265,Taliaferro County,2021-04-29,2,483,30
13265,Taliaferro County,2021-04-30,1,484,30
13265,Taliaferro County,2021-05-03,2,486,30.2
13265,Taliaferro County,2021-05-04,1,487,30.2
13265,Taliaferro County,2021-05-05,3,490,30.4
13265,Taliaferro County,2021-05-06,6,496,30.8
13265,Taliaferro County,2021-05-07,2,498,30.9
13265,Taliaferro County,2021-05-11,1,499,31
13265,Taliaferro County,2021-05-12,1,500,31
13265,Taliaferro County,2021-05-14,7,507,31.5
13265,Taliaferro County,2021-05-16,1,508,31.5
13265,Taliaferro County,2021-05-17,3,511,31.7
13265,Taliaferro County,2021-05-18,18,529,32.8
13265,Taliaferro County,2021-05-20,3,532,33
13265,Taliaferro County,2021-05-21,2,534,33.1
13265,Taliaferro County,2021-05-22,2,536,33.3
13265,Taliaferro County,2021-05-23,1,537,33.3
13265,Taliaferro County,2021-05-24,1,538,33.4
13265,Taliaferro County,2021-05-25,1,539,33.5
13265,Taliaferro County,2021-05-26,1,540,33.5
13265,Taliaferro County,2021-05-27,1,541,33.6
13265,Taliaferro County,2021-05-28,1,542,33.6
13265,Taliaferro County,2021-05-29,2,544,33.8
13265,Taliaferro County,2021-05-31,1,545,33.8
13265,Taliaferro County,2021-06-01,1,546,33.9
13265,Taliaferro County,2021-06-03,1,547,34
13265,Taliaferro County,2021-06-05,1,548,34
13265,Taliaferro County,2021-06-09,1,549,34.1
13265,Taliaferro County,2021-06-10,3,552,34.3
13265,Taliaferro County,2021-06-14,1,553,34.3
13265,Taliaferro County,2021-06-15,3,556,34.5
13265,Taliaferro County,2021-06-16,2,558,34.6
13265,Taliaferro County,2021-06-17,1,559,34.7
13265,Taliaferro County,2021-06-18,1,560,34.8
13265,Taliaferro County,2021-06-19,4,564,35
13265,Taliaferro County,2021-06-21,2,566,35.1
13265,Taliaferro County,2021-06-22,2,568,35.3
13265,Taliaferro County,2021-06-23,4,572,35.5
13265,Taliaferro County,2021-06-24,2,574,35.6
13265,Taliaferro County,2021-06-25,1,575,35.7
13265,Taliaferro County,2021-06-28,1,576,35.8
13265,Taliaferro County,2021-06-29,2,578,35.9
13265,Taliaferro County,2021-07-01,1,579,35.9
13265,Taliaferro County,2021-07-02,2,581,36.1
13265,Taliaferro County,2021-07-03,1,582,36.1
13265,Taliaferro County,2021-07-06,1,583,36.2
13265,Taliaferro County,2021-07-07,1,584,36.3
13265,Taliaferro County,2021-07-09,1,585,36.3
13265,Taliaferro County,2021-07-10,4,589,36.6
13265,Taliaferro County,2021-07-11,3,592,36.7
13265,Taliaferro County,2021-07-13,2,594,36.9
13265,Taliaferro County,2021-07-14,2,596,37
13265,Taliaferro County,2021-07-15,2,598,37.1
13265,Taliaferro County,2021-07-19,1,599,37.2
13265,Taliaferro County,2021-07-20,3,602,37.4
13265,Taliaferro County,2021-07-21,3,605,37.6
13265,Taliaferro County,2021-07-22,3,608,37.7
13265,Taliaferro County,2021-07-23,2,610,37.9
13265,Taliaferro County,2021-07-24,2,612,38
13265,Taliaferro County,2021-07-26,2,614,38.1
13265,Taliaferro County,2021-07-28,2,616,38.2
13265,Taliaferro County,2021-07-29,9,625,38.8
13265,Taliaferro County,2021-07-30,5,630,39.1
13265,Taliaferro County,2021-07-31,2,632,39.2
13265,Taliaferro County,2021-08-01,2,634,39.4
13265,Taliaferro County,2021-08-02,3,637,39.5
13265,Taliaferro County,2021-08-03,1,638,39.6
13265,Taliaferro County,2021-08-04,4,642,39.9
13265,Taliaferro County,2021-08-05,7,649,40.3
13265,Taliaferro County,2021-08-06,4,653,40.5
13265,Taliaferro County,2021-08-07,1,654,40.6
13265,Taliaferro County,2021-08-09,3,657,40.8
13265,Taliaferro County,2021-08-10,3,660,41
13265,Taliaferro County,2021-08-11,3,663,41.2
13265,Taliaferro County,2021-08-12,3,666,41.3
13265,Taliaferro County,2021-08-13,4,670,41.6
13265,Taliaferro County,2021-08-14,3,673,41.8
13265,Taliaferro County,2021-08-16,5,678,42.1
13265,Taliaferro County,2021-08-17,1,679,42.1
13265,Taliaferro County,2021-08-18,7,686,42.6
13265,Taliaferro County,2021-08-19,2,688,42.7
13265,Taliaferro County,2021-08-20,3,691,42.9
13265,Taliaferro County,2021-08-21,3,694,43.1
13265,Taliaferro County,2021-08-22,1,695,43.1
13265,Taliaferro County,2021-08-23,4,699,43.4
13265,Taliaferro County,2021-08-24,5,704,43.7
13265,Taliaferro County,2021-08-25,3,707,43.9
13265,Taliaferro County,2021-08-26,3,710,44.1
13265,Taliaferro County,2021-08-27,1,711,44.1
13265,Taliaferro County,2021-08-30,5,716,44.4
13265,Taliaferro County,2021-08-31,2,718,44.6
13265,Taliaferro County,2021-09-01,2,720,44.7
13265,Taliaferro County,2021-09-02,4,724,44.9
13265,Taliaferro County,2021-09-06,1,725,45
13265,Taliaferro County,2021-09-07,3,728,45.2
13265,Taliaferro County,2021-09-08,7,735,45.6
13265,Taliaferro County,2021-09-09,8,743,46.1
13265,Taliaferro County,2021-09-10,1,744,46.2
13265,Taliaferro County,2021-09-12,2,746,46.3
13265,Taliaferro County,2021-09-13,1,747,46.4
13265,Taliaferro County,2021-09-14,1,748,46.4
13265,Taliaferro County,2021-09-15,1,749,46.5
13265,Taliaferro County,2021-09-16,4,753,46.7
13265,Taliaferro County,2021-09-21,2,755,46.9
13265,Taliaferro County,2021-09-22,1,756,46.9
13265,Taliaferro County,2021-09-23,7,763,47.4
13265,Taliaferro County,2021-09-24,1,764,47.4
13265,Taliaferro County,2021-09-27,1,765,47.5
13265,Taliaferro County,2021-09-28,1,766,47.5
13265,Taliaferro County,2021-09-29,1,767,47.6
13265,Taliaferro County,2021-10-01,1,768,47.7
13265,Taliaferro County,2021-10-02,1,769,47.7
13267,Tattnall County,2020-12-16,4,4,0
13267,Tattnall County,2020-12-18,1,5,0
13267,Tattnall County,2020-12-19,1,6,0
13267,Tattnall County,2020-12-20,1,7,0
13267,Tattnall County,2020-12-21,2,9,0
13267,Tattnall County,2020-12-22,4,13,0.1
13267,Tattnall County,2020-12-23,5,18,0.1
13267,Tattnall County,2020-12-24,1,19,0.1
13267,Tattnall County,2020-12-26,1,20,0.1
13267,Tattnall County,2020-12-27,2,22,0.1
13267,Tattnall County,2020-12-28,14,36,0.1
13267,Tattnall County,2020-12-29,22,58,0.2
13267,Tattnall County,2020-12-30,35,93,0.4
13267,Tattnall County,2020-12-31,6,99,0.4
13267,Tattnall County,2021-01-01,11,110,0.4
13267,Tattnall County,2021-01-02,36,146,0.6
13267,Tattnall County,2021-01-03,3,149,0.6
13267,Tattnall County,2021-01-04,25,174,0.7
13267,Tattnall County,2021-01-05,7,181,0.7
13267,Tattnall County,2021-01-06,14,195,0.8
13267,Tattnall County,2021-01-07,39,234,0.9
13267,Tattnall County,2021-01-08,22,256,1
13267,Tattnall County,2021-01-09,1,257,1
13267,Tattnall County,2021-01-11,62,319,1.3
13267,Tattnall County,2021-01-12,92,411,1.6
13267,Tattnall County,2021-01-13,83,494,1.9
13267,Tattnall County,2021-01-14,105,599,2.4
13267,Tattnall County,2021-01-15,110,709,2.8
13267,Tattnall County,2021-01-16,48,757,3
13267,Tattnall County,2021-01-17,64,821,3.2
13267,Tattnall County,2021-01-18,106,927,3.7
13267,Tattnall County,2021-01-19,51,978,3.9
13267,Tattnall County,2021-01-20,100,1078,4.2
13267,Tattnall County,2021-01-21,129,1207,4.8
13267,Tattnall County,2021-01-22,70,1277,5
13267,Tattnall County,2021-01-23,47,1324,5.2
13267,Tattnall County,2021-01-24,2,1326,5.2
13267,Tattnall County,2021-01-25,19,1345,5.3
13267,Tattnall County,2021-01-26,33,1378,5.4
13267,Tattnall County,2021-01-27,59,1437,5.7
13267,Tattnall County,2021-01-28,100,1537,6.1
13267,Tattnall County,2021-01-29,37,1574,6.2
13267,Tattnall County,2021-01-30,1,1575,6.2
13267,Tattnall County,2021-01-31,2,1577,6.2
13267,Tattnall County,2021-02-01,16,1593,6.3
13267,Tattnall County,2021-02-02,69,1662,6.5
13267,Tattnall County,2021-02-03,36,1698,6.7
13267,Tattnall County,2021-02-04,52,1750,6.9
13267,Tattnall County,2021-02-05,57,1807,7.1
13267,Tattnall County,2021-02-06,2,1809,7.1
13267,Tattnall County,2021-02-08,17,1826,7.2
13267,Tattnall County,2021-02-09,30,1856,7.3
13267,Tattnall County,2021-02-10,68,1924,7.6
13267,Tattnall County,2021-02-11,45,1969,7.8
13267,Tattnall County,2021-02-12,66,2035,8
13267,Tattnall County,2021-02-13,25,2060,8.1
13267,Tattnall County,2021-02-14,3,2063,8.1
13267,Tattnall County,2021-02-15,27,2090,8.2
13267,Tattnall County,2021-02-16,33,2123,8.4
13267,Tattnall County,2021-02-17,85,2208,8.7
13267,Tattnall County,2021-02-18,87,2295,9
13267,Tattnall County,2021-02-19,60,2355,9.3
13267,Tattnall County,2021-02-20,31,2386,9.4
13267,Tattnall County,2021-02-21,1,2387,9.4
13267,Tattnall County,2021-02-22,24,2411,9.5
13267,Tattnall County,2021-02-23,56,2467,9.7
13267,Tattnall County,2021-02-24,55,2522,9.9
13267,Tattnall County,2021-02-25,77,2599,10.2
13267,Tattnall County,2021-02-26,34,2633,10.4
13267,Tattnall County,2021-02-27,11,2644,10.4
13267,Tattnall County,2021-02-28,6,2650,10.4
13267,Tattnall County,2021-03-01,38,2688,10.6
13267,Tattnall County,2021-03-02,30,2718,10.7
13267,Tattnall County,2021-03-03,42,2760,10.9
13267,Tattnall County,2021-03-04,60,2820,11.1
13267,Tattnall County,2021-03-05,33,2853,11.2
13267,Tattnall County,2021-03-06,2,2855,11.2
13267,Tattnall County,2021-03-07,10,2865,11.3
13267,Tattnall County,2021-03-08,57,2922,11.5
13267,Tattnall County,2021-03-09,71,2993,11.8
13267,Tattnall County,2021-03-10,65,3058,12
13267,Tattnall County,2021-03-11,75,3133,12.3
13267,Tattnall County,2021-03-12,52,3185,12.5
13267,Tattnall County,2021-03-13,15,3200,12.6
13267,Tattnall County,2021-03-14,13,3213,12.7
13267,Tattnall County,2021-03-15,67,3280,12.9
13267,Tattnall County,2021-03-16,44,3324,13.1
13267,Tattnall County,2021-03-17,93,3417,13.5
13267,Tattnall County,2021-03-18,44,3461,13.6
13267,Tattnall County,2021-03-19,42,3503,13.8
13267,Tattnall County,2021-03-20,59,3562,14
13267,Tattnall County,2021-03-21,7,3569,14.1
13267,Tattnall County,2021-03-22,22,3591,14.1
13267,Tattnall County,2021-03-23,35,3626,14.3
13267,Tattnall County,2021-03-24,101,3727,14.7
13267,Tattnall County,2021-03-25,92,3819,15
13267,Tattnall County,2021-03-26,58,3877,15.3
13267,Tattnall County,2021-03-27,7,3884,15.3
13267,Tattnall County,2021-03-28,19,3903,15.4
13267,Tattnall County,2021-03-29,42,3945,15.5
13267,Tattnall County,2021-03-30,95,4040,15.9
13267,Tattnall County,2021-03-31,113,4153,16.4
13267,Tattnall County,2021-04-01,102,4255,16.8
13267,Tattnall County,2021-04-02,216,4471,17.6
13267,Tattnall County,2021-04-03,11,4482,17.7
13267,Tattnall County,2021-04-04,10,4492,17.7
13267,Tattnall County,2021-04-05,53,4545,17.9
13267,Tattnall County,2021-04-06,65,4610,18.2
13267,Tattnall County,2021-04-07,55,4665,18.4
13267,Tattnall County,2021-04-08,242,4907,19.3
13267,Tattnall County,2021-04-09,37,4944,19.5
13267,Tattnall County,2021-04-10,65,5009,19.7
13267,Tattnall County,2021-04-11,6,5015,19.8
13267,Tattnall County,2021-04-12,26,5041,19.9
13267,Tattnall County,2021-04-13,35,5076,20
13267,Tattnall County,2021-04-14,55,5131,20.2
13267,Tattnall County,2021-04-15,27,5158,20.3
13267,Tattnall County,2021-04-16,35,5193,20.5
13267,Tattnall County,2021-04-17,4,5197,20.5
13267,Tattnall County,2021-04-18,4,5201,20.5
13267,Tattnall County,2021-04-19,8,5209,20.5
13267,Tattnall County,2021-04-20,17,5226,20.6
13267,Tattnall County,2021-04-21,48,5274,20.8
13267,Tattnall County,2021-04-22,77,5351,21.1
13267,Tattnall County,2021-04-23,25,5376,21.2
13267,Tattnall County,2021-04-24,31,5407,21.3
13267,Tattnall County,2021-04-25,1,5408,21.3
13267,Tattnall County,2021-04-26,25,5433,21.4
13267,Tattnall County,2021-04-27,44,5477,21.6
13267,Tattnall County,2021-04-28,31,5508,21.7
13267,Tattnall County,2021-04-29,89,5597,22.1
13267,Tattnall County,2021-04-30,39,5636,22.2
13267,Tattnall County,2021-05-01,8,5644,22.2
13267,Tattnall County,2021-05-02,2,5646,22.2
13267,Tattnall County,2021-05-03,21,5667,22.3
13267,Tattnall County,2021-05-04,21,5688,22.4
13267,Tattnall County,2021-05-05,13,5701,22.5
13267,Tattnall County,2021-05-06,40,5741,22.6
13267,Tattnall County,2021-05-07,42,5783,22.8
13267,Tattnall County,2021-05-08,20,5803,22.9
13267,Tattnall County,2021-05-10,11,5814,22.9
13267,Tattnall County,2021-05-11,19,5833,23
13267,Tattnall County,2021-05-12,13,5846,23
13267,Tattnall County,2021-05-13,9,5855,23.1
13267,Tattnall County,2021-05-14,26,5881,23.2
13267,Tattnall County,2021-05-15,11,5892,23.2
13267,Tattnall County,2021-05-16,3,5895,23.2
13267,Tattnall County,2021-05-17,17,5912,23.3
13267,Tattnall County,2021-05-18,55,5967,23.5
13267,Tattnall County,2021-05-19,37,6004,23.7
13267,Tattnall County,2021-05-20,21,6025,23.7
13267,Tattnall County,2021-05-21,24,6049,23.8
13267,Tattnall County,2021-05-22,17,6066,23.9
13267,Tattnall County,2021-05-23,3,6069,23.9
13267,Tattnall County,2021-05-24,12,6081,24
13267,Tattnall County,2021-05-25,21,6102,24
13267,Tattnall County,2021-05-26,25,6127,24.1
13267,Tattnall County,2021-05-27,18,6145,24.2
13267,Tattnall County,2021-05-28,4,6149,24.2
13267,Tattnall County,2021-05-29,3,6152,24.2
13267,Tattnall County,2021-05-30,3,6155,24.2
13267,Tattnall County,2021-05-31,1,6156,24.3
13267,Tattnall County,2021-06-01,13,6169,24.3
13267,Tattnall County,2021-06-02,20,6189,24.4
13267,Tattnall County,2021-06-03,22,6211,24.5
13267,Tattnall County,2021-06-04,6,6217,24.5
13267,Tattnall County,2021-06-05,14,6231,24.5
13267,Tattnall County,2021-06-06,5,6236,24.6
13267,Tattnall County,2021-06-07,8,6244,24.6
13267,Tattnall County,2021-06-08,16,6260,24.7
13267,Tattnall County,2021-06-09,6,6266,24.7
13267,Tattnall County,2021-06-10,24,6290,24.8
13267,Tattnall County,2021-06-11,6,6296,24.8
13267,Tattnall County,2021-06-12,18,6314,24.9
13267,Tattnall County,2021-06-13,5,6319,24.9
13267,Tattnall County,2021-06-14,12,6331,24.9
13267,Tattnall County,2021-06-15,16,6347,25
13267,Tattnall County,2021-06-16,18,6365,25.1
13267,Tattnall County,2021-06-17,18,6383,25.1
13267,Tattnall County,2021-06-18,13,6396,25.2
13267,Tattnall County,2021-06-19,3,6399,25.2
13267,Tattnall County,2021-06-20,1,6400,25.2
13267,Tattnall County,2021-06-21,5,6405,25.2
13267,Tattnall County,2021-06-22,9,6414,25.3
13267,Tattnall County,2021-06-23,19,6433,25.3
13267,Tattnall County,2021-06-24,6,6439,25.4
13267,Tattnall County,2021-06-25,15,6454,25.4
13267,Tattnall County,2021-06-26,5,6459,25.4
13267,Tattnall County,2021-06-27,8,6467,25.5
13267,Tattnall County,2021-06-28,8,6475,25.5
13267,Tattnall County,2021-06-29,8,6483,25.5
13267,Tattnall County,2021-06-30,17,6500,25.6
13267,Tattnall County,2021-07-01,19,6519,25.7
13267,Tattnall County,2021-07-02,5,6524,25.7
13267,Tattnall County,2021-07-03,8,6532,25.7
13267,Tattnall County,2021-07-05,7,6539,25.8
13267,Tattnall County,2021-07-06,8,6547,25.8
13267,Tattnall County,2021-07-07,9,6556,25.8
13267,Tattnall County,2021-07-08,9,6565,25.9
13267,Tattnall County,2021-07-09,13,6578,25.9
13267,Tattnall County,2021-07-10,3,6581,25.9
13267,Tattnall County,2021-07-11,2,6583,25.9
13267,Tattnall County,2021-07-12,6,6589,26
13267,Tattnall County,2021-07-13,14,6603,26
13267,Tattnall County,2021-07-14,29,6632,26.1
13267,Tattnall County,2021-07-15,10,6642,26.2
13267,Tattnall County,2021-07-16,17,6659,26.2
13267,Tattnall County,2021-07-17,5,6664,26.3
13267,Tattnall County,2021-07-18,3,6667,26.3
13267,Tattnall County,2021-07-19,10,6677,26.3
13267,Tattnall County,2021-07-20,23,6700,26.4
13267,Tattnall County,2021-07-21,26,6726,26.5
13267,Tattnall County,2021-07-22,45,6771,26.7
13267,Tattnall County,2021-07-23,34,6805,26.8
13267,Tattnall County,2021-07-24,38,6843,27
13267,Tattnall County,2021-07-25,8,6851,27
13267,Tattnall County,2021-07-26,33,6884,27.1
13267,Tattnall County,2021-07-27,38,6922,27.3
13267,Tattnall County,2021-07-28,54,6976,27.5
13267,Tattnall County,2021-07-29,72,7048,27.8
13267,Tattnall County,2021-07-30,33,7081,27.9
13267,Tattnall County,2021-07-31,29,7110,28
13267,Tattnall County,2021-08-01,10,7120,28.1
13267,Tattnall County,2021-08-02,29,7149,28.2
13267,Tattnall County,2021-08-03,39,7188,28.3
13267,Tattnall County,2021-08-04,75,7263,28.6
13267,Tattnall County,2021-08-05,51,7314,28.8
13267,Tattnall County,2021-08-06,49,7363,29
13267,Tattnall County,2021-08-07,28,7391,29.1
13267,Tattnall County,2021-08-08,11,7402,29.2
13267,Tattnall County,2021-08-09,51,7453,29.4
13267,Tattnall County,2021-08-10,45,7498,29.5
13267,Tattnall County,2021-08-11,49,7547,29.7
13267,Tattnall County,2021-08-12,45,7592,29.9
13267,Tattnall County,2021-08-13,71,7663,30.2
13267,Tattnall County,2021-08-14,32,7695,30.3
13267,Tattnall County,2021-08-15,7,7702,30.3
13267,Tattnall County,2021-08-16,46,7748,30.5
13267,Tattnall County,2021-08-17,51,7799,30.7
13267,Tattnall County,2021-08-18,53,7852,30.9
13267,Tattnall County,2021-08-19,52,7904,31.1
13267,Tattnall County,2021-08-20,76,7980,31.4
13267,Tattnall County,2021-08-21,21,8001,31.5
13267,Tattnall County,2021-08-22,13,8014,31.6
13267,Tattnall County,2021-08-23,32,8046,31.7
13267,Tattnall County,2021-08-24,45,8091,31.9
13267,Tattnall County,2021-08-25,41,8132,32
13267,Tattnall County,2021-08-26,28,8160,32.1
13267,Tattnall County,2021-08-27,43,8203,32.3
13267,Tattnall County,2021-08-28,45,8248,32.5
13267,Tattnall County,2021-08-29,14,8262,32.6
13267,Tattnall County,2021-08-30,26,8288,32.7
13267,Tattnall County,2021-08-31,23,8311,32.7
13267,Tattnall County,2021-09-01,30,8341,32.9
13267,Tattnall County,2021-09-02,36,8377,33
13267,Tattnall County,2021-09-03,46,8423,33.2
13267,Tattnall County,2021-09-04,12,8435,33.2
13267,Tattnall County,2021-09-05,11,8446,33.3
13267,Tattnall County,2021-09-06,3,8449,33.3
13267,Tattnall County,2021-09-07,24,8473,33.4
13267,Tattnall County,2021-09-08,32,8505,33.5
13267,Tattnall County,2021-09-09,30,8535,33.6
13267,Tattnall County,2021-09-10,46,8581,33.8
13267,Tattnall County,2021-09-11,15,8596,33.9
13267,Tattnall County,2021-09-12,8,8604,33.9
13267,Tattnall County,2021-09-13,19,8623,34
13267,Tattnall County,2021-09-14,34,8657,34.1
13267,Tattnall County,2021-09-15,25,8682,34.2
13267,Tattnall County,2021-09-16,20,8702,34.3
13267,Tattnall County,2021-09-17,21,8723,34.4
13267,Tattnall County,2021-09-18,8,8731,34.4
13267,Tattnall County,2021-09-19,3,8734,34.4
13267,Tattnall County,2021-09-20,11,8745,34.5
13267,Tattnall County,2021-09-21,15,8760,34.5
13267,Tattnall County,2021-09-22,34,8794,34.6
13267,Tattnall County,2021-09-23,9,8803,34.7
13267,Tattnall County,2021-09-24,5,8808,34.7
13267,Tattnall County,2021-09-25,8,8816,34.7
13267,Tattnall County,2021-09-26,1,8817,34.7
13267,Tattnall County,2021-09-27,5,8822,34.8
13267,Tattnall County,2021-09-28,7,8829,34.8
13267,Tattnall County,2021-09-29,12,8841,34.8
13267,Tattnall County,2021-09-30,10,8851,34.9
13267,Tattnall County,2021-10-01,19,8870,34.9
13267,Tattnall County,2021-10-02,4,8874,35
13267,Tattnall County,2021-10-04,2,8876,35
13267,Tattnall County,2021-10-05,9,8885,35
13267,Tattnall County,2021-10-06,6,8891,35
13267,Tattnall County,2021-10-07,3,8894,35
13269,Taylor County,2020-12-21,1,1,0
13269,Taylor County,2020-12-22,4,5,0.1
13269,Taylor County,2020-12-23,8,13,0.2
13269,Taylor County,2020-12-24,3,16,0.2
13269,Taylor County,2020-12-26,1,17,0.2
13269,Taylor County,2020-12-28,5,22,0.3
13269,Taylor County,2020-12-29,9,31,0.4
13269,Taylor County,2020-12-30,2,33,0.4
13269,Taylor County,2020-12-31,6,39,0.5
13269,Taylor County,2021-01-01,1,40,0.5
13269,Taylor County,2021-01-02,1,41,0.5
13269,Taylor County,2021-01-03,45,86,1.1
13269,Taylor County,2021-01-04,7,93,1.1
13269,Taylor County,2021-01-05,27,120,1.5
13269,Taylor County,2021-01-06,12,132,1.6
13269,Taylor County,2021-01-07,26,158,1.9
13269,Taylor County,2021-01-08,5,163,2
13269,Taylor County,2021-01-11,51,214,2.6
13269,Taylor County,2021-01-12,57,271,3.3
13269,Taylor County,2021-01-13,31,302,3.7
13269,Taylor County,2021-01-14,75,377,4.6
13269,Taylor County,2021-01-15,26,403,5
13269,Taylor County,2021-01-16,3,406,5
13269,Taylor County,2021-01-17,2,408,5
13269,Taylor County,2021-01-18,131,539,6.6
13269,Taylor County,2021-01-19,44,583,7.2
13269,Taylor County,2021-01-20,89,672,8.3
13269,Taylor County,2021-01-21,23,695,8.6
13269,Taylor County,2021-01-22,31,726,8.9
13269,Taylor County,2021-01-23,1,727,9
13269,Taylor County,2021-01-24,12,739,9.1
13269,Taylor County,2021-01-25,8,747,9.2
13269,Taylor County,2021-01-26,13,760,9.4
13269,Taylor County,2021-01-27,24,784,9.7
13269,Taylor County,2021-01-28,5,789,9.7
13269,Taylor County,2021-01-29,16,805,9.9
13269,Taylor County,2021-01-30,1,806,9.9
13269,Taylor County,2021-01-31,2,808,10
13269,Taylor County,2021-02-01,11,819,10.1
13269,Taylor County,2021-02-02,27,846,10.4
13269,Taylor County,2021-02-03,32,878,10.8
13269,Taylor County,2021-02-04,26,904,11.1
13269,Taylor County,2021-02-05,20,924,11.4
13269,Taylor County,2021-02-06,1,925,11.4
13269,Taylor County,2021-02-08,10,935,11.5
13269,Taylor County,2021-02-09,25,960,11.8
13269,Taylor County,2021-02-10,6,966,11.9
13269,Taylor County,2021-02-11,32,998,12.3
13269,Taylor County,2021-02-12,7,1005,12.4
13269,Taylor County,2021-02-13,1,1006,12.4
13269,Taylor County,2021-02-14,1,1007,12.4
13269,Taylor County,2021-02-15,10,1017,12.5
13269,Taylor County,2021-02-16,8,1025,12.6
13269,Taylor County,2021-02-17,7,1032,12.7
13269,Taylor County,2021-02-18,19,1051,12.9
13269,Taylor County,2021-02-19,1,1052,13
13269,Taylor County,2021-02-22,7,1059,13
13269,Taylor County,2021-02-23,4,1063,13.1
13269,Taylor County,2021-02-24,8,1071,13.2
13269,Taylor County,2021-02-25,105,1176,14.5
13269,Taylor County,2021-02-26,7,1183,14.6
13269,Taylor County,2021-03-01,7,1190,14.7
13269,Taylor County,2021-03-02,22,1212,14.9
13269,Taylor County,2021-03-03,15,1227,15.1
13269,Taylor County,2021-03-04,26,1253,15.4
13269,Taylor County,2021-03-05,8,1261,15.5
13269,Taylor County,2021-03-07,1,1262,15.5
13269,Taylor County,2021-03-08,16,1278,15.7
13269,Taylor County,2021-03-09,26,1304,16.1
13269,Taylor County,2021-03-10,23,1327,16.4
13269,Taylor County,2021-03-11,52,1379,17
13269,Taylor County,2021-03-12,21,1400,17.2
13269,Taylor County,2021-03-13,3,1403,17.3
13269,Taylor County,2021-03-14,1,1404,17.3
13269,Taylor County,2021-03-15,24,1428,17.6
13269,Taylor County,2021-03-16,26,1454,17.9
13269,Taylor County,2021-03-17,54,1508,18.6
13269,Taylor County,2021-03-18,23,1531,18.9
13269,Taylor County,2021-03-19,75,1606,19.8
13269,Taylor County,2021-03-22,36,1642,20.2
13269,Taylor County,2021-03-23,121,1763,21.7
13269,Taylor County,2021-03-24,66,1829,22.5
13269,Taylor County,2021-03-25,53,1882,23.2
13269,Taylor County,2021-03-26,52,1934,23.8
13269,Taylor County,2021-03-27,2,1936,23.9
13269,Taylor County,2021-03-28,1,1937,23.9
13269,Taylor County,2021-03-29,39,1976,24.3
13269,Taylor County,2021-03-30,43,2019,24.9
13269,Taylor County,2021-03-31,35,2054,25.3
13269,Taylor County,2021-04-01,65,2119,26.1
13269,Taylor County,2021-04-02,31,2150,26.5
13269,Taylor County,2021-04-03,5,2155,26.6
13269,Taylor County,2021-04-04,2,2157,26.6
13269,Taylor County,2021-04-05,9,2166,26.7
13269,Taylor County,2021-04-06,37,2203,27.1
13269,Taylor County,2021-04-07,37,2240,27.6
13269,Taylor County,2021-04-08,40,2280,28.1
13269,Taylor County,2021-04-09,30,2310,28.5
13269,Taylor County,2021-04-10,8,2318,28.6
13269,Taylor County,2021-04-11,1,2319,28.6
13269,Taylor County,2021-04-12,8,2327,28.7
13269,Taylor County,2021-04-13,14,2341,28.8
13269,Taylor County,2021-04-14,17,2358,29.1
13269,Taylor County,2021-04-15,27,2385,29.4
13269,Taylor County,2021-04-16,18,2403,29.6
13269,Taylor County,2021-04-17,10,2413,29.7
13269,Taylor County,2021-04-18,1,2414,29.7
13269,Taylor County,2021-04-19,11,2425,29.9
13269,Taylor County,2021-04-20,11,2436,30
13269,Taylor County,2021-04-21,18,2454,30.2
13269,Taylor County,2021-04-22,10,2464,30.4
13269,Taylor County,2021-04-23,12,2476,30.5
13269,Taylor County,2021-04-24,1,2477,30.5
13269,Taylor County,2021-04-26,7,2484,30.6
13269,Taylor County,2021-04-27,26,2510,30.9
13269,Taylor County,2021-04-28,16,2526,31.1
13269,Taylor County,2021-04-29,9,2535,31.2
13269,Taylor County,2021-04-30,14,2549,31.4
13269,Taylor County,2021-05-01,3,2552,31.4
13269,Taylor County,2021-05-02,2,2554,31.5
13269,Taylor County,2021-05-03,7,2561,31.6
13269,Taylor County,2021-05-04,9,2570,31.7
13269,Taylor County,2021-05-05,9,2579,31.8
13269,Taylor County,2021-05-06,16,2595,32
13269,Taylor County,2021-05-07,15,2610,32.2
13269,Taylor County,2021-05-08,3,2613,32.2
13269,Taylor County,2021-05-10,9,2622,32.3
13269,Taylor County,2021-05-11,2,2624,32.3
13269,Taylor County,2021-05-12,12,2636,32.5
13269,Taylor County,2021-05-13,25,2661,32.8
13269,Taylor County,2021-05-14,13,2674,32.9
13269,Taylor County,2021-05-15,3,2677,33
13269,Taylor County,2021-05-16,3,2680,33
13269,Taylor County,2021-05-17,9,2689,33.1
13269,Taylor County,2021-05-18,15,2704,33.3
13269,Taylor County,2021-05-19,6,2710,33.4
13269,Taylor County,2021-05-20,5,2715,33.5
13269,Taylor County,2021-05-21,11,2726,33.6
13269,Taylor County,2021-05-22,1,2727,33.6
13269,Taylor County,2021-05-23,2,2729,33.6
13269,Taylor County,2021-05-24,4,2733,33.7
13269,Taylor County,2021-05-25,19,2752,33.9
13269,Taylor County,2021-05-26,5,2757,34
13269,Taylor County,2021-05-27,4,2761,34
13269,Taylor County,2021-05-28,7,2768,34.1
13269,Taylor County,2021-05-29,2,2770,34.1
13269,Taylor County,2021-06-01,10,2780,34.3
13269,Taylor County,2021-06-02,9,2789,34.4
13269,Taylor County,2021-06-03,6,2795,34.4
13269,Taylor County,2021-06-04,9,2804,34.5
13269,Taylor County,2021-06-05,2,2806,34.6
13269,Taylor County,2021-06-06,1,2807,34.6
13269,Taylor County,2021-06-07,5,2812,34.6
13269,Taylor County,2021-06-08,4,2816,34.7
13269,Taylor County,2021-06-09,8,2824,34.8
13269,Taylor County,2021-06-10,4,2828,34.8
13269,Taylor County,2021-06-11,3,2831,34.9
13269,Taylor County,2021-06-12,5,2836,34.9
13269,Taylor County,2021-06-14,4,2840,35
13269,Taylor County,2021-06-15,1,2841,35
13269,Taylor County,2021-06-16,5,2846,35.1
13269,Taylor County,2021-06-17,5,2851,35.1
13269,Taylor County,2021-06-19,2,2853,35.2
13269,Taylor County,2021-06-20,1,2854,35.2
13269,Taylor County,2021-06-21,4,2858,35.2
13269,Taylor County,2021-06-22,5,2863,35.3
13269,Taylor County,2021-06-23,5,2868,35.3
13269,Taylor County,2021-06-24,4,2872,35.4
13269,Taylor County,2021-06-25,2,2874,35.4
13269,Taylor County,2021-06-26,4,2878,35.5
13269,Taylor County,2021-06-27,1,2879,35.5
13269,Taylor County,2021-06-28,3,2882,35.5
13269,Taylor County,2021-06-29,12,2894,35.7
13269,Taylor County,2021-07-01,2,2896,35.7
13269,Taylor County,2021-07-02,5,2901,35.7
13269,Taylor County,2021-07-03,1,2902,35.8
13269,Taylor County,2021-07-06,4,2906,35.8
13269,Taylor County,2021-07-07,2,2908,35.8
13269,Taylor County,2021-07-08,5,2913,35.9
13269,Taylor County,2021-07-09,9,2922,36
13269,Taylor County,2021-07-12,2,2924,36
13269,Taylor County,2021-07-13,4,2928,36.1
13269,Taylor County,2021-07-14,5,2933,36.1
13269,Taylor County,2021-07-15,2,2935,36.2
13269,Taylor County,2021-07-16,7,2942,36.2
13269,Taylor County,2021-07-17,5,2947,36.3
13269,Taylor County,2021-07-19,5,2952,36.4
13269,Taylor County,2021-07-20,13,2965,36.5
13269,Taylor County,2021-07-21,8,2973,36.6
13269,Taylor County,2021-07-22,5,2978,36.7
13269,Taylor County,2021-07-23,9,2987,36.8
13269,Taylor County,2021-07-24,5,2992,36.9
13269,Taylor County,2021-07-25,4,2996,36.9
13269,Taylor County,2021-07-26,14,3010,37.1
13269,Taylor County,2021-07-27,9,3019,37.2
13269,Taylor County,2021-07-28,9,3028,37.3
13269,Taylor County,2021-07-29,32,3060,37.7
13269,Taylor County,2021-07-30,29,3089,38.1
13269,Taylor County,2021-07-31,9,3098,38.2
13269,Taylor County,2021-08-01,4,3102,38.2
13269,Taylor County,2021-08-02,7,3109,38.3
13269,Taylor County,2021-08-03,9,3118,38.4
13269,Taylor County,2021-08-04,8,3126,38.5
13269,Taylor County,2021-08-05,20,3146,38.8
13269,Taylor County,2021-08-06,37,3183,39.2
13269,Taylor County,2021-08-07,5,3188,39.3
13269,Taylor County,2021-08-08,5,3193,39.3
13269,Taylor County,2021-08-09,8,3201,39.4
13269,Taylor County,2021-08-10,13,3214,39.6
13269,Taylor County,2021-08-11,11,3225,39.7
13269,Taylor County,2021-08-12,28,3253,40.1
13269,Taylor County,2021-08-13,32,3285,40.5
13269,Taylor County,2021-08-14,34,3319,40.9
13269,Taylor County,2021-08-15,5,3324,41
13269,Taylor County,2021-08-16,7,3331,41
13269,Taylor County,2021-08-17,28,3359,41.4
13269,Taylor County,2021-08-18,15,3374,41.6
13269,Taylor County,2021-08-19,28,3402,41.9
13269,Taylor County,2021-08-20,15,3417,42.1
13269,Taylor County,2021-08-21,11,3428,42.2
13269,Taylor County,2021-08-22,7,3435,42.3
13269,Taylor County,2021-08-23,18,3453,42.5
13269,Taylor County,2021-08-24,39,3492,43
13269,Taylor County,2021-08-25,13,3505,43.2
13269,Taylor County,2021-08-26,34,3539,43.6
13269,Taylor County,2021-08-27,34,3573,44
13269,Taylor County,2021-08-28,11,3584,44.2
13269,Taylor County,2021-08-29,7,3591,44.2
13269,Taylor County,2021-08-30,9,3600,44.4
13269,Taylor County,2021-08-31,25,3625,44.7
13269,Taylor County,2021-09-01,15,3640,44.8
13269,Taylor County,2021-09-02,27,3667,45.2
13269,Taylor County,2021-09-03,20,3687,45.4
13269,Taylor County,2021-09-04,17,3704,45.6
13269,Taylor County,2021-09-05,3,3707,45.7
13269,Taylor County,2021-09-07,11,3718,45.8
13269,Taylor County,2021-09-08,11,3729,45.9
13269,Taylor County,2021-09-09,14,3743,46.1
13269,Taylor County,2021-09-10,23,3766,46.4
13269,Taylor County,2021-09-11,8,3774,46.5
13269,Taylor County,2021-09-12,3,3777,46.5
13269,Taylor County,2021-09-13,5,3782,46.6
13269,Taylor County,2021-09-14,12,3794,46.7
13269,Taylor County,2021-09-15,8,3802,46.8
13269,Taylor County,2021-09-16,9,3811,47
13269,Taylor County,2021-09-17,9,3820,47.1
13269,Taylor County,2021-09-18,3,3823,47.1
13269,Taylor County,2021-09-20,6,3829,47.2
13269,Taylor County,2021-09-21,7,3836,47.3
13269,Taylor County,2021-09-22,4,3840,47.3
13269,Taylor County,2021-09-23,17,3857,47.5
13269,Taylor County,2021-09-24,9,3866,47.6
13269,Taylor County,2021-09-25,1,3867,47.6
13269,Taylor County,2021-09-26,2,3869,47.7
13269,Taylor County,2021-09-27,5,3874,47.7
13269,Taylor County,2021-09-28,9,3883,47.8
13269,Taylor County,2021-09-29,2,3885,47.9
13269,Taylor County,2021-09-30,7,3892,48
13269,Taylor County,2021-10-01,4,3896,48
13269,Taylor County,2021-10-02,1,3897,48
13269,Taylor County,2021-10-04,1,3898,48
13269,Taylor County,2021-10-05,5,3903,48.1
13269,Taylor County,2021-10-06,3,3906,48.1
13269,Taylor County,2021-10-07,5,3911,48.2
13271,Telfair County,2020-12-17,1,1,0
13271,Telfair County,2020-12-18,5,6,0
13271,Telfair County,2020-12-20,1,7,0
13271,Telfair County,2020-12-21,2,9,0.1
13271,Telfair County,2020-12-22,2,11,0.1
13271,Telfair County,2020-12-23,4,15,0.1
13271,Telfair County,2020-12-24,1,16,0.1
13271,Telfair County,2020-12-28,29,45,0.3
13271,Telfair County,2020-12-29,30,75,0.5
13271,Telfair County,2020-12-30,35,110,0.7
13271,Telfair County,2020-12-31,35,145,0.9
13271,Telfair County,2021-01-01,1,146,0.9
13271,Telfair County,2021-01-02,1,147,0.9
13271,Telfair County,2021-01-03,6,153,1
13271,Telfair County,2021-01-04,38,191,1.2
13271,Telfair County,2021-01-05,18,209,1.3
13271,Telfair County,2021-01-06,13,222,1.4
13271,Telfair County,2021-01-07,39,261,1.6
13271,Telfair County,2021-01-08,9,270,1.7
13271,Telfair County,2021-01-09,10,280,1.7
13271,Telfair County,2021-01-10,2,282,1.8
13271,Telfair County,2021-01-11,117,399,2.5
13271,Telfair County,2021-01-12,169,568,3.5
13271,Telfair County,2021-01-13,25,593,3.7
13271,Telfair County,2021-01-14,16,609,3.8
13271,Telfair County,2021-01-15,28,637,4
13271,Telfair County,2021-01-16,2,639,4
13271,Telfair County,2021-01-17,1,640,4
13271,Telfair County,2021-01-18,21,661,4.1
13271,Telfair County,2021-01-19,195,856,5.3
13271,Telfair County,2021-01-20,28,884,5.5
13271,Telfair County,2021-01-21,19,903,5.6
13271,Telfair County,2021-01-22,6,909,5.7
13271,Telfair County,2021-01-23,3,912,5.7
13271,Telfair County,2021-01-25,30,942,5.9
13271,Telfair County,2021-01-26,150,1092,6.8
13271,Telfair County,2021-01-27,21,1113,6.9
13271,Telfair County,2021-01-28,20,1133,7.1
13271,Telfair County,2021-01-29,6,1139,7.1
13271,Telfair County,2021-01-30,2,1141,7.1
13271,Telfair County,2021-02-01,7,1148,7.2
13271,Telfair County,2021-02-02,124,1272,7.9
13271,Telfair County,2021-02-03,32,1304,8.1
13271,Telfair County,2021-02-04,5,1309,8.2
13271,Telfair County,2021-02-05,5,1314,8.2
13271,Telfair County,2021-02-06,3,1317,8.2
13271,Telfair County,2021-02-08,36,1353,8.4
13271,Telfair County,2021-02-09,32,1385,8.6
13271,Telfair County,2021-02-10,20,1405,8.8
13271,Telfair County,2021-02-11,15,1420,8.9
13271,Telfair County,2021-02-12,8,1428,8.9
13271,Telfair County,2021-02-14,1,1429,8.9
13271,Telfair County,2021-02-15,6,1435,8.9
13271,Telfair County,2021-02-16,56,1491,9.3
13271,Telfair County,2021-02-17,9,1500,9.4
13271,Telfair County,2021-02-18,2,1502,9.4
13271,Telfair County,2021-02-19,4,1506,9.4
13271,Telfair County,2021-02-22,5,1511,9.4
13271,Telfair County,2021-02-23,54,1565,9.8
13271,Telfair County,2021-02-24,3,1568,9.8
13271,Telfair County,2021-02-25,8,1576,9.8
13271,Telfair County,2021-02-26,4,1580,9.9
13271,Telfair County,2021-03-01,14,1594,9.9
13271,Telfair County,2021-03-02,49,1643,10.2
13271,Telfair County,2021-03-03,4,1647,10.3
13271,Telfair County,2021-03-04,8,1655,10.3
13271,Telfair County,2021-03-05,2,1657,10.3
13271,Telfair County,2021-03-06,2,1659,10.3
13271,Telfair County,2021-03-07,1,1660,10.4
13271,Telfair County,2021-03-08,10,1670,10.4
13271,Telfair County,2021-03-09,111,1781,11.1
13271,Telfair County,2021-03-10,12,1793,11.2
13271,Telfair County,2021-03-11,14,1807,11.3
13271,Telfair County,2021-03-12,26,1833,11.4
13271,Telfair County,2021-03-13,3,1836,11.4
13271,Telfair County,2021-03-14,1,1837,11.5
13271,Telfair County,2021-03-15,56,1893,11.8
13271,Telfair County,2021-03-16,118,2011,12.5
13271,Telfair County,2021-03-17,16,2027,12.6
13271,Telfair County,2021-03-18,15,2042,12.7
13271,Telfair County,2021-03-19,9,2051,12.8
13271,Telfair County,2021-03-20,4,2055,12.8
13271,Telfair County,2021-03-21,1,2056,12.8
13271,Telfair County,2021-03-22,10,2066,12.9
13271,Telfair County,2021-03-23,84,2150,13.4
13271,Telfair County,2021-03-24,17,2167,13.5
13271,Telfair County,2021-03-25,16,2183,13.6
13271,Telfair County,2021-03-26,12,2195,13.7
13271,Telfair County,2021-03-27,3,2198,13.7
13271,Telfair County,2021-03-28,1,2199,13.7
13271,Telfair County,2021-03-29,24,2223,13.9
13271,Telfair County,2021-03-30,90,2313,14.4
13271,Telfair County,2021-03-31,26,2339,14.6
13271,Telfair County,2021-04-01,35,2374,14.8
13271,Telfair County,2021-04-02,33,2407,15
13271,Telfair County,2021-04-03,20,2427,15.1
13271,Telfair County,2021-04-04,2,2429,15.1
13271,Telfair County,2021-04-05,15,2444,15.2
13271,Telfair County,2021-04-06,60,2504,15.6
13271,Telfair County,2021-04-07,11,2515,15.7
13271,Telfair County,2021-04-08,15,2530,15.8
13271,Telfair County,2021-04-09,30,2560,16
13271,Telfair County,2021-04-10,19,2579,16.1
13271,Telfair County,2021-04-11,2,2581,16.1
13271,Telfair County,2021-04-12,23,2604,16.2
13271,Telfair County,2021-04-13,90,2694,16.8
13271,Telfair County,2021-04-14,99,2793,17.4
13271,Telfair County,2021-04-15,8,2801,17.5
13271,Telfair County,2021-04-16,8,2809,17.5
13271,Telfair County,2021-04-17,4,2813,17.5
13271,Telfair County,2021-04-18,1,2814,17.5
13271,Telfair County,2021-04-19,9,2823,17.6
13271,Telfair County,2021-04-20,33,2856,17.8
13271,Telfair County,2021-04-21,22,2878,17.9
13271,Telfair County,2021-04-22,5,2883,18
13271,Telfair County,2021-04-23,15,2898,18.1
13271,Telfair County,2021-04-24,2,2900,18.1
13271,Telfair County,2021-04-25,2,2902,18.1
13271,Telfair County,2021-04-26,11,2913,18.2
13271,Telfair County,2021-04-27,23,2936,18.3
13271,Telfair County,2021-04-28,17,2953,18.4
13271,Telfair County,2021-04-29,18,2971,18.5
13271,Telfair County,2021-04-30,18,2989,18.6
13271,Telfair County,2021-05-01,7,2996,18.7
13271,Telfair County,2021-05-02,2,2998,18.7
13271,Telfair County,2021-05-03,12,3010,18.8
13271,Telfair County,2021-05-04,13,3023,18.9
13271,Telfair County,2021-05-05,30,3053,19
13271,Telfair County,2021-05-06,7,3060,19.1
13271,Telfair County,2021-05-07,8,3068,19.1
13271,Telfair County,2021-05-08,9,3077,19.2
13271,Telfair County,2021-05-09,1,3078,19.2
13271,Telfair County,2021-05-10,3,3081,19.2
13271,Telfair County,2021-05-11,8,3089,19.3
13271,Telfair County,2021-05-12,12,3101,19.3
13271,Telfair County,2021-05-13,8,3109,19.4
13271,Telfair County,2021-05-14,10,3119,19.5
13271,Telfair County,2021-05-15,6,3125,19.5
13271,Telfair County,2021-05-16,2,3127,19.5
13271,Telfair County,2021-05-17,11,3138,19.6
13271,Telfair County,2021-05-18,23,3161,19.7
13271,Telfair County,2021-05-19,23,3184,19.9
13271,Telfair County,2021-05-20,20,3204,20
13271,Telfair County,2021-05-21,4,3208,20
13271,Telfair County,2021-05-22,5,3213,20
13271,Telfair County,2021-05-23,1,3214,20
13271,Telfair County,2021-05-24,7,3221,20.1
13271,Telfair County,2021-05-25,10,3231,20.1
13271,Telfair County,2021-05-26,15,3246,20.2
13271,Telfair County,2021-05-27,11,3257,20.3
13271,Telfair County,2021-05-28,4,3261,20.3
13271,Telfair County,2021-05-29,2,3263,20.3
13271,Telfair County,2021-05-30,1,3264,20.4
13271,Telfair County,2021-05-31,2,3266,20.4
13271,Telfair County,2021-06-01,8,3274,20.4
13271,Telfair County,2021-06-02,14,3288,20.5
13271,Telfair County,2021-06-03,12,3300,20.6
13271,Telfair County,2021-06-04,7,3307,20.6
13271,Telfair County,2021-06-05,1,3308,20.6
13271,Telfair County,2021-06-06,2,3310,20.6
13271,Telfair County,2021-06-07,9,3319,20.7
13271,Telfair County,2021-06-08,9,3328,20.8
13271,Telfair County,2021-06-09,15,3343,20.8
13271,Telfair County,2021-06-10,7,3350,20.9
13271,Telfair County,2021-06-11,6,3356,20.9
13271,Telfair County,2021-06-12,5,3361,21
13271,Telfair County,2021-06-13,1,3362,21
13271,Telfair County,2021-06-14,10,3372,21
13271,Telfair County,2021-06-15,5,3377,21.1
13271,Telfair County,2021-06-16,7,3384,21.1
13271,Telfair County,2021-06-17,2,3386,21.1
13271,Telfair County,2021-06-18,6,3392,21.2
13271,Telfair County,2021-06-19,3,3395,21.2
13271,Telfair County,2021-06-21,4,3399,21.2
13271,Telfair County,2021-06-22,1,3400,21.2
13271,Telfair County,2021-06-23,6,3406,21.2
13271,Telfair County,2021-06-24,4,3410,21.3
13271,Telfair County,2021-06-25,6,3416,21.3
13271,Telfair County,2021-06-26,3,3419,21.3
13271,Telfair County,2021-06-27,2,3421,21.3
13271,Telfair County,2021-06-28,4,3425,21.4
13271,Telfair County,2021-06-29,8,3433,21.4
13271,Telfair County,2021-06-30,4,3437,21.4
13271,Telfair County,2021-07-01,5,3442,21.5
13271,Telfair County,2021-07-03,2,3444,21.5
13271,Telfair County,2021-07-04,1,3445,21.5
13271,Telfair County,2021-07-05,3,3448,21.5
13271,Telfair County,2021-07-06,6,3454,21.5
13271,Telfair County,2021-07-08,4,3458,21.6
13271,Telfair County,2021-07-09,15,3473,21.7
13271,Telfair County,2021-07-10,2,3475,21.7
13271,Telfair County,2021-07-11,1,3476,21.7
13271,Telfair County,2021-07-12,7,3483,21.7
13271,Telfair County,2021-07-13,11,3494,21.8
13271,Telfair County,2021-07-14,6,3500,21.8
13271,Telfair County,2021-07-15,5,3505,21.9
13271,Telfair County,2021-07-16,9,3514,21.9
13271,Telfair County,2021-07-17,1,3515,21.9
13271,Telfair County,2021-07-18,1,3516,21.9
13271,Telfair County,2021-07-19,9,3525,22
13271,Telfair County,2021-07-20,14,3539,22.1
13271,Telfair County,2021-07-21,10,3549,22.1
13271,Telfair County,2021-07-22,11,3560,22.2
13271,Telfair County,2021-07-23,10,3570,22.3
13271,Telfair County,2021-07-24,9,3579,22.3
13271,Telfair County,2021-07-25,1,3580,22.3
13271,Telfair County,2021-07-26,15,3595,22.4
13271,Telfair County,2021-07-27,28,3623,22.6
13271,Telfair County,2021-07-28,24,3647,22.7
13271,Telfair County,2021-07-29,20,3667,22.9
13271,Telfair County,2021-07-30,17,3684,23
13271,Telfair County,2021-07-31,4,3688,23
13271,Telfair County,2021-08-01,3,3691,23
13271,Telfair County,2021-08-02,36,3727,23.2
13271,Telfair County,2021-08-03,27,3754,23.4
13271,Telfair County,2021-08-04,18,3772,23.5
13271,Telfair County,2021-08-05,54,3826,23.9
13271,Telfair County,2021-08-06,23,3849,24
13271,Telfair County,2021-08-07,9,3858,24.1
13271,Telfair County,2021-08-08,11,3869,24.1
13271,Telfair County,2021-08-09,29,3898,24.3
13271,Telfair County,2021-08-10,41,3939,24.6
13271,Telfair County,2021-08-11,23,3962,24.7
13271,Telfair County,2021-08-12,31,3993,24.9
13271,Telfair County,2021-08-13,29,4022,25.1
13271,Telfair County,2021-08-14,10,4032,25.1
13271,Telfair County,2021-08-15,4,4036,25.2
13271,Telfair County,2021-08-16,22,4058,25.3
13271,Telfair County,2021-08-17,32,4090,25.5
13271,Telfair County,2021-08-18,29,4119,25.7
13271,Telfair County,2021-08-19,28,4147,25.9
13271,Telfair County,2021-08-20,45,4192,26.1
13271,Telfair County,2021-08-21,11,4203,26.2
13271,Telfair County,2021-08-22,6,4209,26.2
13271,Telfair County,2021-08-23,22,4231,26.4
13271,Telfair County,2021-08-24,26,4257,26.5
13271,Telfair County,2021-08-25,12,4269,26.6
13271,Telfair County,2021-08-26,21,4290,26.8
13271,Telfair County,2021-08-27,34,4324,27
13271,Telfair County,2021-08-28,9,4333,27
13271,Telfair County,2021-08-29,5,4338,27.1
13271,Telfair County,2021-08-30,18,4356,27.2
13271,Telfair County,2021-08-31,30,4386,27.4
13271,Telfair County,2021-09-01,33,4419,27.6
13271,Telfair County,2021-09-02,20,4439,27.7
13271,Telfair County,2021-09-03,24,4463,27.8
13271,Telfair County,2021-09-04,5,4468,27.9
13271,Telfair County,2021-09-05,3,4471,27.9
13271,Telfair County,2021-09-06,3,4474,27.9
13271,Telfair County,2021-09-07,19,4493,28
13271,Telfair County,2021-09-08,9,4502,28.1
13271,Telfair County,2021-09-09,13,4515,28.2
13271,Telfair County,2021-09-10,19,4534,28.3
13271,Telfair County,2021-09-11,3,4537,28.3
13271,Telfair County,2021-09-12,2,4539,28.3
13271,Telfair County,2021-09-13,10,4549,28.4
13271,Telfair County,2021-09-14,13,4562,28.5
13271,Telfair County,2021-09-15,8,4570,28.5
13271,Telfair County,2021-09-16,14,4584,28.6
13271,Telfair County,2021-09-17,10,4594,28.6
13271,Telfair County,2021-09-18,7,4601,28.7
13271,Telfair County,2021-09-20,7,4608,28.7
13271,Telfair County,2021-09-21,14,4622,28.8
13271,Telfair County,2021-09-22,10,4632,28.9
13271,Telfair County,2021-09-23,11,4643,29
13271,Telfair County,2021-09-24,13,4656,29
13271,Telfair County,2021-09-25,5,4661,29.1
13271,Telfair County,2021-09-26,5,4666,29.1
13271,Telfair County,2021-09-27,7,4673,29.1
13271,Telfair County,2021-09-28,6,4679,29.2
13271,Telfair County,2021-09-29,5,4684,29.2
13271,Telfair County,2021-09-30,5,4689,29.2
13271,Telfair County,2021-10-01,5,4694,29.3
13271,Telfair County,2021-10-02,5,4699,29.3
13271,Telfair County,2021-10-04,5,4704,29.3
13271,Telfair County,2021-10-05,6,4710,29.4
13271,Telfair County,2021-10-06,8,4718,29.4
13271,Telfair County,2021-10-07,5,4723,29.5
13273,Terrell County,2020-12-17,2,2,0
13273,Terrell County,2020-12-18,3,5,0.1
13273,Terrell County,2020-12-19,1,6,0.1
13273,Terrell County,2020-12-20,1,7,0.1
13273,Terrell County,2020-12-21,6,13,0.1
13273,Terrell County,2020-12-22,8,21,0.2
13273,Terrell County,2020-12-23,17,38,0.4
13273,Terrell County,2020-12-24,1,39,0.4
13273,Terrell County,2020-12-26,4,43,0.5
13273,Terrell County,2020-12-28,7,50,0.6
13273,Terrell County,2020-12-29,8,58,0.7
13273,Terrell County,2020-12-30,7,65,0.7
13273,Terrell County,2020-12-31,2,67,0.8
13273,Terrell County,2021-01-01,4,71,0.8
13273,Terrell County,2021-01-04,17,88,1
13273,Terrell County,2021-01-05,2,90,1
13273,Terrell County,2021-01-06,36,126,1.4
13273,Terrell County,2021-01-07,19,145,1.7
13273,Terrell County,2021-01-08,14,159,1.8
13273,Terrell County,2021-01-09,1,160,1.8
13273,Terrell County,2021-01-10,5,165,1.9
13273,Terrell County,2021-01-11,29,194,2.2
13273,Terrell County,2021-01-12,39,233,2.7
13273,Terrell County,2021-01-13,64,297,3.4
13273,Terrell County,2021-01-14,62,359,4.1
13273,Terrell County,2021-01-15,67,426,4.9
13273,Terrell County,2021-01-16,27,453,5.2
13273,Terrell County,2021-01-17,8,461,5.3
13273,Terrell County,2021-01-18,102,563,6.4
13273,Terrell County,2021-01-19,72,635,7.3
13273,Terrell County,2021-01-20,58,693,7.9
13273,Terrell County,2021-01-21,57,750,8.6
13273,Terrell County,2021-01-22,71,821,9.4
13273,Terrell County,2021-01-23,4,825,9.4
13273,Terrell County,2021-01-25,62,887,10.2
13273,Terrell County,2021-01-26,80,967,11.1
13273,Terrell County,2021-01-27,56,1023,11.7
13273,Terrell County,2021-01-28,58,1081,12.4
13273,Terrell County,2021-01-29,47,1128,12.9
13273,Terrell County,2021-01-31,2,1130,12.9
13273,Terrell County,2021-02-01,32,1162,13.3
13273,Terrell County,2021-02-02,47,1209,13.8
13273,Terrell County,2021-02-03,46,1255,14.4
13273,Terrell County,2021-02-04,45,1300,14.9
13273,Terrell County,2021-02-05,28,1328,15.2
13273,Terrell County,2021-02-06,1,1329,15.2
13273,Terrell County,2021-02-07,1,1330,15.2
13273,Terrell County,2021-02-08,33,1363,15.6
13273,Terrell County,2021-02-09,22,1385,15.9
13273,Terrell County,2021-02-10,14,1399,16
13273,Terrell County,2021-02-11,26,1425,16.3
13273,Terrell County,2021-02-12,14,1439,16.5
13273,Terrell County,2021-02-13,5,1444,16.5
13273,Terrell County,2021-02-14,1,1445,16.5
13273,Terrell County,2021-02-15,17,1462,16.7
13273,Terrell County,2021-02-16,25,1487,17
13273,Terrell County,2021-02-17,19,1506,17.2
13273,Terrell County,2021-02-18,21,1527,17.5
13273,Terrell County,2021-02-19,7,1534,17.6
13273,Terrell County,2021-02-20,5,1539,17.6
13273,Terrell County,2021-02-22,12,1551,17.8
13273,Terrell County,2021-02-23,33,1584,18.1
13273,Terrell County,2021-02-24,7,1591,18.2
13273,Terrell County,2021-02-25,22,1613,18.5
13273,Terrell County,2021-02-26,17,1630,18.7
13273,Terrell County,2021-02-27,5,1635,18.7
13273,Terrell County,2021-03-01,17,1652,18.9
13273,Terrell County,2021-03-02,37,1689,19.3
13273,Terrell County,2021-03-03,23,1712,19.6
13273,Terrell County,2021-03-04,22,1734,19.8
13273,Terrell County,2021-03-05,28,1762,20.2
13273,Terrell County,2021-03-06,1,1763,20.2
13273,Terrell County,2021-03-08,28,1791,20.5
13273,Terrell County,2021-03-09,39,1830,20.9
13273,Terrell County,2021-03-10,33,1863,21.3
13273,Terrell County,2021-03-11,35,1898,21.7
13273,Terrell County,2021-03-12,78,1976,22.6
13273,Terrell County,2021-03-13,9,1985,22.7
13273,Terrell County,2021-03-14,1,1986,22.7
13273,Terrell County,2021-03-15,36,2022,23.1
13273,Terrell County,2021-03-16,81,2103,24.1
13273,Terrell County,2021-03-17,51,2154,24.7
13273,Terrell County,2021-03-18,22,2176,24.9
13273,Terrell County,2021-03-19,54,2230,25.5
13273,Terrell County,2021-03-20,10,2240,25.6
13273,Terrell County,2021-03-21,1,2241,25.6
13273,Terrell County,2021-03-22,36,2277,26.1
13273,Terrell County,2021-03-23,33,2310,26.4
13273,Terrell County,2021-03-24,47,2357,27
13273,Terrell County,2021-03-25,38,2395,27.4
13273,Terrell County,2021-03-26,54,2449,28
13273,Terrell County,2021-03-27,4,2453,28.1
13273,Terrell County,2021-03-28,4,2457,28.1
13273,Terrell County,2021-03-29,40,2497,28.6
13273,Terrell County,2021-03-30,50,2547,29.2
13273,Terrell County,2021-03-31,67,2614,29.9
13273,Terrell County,2021-04-01,26,2640,30.2
13273,Terrell County,2021-04-02,12,2652,30.4
13273,Terrell County,2021-04-03,7,2659,30.4
13273,Terrell County,2021-04-04,2,2661,30.5
13273,Terrell County,2021-04-05,32,2693,30.8
13273,Terrell County,2021-04-06,33,2726,31.2
13273,Terrell County,2021-04-07,32,2758,31.6
13273,Terrell County,2021-04-08,27,2785,31.9
13273,Terrell County,2021-04-09,34,2819,32.3
13273,Terrell County,2021-04-10,2,2821,32.3
13273,Terrell County,2021-04-11,1,2822,32.3
13273,Terrell County,2021-04-12,25,2847,32.6
13273,Terrell County,2021-04-13,28,2875,32.9
13273,Terrell County,2021-04-14,32,2907,33.3
13273,Terrell County,2021-04-15,8,2915,33.4
13273,Terrell County,2021-04-16,32,2947,33.7
13273,Terrell County,2021-04-17,1,2948,33.7
13273,Terrell County,2021-04-18,3,2951,33.8
13273,Terrell County,2021-04-19,26,2977,34.1
13273,Terrell County,2021-04-20,18,2995,34.3
13273,Terrell County,2021-04-21,16,3011,34.5
13273,Terrell County,2021-04-22,24,3035,34.7
13273,Terrell County,2021-04-23,35,3070,35.1
13273,Terrell County,2021-04-24,2,3072,35.2
13273,Terrell County,2021-04-26,14,3086,35.3
13273,Terrell County,2021-04-27,9,3095,35.4
13273,Terrell County,2021-04-28,22,3117,35.7
13273,Terrell County,2021-04-29,22,3139,35.9
13273,Terrell County,2021-04-30,30,3169,36.3
13273,Terrell County,2021-05-01,2,3171,36.3
13273,Terrell County,2021-05-02,2,3173,36.3
13273,Terrell County,2021-05-03,14,3187,36.5
13273,Terrell County,2021-05-04,15,3202,36.6
13273,Terrell County,2021-05-05,17,3219,36.8
13273,Terrell County,2021-05-06,7,3226,36.9
13273,Terrell County,2021-05-07,21,3247,37.2
13273,Terrell County,2021-05-08,5,3252,37.2
13273,Terrell County,2021-05-10,8,3260,37.3
13273,Terrell County,2021-05-11,10,3270,37.4
13273,Terrell County,2021-05-12,13,3283,37.6
13273,Terrell County,2021-05-13,5,3288,37.6
13273,Terrell County,2021-05-14,21,3309,37.9
13273,Terrell County,2021-05-16,5,3314,37.9
13273,Terrell County,2021-05-17,7,3321,38
13273,Terrell County,2021-05-18,20,3341,38.2
13273,Terrell County,2021-05-19,22,3363,38.5
13273,Terrell County,2021-05-20,10,3373,38.6
13273,Terrell County,2021-05-21,30,3403,38.9
13273,Terrell County,2021-05-22,6,3409,39
13273,Terrell County,2021-05-23,3,3412,39.1
13273,Terrell County,2021-05-24,6,3418,39.1
13273,Terrell County,2021-05-25,7,3425,39.2
13273,Terrell County,2021-05-26,23,3448,39.5
13273,Terrell County,2021-05-27,12,3460,39.6
13273,Terrell County,2021-05-28,7,3467,39.7
13273,Terrell County,2021-05-29,31,3498,40
13273,Terrell County,2021-06-01,8,3506,40.1
13273,Terrell County,2021-06-02,13,3519,40.3
13273,Terrell County,2021-06-03,8,3527,40.4
13273,Terrell County,2021-06-04,15,3542,40.5
13273,Terrell County,2021-06-05,2,3544,40.6
13273,Terrell County,2021-06-06,1,3545,40.6
13273,Terrell County,2021-06-07,13,3558,40.7
13273,Terrell County,2021-06-08,8,3566,40.8
13273,Terrell County,2021-06-09,15,3581,41
13273,Terrell County,2021-06-10,10,3591,41.1
13273,Terrell County,2021-06-11,15,3606,41.3
13273,Terrell County,2021-06-12,4,3610,41.3
13273,Terrell County,2021-06-14,16,3626,41.5
13273,Terrell County,2021-06-15,12,3638,41.6
13273,Terrell County,2021-06-16,9,3647,41.7
13273,Terrell County,2021-06-17,8,3655,41.8
13273,Terrell County,2021-06-18,14,3669,42
13273,Terrell County,2021-06-19,2,3671,42
13273,Terrell County,2021-06-21,3,3674,42.1
13273,Terrell County,2021-06-22,5,3679,42.1
13273,Terrell County,2021-06-23,9,3688,42.2
13273,Terrell County,2021-06-24,5,3693,42.3
13273,Terrell County,2021-06-25,11,3704,42.4
13273,Terrell County,2021-06-26,10,3714,42.5
13273,Terrell County,2021-06-28,9,3723,42.6
13273,Terrell County,2021-06-29,1,3724,42.6
13273,Terrell County,2021-06-30,8,3732,42.7
13273,Terrell County,2021-07-01,3,3735,42.7
13273,Terrell County,2021-07-02,2,3737,42.8
13273,Terrell County,2021-07-03,2,3739,42.8
13273,Terrell County,2021-07-05,8,3747,42.9
13273,Terrell County,2021-07-06,6,3753,43
13273,Terrell County,2021-07-07,10,3763,43.1
13273,Terrell County,2021-07-08,6,3769,43.1
13273,Terrell County,2021-07-09,10,3779,43.3
13273,Terrell County,2021-07-11,4,3783,43.3
13273,Terrell County,2021-07-12,2,3785,43.3
13273,Terrell County,2021-07-13,6,3791,43.4
13273,Terrell County,2021-07-14,8,3799,43.5
13273,Terrell County,2021-07-15,13,3812,43.6
13273,Terrell County,2021-07-16,22,3834,43.9
13273,Terrell County,2021-07-17,5,3839,43.9
13273,Terrell County,2021-07-18,3,3842,44
13273,Terrell County,2021-07-19,7,3849,44.1
13273,Terrell County,2021-07-20,5,3854,44.1
13273,Terrell County,2021-07-21,24,3878,44.4
13273,Terrell County,2021-07-22,7,3885,44.5
13273,Terrell County,2021-07-23,13,3898,44.6
13273,Terrell County,2021-07-24,8,3906,44.7
13273,Terrell County,2021-07-25,8,3914,44.8
13273,Terrell County,2021-07-26,6,3920,44.9
13273,Terrell County,2021-07-27,17,3937,45.1
13273,Terrell County,2021-07-28,21,3958,45.3
13273,Terrell County,2021-07-29,24,3982,45.6
13273,Terrell County,2021-07-30,27,4009,45.9
13273,Terrell County,2021-07-31,16,4025,46.1
13273,Terrell County,2021-08-01,1,4026,46.1
13273,Terrell County,2021-08-02,17,4043,46.3
13273,Terrell County,2021-08-03,26,4069,46.6
13273,Terrell County,2021-08-04,28,4097,46.9
13273,Terrell County,2021-08-05,25,4122,47.2
13273,Terrell County,2021-08-06,31,4153,47.5
13273,Terrell County,2021-08-07,11,4164,47.7
13273,Terrell County,2021-08-08,10,4174,47.8
13273,Terrell County,2021-08-09,19,4193,48
13273,Terrell County,2021-08-10,18,4211,48.2
13273,Terrell County,2021-08-11,37,4248,48.6
13273,Terrell County,2021-08-12,63,4311,49.3
13273,Terrell County,2021-08-13,42,4353,49.8
13273,Terrell County,2021-08-14,28,4381,50.1
13273,Terrell County,2021-08-15,4,4385,50.2
13273,Terrell County,2021-08-16,31,4416,50.5
13273,Terrell County,2021-08-17,29,4445,50.9
13273,Terrell County,2021-08-18,41,4486,51.3
13273,Terrell County,2021-08-19,22,4508,51.6
13273,Terrell County,2021-08-20,25,4533,51.9
13273,Terrell County,2021-08-21,10,4543,52
13273,Terrell County,2021-08-22,3,4546,52
13273,Terrell County,2021-08-23,37,4583,52.5
13273,Terrell County,2021-08-24,10,4593,52.6
13273,Terrell County,2021-08-25,32,4625,52.9
13273,Terrell County,2021-08-26,22,4647,53.2
13273,Terrell County,2021-08-27,43,4690,53.7
13273,Terrell County,2021-08-28,5,4695,53.7
13273,Terrell County,2021-08-29,3,4698,53.8
13273,Terrell County,2021-08-30,45,4743,54.3
13273,Terrell County,2021-08-31,16,4759,54.5
13273,Terrell County,2021-09-01,21,4780,54.7
13273,Terrell County,2021-09-02,25,4805,55
13273,Terrell County,2021-09-03,16,4821,55.2
13273,Terrell County,2021-09-04,7,4828,55.3
13273,Terrell County,2021-09-05,9,4837,55.4
13273,Terrell County,2021-09-06,2,4839,55.4
13273,Terrell County,2021-09-07,11,4850,55.5
13273,Terrell County,2021-09-08,25,4875,55.8
13273,Terrell County,2021-09-09,13,4888,55.9
13273,Terrell County,2021-09-10,29,4917,56.3
13273,Terrell County,2021-09-11,11,4928,56.4
13273,Terrell County,2021-09-12,2,4930,56.4
13273,Terrell County,2021-09-13,15,4945,56.6
13273,Terrell County,2021-09-14,18,4963,56.8
13273,Terrell County,2021-09-15,17,4980,57
13273,Terrell County,2021-09-16,10,4990,57.1
13273,Terrell County,2021-09-17,16,5006,57.3
13273,Terrell County,2021-09-18,3,5009,57.3
13273,Terrell County,2021-09-19,8,5017,57.4
13273,Terrell County,2021-09-20,15,5032,57.6
13273,Terrell County,2021-09-21,19,5051,57.8
13273,Terrell County,2021-09-22,19,5070,58
13273,Terrell County,2021-09-23,5,5075,58.1
13273,Terrell County,2021-09-24,11,5086,58.2
13273,Terrell County,2021-09-25,1,5087,58.2
13273,Terrell County,2021-09-26,2,5089,58.2
13273,Terrell County,2021-09-27,11,5100,58.4
13273,Terrell County,2021-09-28,4,5104,58.4
13273,Terrell County,2021-09-29,14,5118,58.6
13273,Terrell County,2021-09-30,7,5125,58.7
13273,Terrell County,2021-10-01,13,5138,58.8
13273,Terrell County,2021-10-03,3,5141,58.8
13273,Terrell County,2021-10-04,2,5143,58.9
13273,Terrell County,2021-10-05,1,5144,58.9
13273,Terrell County,2021-10-06,7,5151,59
13273,Terrell County,2021-10-07,1,5152,59
13275,Thomas County,2020-12-12,1,1,0
13275,Thomas County,2020-12-17,9,10,0
13275,Thomas County,2020-12-18,28,38,0.1
13275,Thomas County,2020-12-19,79,117,0.3
13275,Thomas County,2020-12-20,1,118,0.3
13275,Thomas County,2020-12-21,104,222,0.5
13275,Thomas County,2020-12-22,34,256,0.6
13275,Thomas County,2020-12-23,187,443,1
13275,Thomas County,2020-12-24,8,451,1
13275,Thomas County,2020-12-26,2,453,1
13275,Thomas County,2020-12-27,3,456,1
13275,Thomas County,2020-12-28,127,583,1.3
13275,Thomas County,2020-12-29,57,640,1.4
13275,Thomas County,2020-12-30,183,823,1.8
13275,Thomas County,2020-12-31,30,853,1.9
13275,Thomas County,2021-01-01,5,858,1.9
13275,Thomas County,2021-01-03,3,861,1.9
13275,Thomas County,2021-01-04,207,1068,2.4
13275,Thomas County,2021-01-05,59,1127,2.5
13275,Thomas County,2021-01-06,164,1291,2.9
13275,Thomas County,2021-01-07,51,1342,3
13275,Thomas County,2021-01-08,132,1474,3.3
13275,Thomas County,2021-01-10,1,1475,3.3
13275,Thomas County,2021-01-11,269,1744,3.9
13275,Thomas County,2021-01-12,375,2119,4.7
13275,Thomas County,2021-01-13,348,2467,5.5
13275,Thomas County,2021-01-14,601,3068,6.9
13275,Thomas County,2021-01-15,167,3235,7.2
13275,Thomas County,2021-01-16,49,3284,7.4
13275,Thomas County,2021-01-17,2,3286,7.4
13275,Thomas County,2021-01-18,228,3514,7.9
13275,Thomas County,2021-01-19,513,4027,9
13275,Thomas County,2021-01-20,301,4328,9.7
13275,Thomas County,2021-01-21,404,4732,10.6
13275,Thomas County,2021-01-22,217,4949,11.1
13275,Thomas County,2021-01-23,58,5007,11.2
13275,Thomas County,2021-01-24,3,5010,11.2
13275,Thomas County,2021-01-25,185,5195,11.6
13275,Thomas County,2021-01-26,437,5632,12.6
13275,Thomas County,2021-01-27,218,5850,13.1
13275,Thomas County,2021-01-28,355,6205,13.9
13275,Thomas County,2021-01-29,249,6454,14.5
13275,Thomas County,2021-01-30,3,6457,14.5
13275,Thomas County,2021-02-01,108,6565,14.7
13275,Thomas County,2021-02-02,79,6644,14.9
13275,Thomas County,2021-02-03,130,6774,15.2
13275,Thomas County,2021-02-04,92,6866,15.4
13275,Thomas County,2021-02-05,108,6974,15.6
13275,Thomas County,2021-02-06,16,6990,15.7
13275,Thomas County,2021-02-08,55,7045,15.8
13275,Thomas County,2021-02-09,100,7145,16
13275,Thomas County,2021-02-10,97,7242,16.2
13275,Thomas County,2021-02-11,31,7273,16.3
13275,Thomas County,2021-02-12,37,7310,16.4
13275,Thomas County,2021-02-13,90,7400,16.6
13275,Thomas County,2021-02-15,53,7453,16.7
13275,Thomas County,2021-02-16,79,7532,16.9
13275,Thomas County,2021-02-17,219,7751,17.4
13275,Thomas County,2021-02-18,72,7823,17.5
13275,Thomas County,2021-02-19,34,7857,17.6
13275,Thomas County,2021-02-20,11,7868,17.6
13275,Thomas County,2021-02-21,2,7870,17.6
13275,Thomas County,2021-02-22,67,7937,17.8
13275,Thomas County,2021-02-23,81,8018,18
13275,Thomas County,2021-02-24,63,8081,18.1
13275,Thomas County,2021-02-25,83,8164,18.3
13275,Thomas County,2021-02-26,54,8218,18.4
13275,Thomas County,2021-02-27,5,8223,18.4
13275,Thomas County,2021-02-28,4,8227,18.4
13275,Thomas County,2021-03-01,125,8352,18.7
13275,Thomas County,2021-03-02,80,8432,18.9
13275,Thomas County,2021-03-03,158,8590,19.2
13275,Thomas County,2021-03-04,55,8645,19.4
13275,Thomas County,2021-03-05,80,8725,19.5
13275,Thomas County,2021-03-06,5,8730,19.6
13275,Thomas County,2021-03-07,21,8751,19.6
13275,Thomas County,2021-03-08,375,9126,20.4
13275,Thomas County,2021-03-09,108,9234,20.7
13275,Thomas County,2021-03-10,146,9380,21
13275,Thomas County,2021-03-11,163,9543,21.4
13275,Thomas County,2021-03-12,158,9701,21.7
13275,Thomas County,2021-03-13,24,9725,21.8
13275,Thomas County,2021-03-14,25,9750,21.8
13275,Thomas County,2021-03-15,253,10003,22.4
13275,Thomas County,2021-03-16,178,10181,22.8
13275,Thomas County,2021-03-17,263,10444,23.4
13275,Thomas County,2021-03-18,79,10523,23.6
13275,Thomas County,2021-03-19,142,10665,23.9
13275,Thomas County,2021-03-20,19,10684,23.9
13275,Thomas County,2021-03-21,21,10705,24
13275,Thomas County,2021-03-22,168,10873,24.4
13275,Thomas County,2021-03-23,119,10992,24.6
13275,Thomas County,2021-03-24,210,11202,25.1
13275,Thomas County,2021-03-25,270,11472,25.7
13275,Thomas County,2021-03-26,226,11698,26.2
13275,Thomas County,2021-03-27,13,11711,26.2
13275,Thomas County,2021-03-28,15,11726,26.3
13275,Thomas County,2021-03-29,224,11950,26.8
13275,Thomas County,2021-03-30,235,12185,27.3
13275,Thomas County,2021-03-31,220,12405,27.8
13275,Thomas County,2021-04-01,225,12630,28.3
13275,Thomas County,2021-04-02,245,12875,28.8
13275,Thomas County,2021-04-03,27,12902,28.9
13275,Thomas County,2021-04-04,24,12926,29
13275,Thomas County,2021-04-05,180,13106,29.4
13275,Thomas County,2021-04-06,145,13251,29.7
13275,Thomas County,2021-04-07,210,13461,30.2
13275,Thomas County,2021-04-08,124,13585,30.4
13275,Thomas County,2021-04-09,144,13729,30.8
13275,Thomas County,2021-04-10,21,13750,30.8
13275,Thomas County,2021-04-11,14,13764,30.8
13275,Thomas County,2021-04-12,109,13873,31.1
13275,Thomas County,2021-04-13,102,13975,31.3
13275,Thomas County,2021-04-14,147,14122,31.6
13275,Thomas County,2021-04-15,79,14201,31.8
13275,Thomas County,2021-04-16,46,14247,31.9
13275,Thomas County,2021-04-17,11,14258,31.9
13275,Thomas County,2021-04-18,4,14262,32
13275,Thomas County,2021-04-19,64,14326,32.1
13275,Thomas County,2021-04-20,75,14401,32.3
13275,Thomas County,2021-04-21,68,14469,32.4
13275,Thomas County,2021-04-22,64,14533,32.6
13275,Thomas County,2021-04-23,98,14631,32.8
13275,Thomas County,2021-04-24,9,14640,32.8
13275,Thomas County,2021-04-25,8,14648,32.8
13275,Thomas County,2021-04-26,38,14686,32.9
13275,Thomas County,2021-04-27,49,14735,33
13275,Thomas County,2021-04-28,101,14836,33.2
13275,Thomas County,2021-04-29,57,14893,33.4
13275,Thomas County,2021-04-30,61,14954,33.5
13275,Thomas County,2021-05-01,12,14966,33.5
13275,Thomas County,2021-05-02,9,14975,33.6
13275,Thomas County,2021-05-03,49,15024,33.7
13275,Thomas County,2021-05-04,39,15063,33.8
13275,Thomas County,2021-05-05,36,15099,33.8
13275,Thomas County,2021-05-06,69,15168,34
13275,Thomas County,2021-05-07,36,15204,34.1
13275,Thomas County,2021-05-08,11,15215,34.1
13275,Thomas County,2021-05-10,18,15233,34.1
13275,Thomas County,2021-05-11,81,15314,34.3
13275,Thomas County,2021-05-12,59,15373,34.4
13275,Thomas County,2021-05-13,60,15433,34.6
13275,Thomas County,2021-05-14,51,15484,34.7
13275,Thomas County,2021-05-15,27,15511,34.8
13275,Thomas County,2021-05-16,23,15534,34.8
13275,Thomas County,2021-05-17,56,15590,34.9
13275,Thomas County,2021-05-18,78,15668,35.1
13275,Thomas County,2021-05-19,161,15829,35.5
13275,Thomas County,2021-05-20,97,15926,35.7
13275,Thomas County,2021-05-21,121,16047,36
13275,Thomas County,2021-05-22,13,16060,36
13275,Thomas County,2021-05-23,12,16072,36
13275,Thomas County,2021-05-24,30,16102,36.1
13275,Thomas County,2021-05-25,80,16182,36.3
13275,Thomas County,2021-05-26,34,16216,36.3
13275,Thomas County,2021-05-27,54,16270,36.5
13275,Thomas County,2021-05-28,19,16289,36.5
13275,Thomas County,2021-05-29,21,16310,36.5
13275,Thomas County,2021-05-30,8,16318,36.6
13275,Thomas County,2021-05-31,1,16319,36.6
13275,Thomas County,2021-06-01,33,16352,36.6
13275,Thomas County,2021-06-02,39,16391,36.7
13275,Thomas County,2021-06-03,52,16443,36.8
13275,Thomas County,2021-06-04,36,16479,36.9
13275,Thomas County,2021-06-05,9,16488,36.9
13275,Thomas County,2021-06-06,9,16497,37
13275,Thomas County,2021-06-07,20,16517,37
13275,Thomas County,2021-06-08,27,16544,37.1
13275,Thomas County,2021-06-09,30,16574,37.1
13275,Thomas County,2021-06-10,42,16616,37.2
13275,Thomas County,2021-06-11,27,16643,37.3
13275,Thomas County,2021-06-12,11,16654,37.3
13275,Thomas County,2021-06-13,7,16661,37.3
13275,Thomas County,2021-06-14,19,16680,37.4
13275,Thomas County,2021-06-15,27,16707,37.4
13275,Thomas County,2021-06-16,30,16737,37.5
13275,Thomas County,2021-06-17,52,16789,37.6
13275,Thomas County,2021-06-18,25,16814,37.7
13275,Thomas County,2021-06-19,20,16834,37.7
13275,Thomas County,2021-06-20,5,16839,37.7
13275,Thomas County,2021-06-21,19,16858,37.8
13275,Thomas County,2021-06-22,49,16907,37.9
13275,Thomas County,2021-06-23,29,16936,37.9
13275,Thomas County,2021-06-24,45,16981,38
13275,Thomas County,2021-06-25,21,17002,38.1
13275,Thomas County,2021-06-26,10,17012,38.1
13275,Thomas County,2021-06-27,4,17016,38.1
13275,Thomas County,2021-06-28,8,17024,38.1
13275,Thomas County,2021-06-29,40,17064,38.2
13275,Thomas County,2021-06-30,26,17090,38.3
13275,Thomas County,2021-07-01,51,17141,38.4
13275,Thomas County,2021-07-02,22,17163,38.5
13275,Thomas County,2021-07-03,9,17172,38.5
13275,Thomas County,2021-07-04,2,17174,38.5
13275,Thomas County,2021-07-05,20,17194,38.5
13275,Thomas County,2021-07-06,25,17219,38.6
13275,Thomas County,2021-07-07,12,17231,38.6
13275,Thomas County,2021-07-08,27,17258,38.7
13275,Thomas County,2021-07-09,35,17293,38.7
13275,Thomas County,2021-07-10,15,17308,38.8
13275,Thomas County,2021-07-11,4,17312,38.8
13275,Thomas County,2021-07-12,14,17326,38.8
13275,Thomas County,2021-07-13,41,17367,38.9
13275,Thomas County,2021-07-14,21,17388,39
13275,Thomas County,2021-07-15,38,17426,39
13275,Thomas County,2021-07-16,43,17469,39.1
13275,Thomas County,2021-07-17,27,17496,39.2
13275,Thomas County,2021-07-18,10,17506,39.2
13275,Thomas County,2021-07-19,26,17532,39.3
13275,Thomas County,2021-07-20,57,17589,39.4
13275,Thomas County,2021-07-21,51,17640,39.5
13275,Thomas County,2021-07-22,59,17699,39.7
13275,Thomas County,2021-07-23,90,17789,39.9
13275,Thomas County,2021-07-24,39,17828,39.9
13275,Thomas County,2021-07-25,21,17849,40
13275,Thomas County,2021-07-26,77,17926,40.2
13275,Thomas County,2021-07-27,123,18049,40.4
13275,Thomas County,2021-07-28,120,18169,40.7
13275,Thomas County,2021-07-29,133,18302,41
13275,Thomas County,2021-07-30,129,18431,41.3
13275,Thomas County,2021-07-31,56,18487,41.4
13275,Thomas County,2021-08-01,34,18521,41.5
13275,Thomas County,2021-08-02,98,18619,41.7
13275,Thomas County,2021-08-03,126,18745,42
13275,Thomas County,2021-08-04,354,19099,42.8
13275,Thomas County,2021-08-05,143,19242,43.1
13275,Thomas County,2021-08-06,108,19350,43.4
13275,Thomas County,2021-08-07,53,19403,43.5
13275,Thomas County,2021-08-08,60,19463,43.6
13275,Thomas County,2021-08-09,93,19556,43.8
13275,Thomas County,2021-08-10,113,19669,44.1
13275,Thomas County,2021-08-11,206,19875,44.5
13275,Thomas County,2021-08-12,130,20005,44.8
13275,Thomas County,2021-08-13,120,20125,45.1
13275,Thomas County,2021-08-14,60,20185,45.2
13275,Thomas County,2021-08-15,31,20216,45.3
13275,Thomas County,2021-08-16,69,20285,45.5
13275,Thomas County,2021-08-17,127,20412,45.7
13275,Thomas County,2021-08-18,208,20620,46.2
13275,Thomas County,2021-08-19,108,20728,46.4
13275,Thomas County,2021-08-20,181,20909,46.8
13275,Thomas County,2021-08-21,78,20987,47
13275,Thomas County,2021-08-22,29,21016,47.1
13275,Thomas County,2021-08-23,74,21090,47.3
13275,Thomas County,2021-08-24,74,21164,47.4
13275,Thomas County,2021-08-25,144,21308,47.7
13275,Thomas County,2021-08-26,125,21433,48
13275,Thomas County,2021-08-27,97,21530,48.2
13275,Thomas County,2021-08-28,61,21591,48.4
13275,Thomas County,2021-08-29,28,21619,48.4
13275,Thomas County,2021-08-30,68,21687,48.6
13275,Thomas County,2021-08-31,55,21742,48.7
13275,Thomas County,2021-09-01,109,21851,49
13275,Thomas County,2021-09-02,81,21932,49.1
13275,Thomas County,2021-09-03,74,22006,49.3
13275,Thomas County,2021-09-04,24,22030,49.4
13275,Thomas County,2021-09-05,14,22044,49.4
13275,Thomas County,2021-09-06,2,22046,49.4
13275,Thomas County,2021-09-07,50,22096,49.5
13275,Thomas County,2021-09-08,76,22172,49.7
13275,Thomas County,2021-09-09,65,22237,49.8
13275,Thomas County,2021-09-10,75,22312,50
13275,Thomas County,2021-09-11,28,22340,50.1
13275,Thomas County,2021-09-12,10,22350,50.1
13275,Thomas County,2021-09-13,58,22408,50.2
13275,Thomas County,2021-09-14,52,22460,50.3
13275,Thomas County,2021-09-15,62,22522,50.5
13275,Thomas County,2021-09-16,49,22571,50.6
13275,Thomas County,2021-09-17,30,22601,50.6
13275,Thomas County,2021-09-18,16,22617,50.7
13275,Thomas County,2021-09-19,9,22626,50.7
13275,Thomas County,2021-09-20,17,22643,50.7
13275,Thomas County,2021-09-21,40,22683,50.8
13275,Thomas County,2021-09-22,38,22721,50.9
13275,Thomas County,2021-09-23,29,22750,51
13275,Thomas County,2021-09-24,19,22769,51
13275,Thomas County,2021-09-25,17,22786,51.1
13275,Thomas County,2021-09-26,9,22795,51.1
13275,Thomas County,2021-09-27,18,22813,51.1
13275,Thomas County,2021-09-28,17,22830,51.2
13275,Thomas County,2021-09-29,26,22856,51.2
13275,Thomas County,2021-09-30,21,22877,51.3
13275,Thomas County,2021-10-01,15,22892,51.3
13275,Thomas County,2021-10-02,3,22895,51.3
13275,Thomas County,2021-10-03,3,22898,51.3
13275,Thomas County,2021-10-04,6,22904,51.3
13275,Thomas County,2021-10-05,13,22917,51.3
13275,Thomas County,2021-10-06,12,22929,51.4
13275,Thomas County,2021-10-07,7,22936,51.4
13277,Tift County,2020-12-14,1,1,0
13277,Tift County,2020-12-16,2,3,0
13277,Tift County,2020-12-17,13,16,0
13277,Tift County,2020-12-18,8,24,0.1
13277,Tift County,2020-12-19,1,25,0.1
13277,Tift County,2020-12-21,9,34,0.1
13277,Tift County,2020-12-22,42,76,0.2
13277,Tift County,2020-12-23,109,185,0.5
13277,Tift County,2020-12-24,19,204,0.5
13277,Tift County,2020-12-26,4,208,0.5
13277,Tift County,2020-12-28,106,314,0.8
13277,Tift County,2020-12-29,106,420,1
13277,Tift County,2020-12-30,102,522,1.3
13277,Tift County,2020-12-31,64,586,1.4
13277,Tift County,2021-01-01,3,589,1.5
13277,Tift County,2021-01-02,2,591,1.5
13277,Tift County,2021-01-03,1,592,1.5
13277,Tift County,2021-01-04,116,708,1.7
13277,Tift County,2021-01-05,127,835,2.1
13277,Tift County,2021-01-06,84,919,2.3
13277,Tift County,2021-01-07,128,1047,2.6
13277,Tift County,2021-01-08,98,1145,2.8
13277,Tift County,2021-01-09,3,1148,2.8
13277,Tift County,2021-01-10,3,1151,2.8
13277,Tift County,2021-01-11,169,1320,3.3
13277,Tift County,2021-01-12,163,1483,3.7
13277,Tift County,2021-01-13,197,1680,4.1
13277,Tift County,2021-01-14,256,1936,4.8
13277,Tift County,2021-01-15,407,2343,5.8
13277,Tift County,2021-01-16,16,2359,5.8
13277,Tift County,2021-01-17,2,2361,5.8
13277,Tift County,2021-01-18,232,2593,6.4
13277,Tift County,2021-01-19,169,2762,6.8
13277,Tift County,2021-01-20,235,2997,7.4
13277,Tift County,2021-01-21,258,3255,8
13277,Tift County,2021-01-22,210,3465,8.5
13277,Tift County,2021-01-23,7,3472,8.6
13277,Tift County,2021-01-24,4,3476,8.6
13277,Tift County,2021-01-25,189,3665,9
13277,Tift County,2021-01-26,209,3874,9.6
13277,Tift County,2021-01-27,250,4124,10.2
13277,Tift County,2021-01-28,238,4362,10.8
13277,Tift County,2021-01-29,145,4507,11.1
13277,Tift County,2021-01-30,3,4510,11.1
13277,Tift County,2021-01-31,1,4511,11.1
13277,Tift County,2021-02-01,193,4704,11.6
13277,Tift County,2021-02-02,159,4863,12
13277,Tift County,2021-02-03,176,5039,12.4
13277,Tift County,2021-02-04,148,5187,12.8
13277,Tift County,2021-02-05,118,5305,13.1
13277,Tift County,2021-02-06,4,5309,13.1
13277,Tift County,2021-02-07,1,5310,13.1
13277,Tift County,2021-02-08,99,5409,13.3
13277,Tift County,2021-02-09,99,5508,13.6
13277,Tift County,2021-02-10,81,5589,13.8
13277,Tift County,2021-02-11,75,5664,14
13277,Tift County,2021-02-12,89,5753,14.2
13277,Tift County,2021-02-13,12,5765,14.2
13277,Tift County,2021-02-14,3,5768,14.2
13277,Tift County,2021-02-15,67,5835,14.4
13277,Tift County,2021-02-16,73,5908,14.6
13277,Tift County,2021-02-17,86,5994,14.8
13277,Tift County,2021-02-18,40,6034,14.9
13277,Tift County,2021-02-19,85,6119,15.1
13277,Tift County,2021-02-20,1,6120,15.1
13277,Tift County,2021-02-21,8,6128,15.1
13277,Tift County,2021-02-22,65,6193,15.3
13277,Tift County,2021-02-23,79,6272,15.5
13277,Tift County,2021-02-24,77,6349,15.7
13277,Tift County,2021-02-25,65,6414,15.8
13277,Tift County,2021-02-26,79,6493,16
13277,Tift County,2021-02-27,10,6503,16
13277,Tift County,2021-02-28,11,6514,16.1
13277,Tift County,2021-03-01,51,6565,16.2
13277,Tift County,2021-03-02,70,6635,16.4
13277,Tift County,2021-03-03,78,6713,16.6
13277,Tift County,2021-03-04,56,6769,16.7
13277,Tift County,2021-03-05,57,6826,16.8
13277,Tift County,2021-03-06,6,6832,16.9
13277,Tift County,2021-03-07,11,6843,16.9
13277,Tift County,2021-03-08,118,6961,17.2
13277,Tift County,2021-03-09,85,7046,17.4
13277,Tift County,2021-03-10,183,7229,17.8
13277,Tift County,2021-03-11,189,7418,18.3
13277,Tift County,2021-03-12,163,7581,18.7
13277,Tift County,2021-03-13,17,7598,18.7
13277,Tift County,2021-03-14,23,7621,18.8
13277,Tift County,2021-03-15,149,7770,19.2
13277,Tift County,2021-03-16,149,7919,19.5
13277,Tift County,2021-03-17,127,8046,19.8
13277,Tift County,2021-03-18,81,8127,20
13277,Tift County,2021-03-19,124,8251,20.4
13277,Tift County,2021-03-20,16,8267,20.4
13277,Tift County,2021-03-21,16,8283,20.4
13277,Tift County,2021-03-22,146,8429,20.8
13277,Tift County,2021-03-23,103,8532,21
13277,Tift County,2021-03-24,115,8647,21.3
13277,Tift County,2021-03-25,118,8765,21.6
13277,Tift County,2021-03-26,133,8898,21.9
13277,Tift County,2021-03-27,26,8924,22
13277,Tift County,2021-03-28,19,8943,22.1
13277,Tift County,2021-03-29,56,8999,22.2
13277,Tift County,2021-03-30,96,9095,22.4
13277,Tift County,2021-03-31,219,9314,23
13277,Tift County,2021-04-01,163,9477,23.4
13277,Tift County,2021-04-02,160,9637,23.8
13277,Tift County,2021-04-03,14,9651,23.8
13277,Tift County,2021-04-04,6,9657,23.8
13277,Tift County,2021-04-05,105,9762,24.1
13277,Tift County,2021-04-06,100,9862,24.3
13277,Tift County,2021-04-07,129,9991,24.6
13277,Tift County,2021-04-08,154,10145,25
13277,Tift County,2021-04-09,103,10248,25.3
13277,Tift County,2021-04-10,28,10276,25.3
13277,Tift County,2021-04-11,11,10287,25.4
13277,Tift County,2021-04-12,59,10346,25.5
13277,Tift County,2021-04-13,59,10405,25.7
13277,Tift County,2021-04-14,97,10502,25.9
13277,Tift County,2021-04-15,120,10622,26.2
13277,Tift County,2021-04-16,63,10685,26.4
13277,Tift County,2021-04-17,11,10696,26.4
13277,Tift County,2021-04-18,5,10701,26.4
13277,Tift County,2021-04-19,35,10736,26.5
13277,Tift County,2021-04-20,36,10772,26.6
13277,Tift County,2021-04-21,79,10851,26.8
13277,Tift County,2021-04-22,51,10902,26.9
13277,Tift County,2021-04-23,69,10971,27.1
13277,Tift County,2021-04-24,9,10980,27.1
13277,Tift County,2021-04-25,6,10986,27.1
13277,Tift County,2021-04-26,40,11026,27.2
13277,Tift County,2021-04-27,36,11062,27.3
13277,Tift County,2021-04-28,67,11129,27.5
13277,Tift County,2021-04-29,47,11176,27.6
13277,Tift County,2021-04-30,115,11291,27.9
13277,Tift County,2021-05-01,9,11300,27.9
13277,Tift County,2021-05-02,6,11306,27.9
13277,Tift County,2021-05-03,73,11379,28.1
13277,Tift County,2021-05-04,38,11417,28.2
13277,Tift County,2021-05-05,65,11482,28.3
13277,Tift County,2021-05-06,34,11516,28.4
13277,Tift County,2021-05-07,50,11566,28.5
13277,Tift County,2021-05-08,11,11577,28.6
13277,Tift County,2021-05-09,7,11584,28.6
13277,Tift County,2021-05-10,18,11602,28.6
13277,Tift County,2021-05-11,37,11639,28.7
13277,Tift County,2021-05-12,41,11680,28.8
13277,Tift County,2021-05-13,27,11707,28.9
13277,Tift County,2021-05-14,46,11753,29
13277,Tift County,2021-05-15,31,11784,29.1
13277,Tift County,2021-05-16,7,11791,29.1
13277,Tift County,2021-05-17,41,11832,29.2
13277,Tift County,2021-05-18,57,11889,29.3
13277,Tift County,2021-05-19,68,11957,29.5
13277,Tift County,2021-05-20,34,11991,29.6
13277,Tift County,2021-05-21,44,12035,29.7
13277,Tift County,2021-05-22,62,12097,29.8
13277,Tift County,2021-05-23,6,12103,29.9
13277,Tift County,2021-05-24,32,12135,29.9
13277,Tift County,2021-05-25,33,12168,30
13277,Tift County,2021-05-26,86,12254,30.2
13277,Tift County,2021-05-27,25,12279,30.3
13277,Tift County,2021-05-28,29,12308,30.4
13277,Tift County,2021-05-29,9,12317,30.4
13277,Tift County,2021-05-30,5,12322,30.4
13277,Tift County,2021-05-31,4,12326,30.4
13277,Tift County,2021-06-01,40,12366,30.5
13277,Tift County,2021-06-02,31,12397,30.6
13277,Tift County,2021-06-03,37,12434,30.7
13277,Tift County,2021-06-04,46,12480,30.8
13277,Tift County,2021-06-05,10,12490,30.8
13277,Tift County,2021-06-06,15,12505,30.8
13277,Tift County,2021-06-07,23,12528,30.9
13277,Tift County,2021-06-08,20,12548,31
13277,Tift County,2021-06-09,25,12573,31
13277,Tift County,2021-06-10,31,12604,31.1
13277,Tift County,2021-06-11,26,12630,31.2
13277,Tift County,2021-06-12,16,12646,31.2
13277,Tift County,2021-06-13,2,12648,31.2
13277,Tift County,2021-06-14,19,12667,31.2
13277,Tift County,2021-06-15,30,12697,31.3
13277,Tift County,2021-06-16,23,12720,31.4
13277,Tift County,2021-06-17,20,12740,31.4
13277,Tift County,2021-06-18,35,12775,31.5
13277,Tift County,2021-06-19,11,12786,31.5
13277,Tift County,2021-06-20,4,12790,31.5
13277,Tift County,2021-06-21,34,12824,31.6
13277,Tift County,2021-06-22,26,12850,31.7
13277,Tift County,2021-06-23,19,12869,31.7
13277,Tift County,2021-06-24,32,12901,31.8
13277,Tift County,2021-06-25,29,12930,31.9
13277,Tift County,2021-06-26,14,12944,31.9
13277,Tift County,2021-06-27,1,12945,31.9
13277,Tift County,2021-06-28,19,12964,32
13277,Tift County,2021-06-29,27,12991,32
13277,Tift County,2021-06-30,23,13014,32.1
13277,Tift County,2021-07-01,31,13045,32.2
13277,Tift County,2021-07-02,25,13070,32.2
13277,Tift County,2021-07-03,13,13083,32.3
13277,Tift County,2021-07-04,1,13084,32.3
13277,Tift County,2021-07-05,9,13093,32.3
13277,Tift County,2021-07-06,18,13111,32.3
13277,Tift County,2021-07-07,16,13127,32.4
13277,Tift County,2021-07-08,30,13157,32.5
13277,Tift County,2021-07-09,25,13182,32.5
13277,Tift County,2021-07-10,10,13192,32.5
13277,Tift County,2021-07-11,8,13200,32.6
13277,Tift County,2021-07-12,21,13221,32.6
13277,Tift County,2021-07-13,26,13247,32.7
13277,Tift County,2021-07-14,18,13265,32.7
13277,Tift County,2021-07-15,35,13300,32.8
13277,Tift County,2021-07-16,56,13356,32.9
13277,Tift County,2021-07-17,7,13363,33
13277,Tift County,2021-07-18,13,13376,33
13277,Tift County,2021-07-19,40,13416,33.1
13277,Tift County,2021-07-20,40,13456,33.2
13277,Tift County,2021-07-21,39,13495,33.3
13277,Tift County,2021-07-22,56,13551,33.4
13277,Tift County,2021-07-23,68,13619,33.6
13277,Tift County,2021-07-24,45,13664,33.7
13277,Tift County,2021-07-25,19,13683,33.8
13277,Tift County,2021-07-26,80,13763,33.9
13277,Tift County,2021-07-27,80,13843,34.1
13277,Tift County,2021-07-28,122,13965,34.4
13277,Tift County,2021-07-29,87,14052,34.7
13277,Tift County,2021-07-30,98,14150,34.9
13277,Tift County,2021-07-31,51,14201,35
13277,Tift County,2021-08-01,29,14230,35.1
13277,Tift County,2021-08-02,62,14292,35.3
13277,Tift County,2021-08-03,76,14368,35.4
13277,Tift County,2021-08-04,132,14500,35.8
13277,Tift County,2021-08-05,110,14610,36
13277,Tift County,2021-08-06,150,14760,36.4
13277,Tift County,2021-08-07,69,14829,36.6
13277,Tift County,2021-08-08,35,14864,36.7
13277,Tift County,2021-08-09,120,14984,37
13277,Tift County,2021-08-10,82,15066,37.2
13277,Tift County,2021-08-11,108,15174,37.4
13277,Tift County,2021-08-12,125,15299,37.7
13277,Tift County,2021-08-13,127,15426,38.1
13277,Tift County,2021-08-14,62,15488,38.2
13277,Tift County,2021-08-15,26,15514,38.3
13277,Tift County,2021-08-16,112,15626,38.5
13277,Tift County,2021-08-17,103,15729,38.8
13277,Tift County,2021-08-18,79,15808,39
13277,Tift County,2021-08-19,96,15904,39.2
13277,Tift County,2021-08-20,65,15969,39.4
13277,Tift County,2021-08-21,43,16012,39.5
13277,Tift County,2021-08-22,16,16028,39.5
13277,Tift County,2021-08-23,66,16094,39.7
13277,Tift County,2021-08-24,63,16157,39.9
13277,Tift County,2021-08-25,80,16237,40.1
13277,Tift County,2021-08-26,61,16298,40.2
13277,Tift County,2021-08-27,86,16384,40.4
13277,Tift County,2021-08-28,24,16408,40.5
13277,Tift County,2021-08-29,18,16426,40.5
13277,Tift County,2021-08-30,55,16481,40.7
13277,Tift County,2021-08-31,62,16543,40.8
13277,Tift County,2021-09-01,55,16598,40.9
13277,Tift County,2021-09-02,61,16659,41.1
13277,Tift County,2021-09-03,68,16727,41.3
13277,Tift County,2021-09-04,19,16746,41.3
13277,Tift County,2021-09-05,39,16785,41.4
13277,Tift County,2021-09-06,2,16787,41.4
13277,Tift County,2021-09-07,35,16822,41.5
13277,Tift County,2021-09-08,37,16859,41.6
13277,Tift County,2021-09-09,115,16974,41.9
13277,Tift County,2021-09-10,69,17043,42
13277,Tift County,2021-09-11,26,17069,42.1
13277,Tift County,2021-09-12,27,17096,42.2
13277,Tift County,2021-09-13,39,17135,42.3
13277,Tift County,2021-09-14,39,17174,42.4
13277,Tift County,2021-09-15,36,17210,42.5
13277,Tift County,2021-09-16,23,17233,42.5
13277,Tift County,2021-09-17,28,17261,42.6
13277,Tift County,2021-09-18,13,17274,42.6
13277,Tift County,2021-09-19,4,17278,42.6
13277,Tift County,2021-09-20,26,17304,42.7
13277,Tift County,2021-09-21,19,17323,42.7
13277,Tift County,2021-09-22,34,17357,42.8
13277,Tift County,2021-09-23,19,17376,42.9
13277,Tift County,2021-09-24,21,17397,42.9
13277,Tift County,2021-09-25,4,17401,42.9
13277,Tift County,2021-09-26,10,17411,42.9
13277,Tift County,2021-09-27,13,17424,43
13277,Tift County,2021-09-28,12,17436,43
13277,Tift County,2021-09-29,20,17456,43.1
13277,Tift County,2021-09-30,6,17462,43.1
13277,Tift County,2021-10-01,19,17481,43.1
13277,Tift County,2021-10-02,8,17489,43.1
13277,Tift County,2021-10-03,1,17490,43.1
13277,Tift County,2021-10-04,6,17496,43.2
13277,Tift County,2021-10-05,15,17511,43.2
13277,Tift County,2021-10-06,9,17520,43.2
13277,Tift County,2021-10-07,3,17523,43.2
13279,Toombs County,2020-12-16,1,1,0
13279,Toombs County,2020-12-18,3,4,0
13279,Toombs County,2020-12-19,1,5,0
13279,Toombs County,2020-12-21,2,7,0
13279,Toombs County,2020-12-22,4,11,0
13279,Toombs County,2020-12-23,28,39,0.1
13279,Toombs County,2020-12-24,11,50,0.2
13279,Toombs County,2020-12-27,3,53,0.2
13279,Toombs County,2020-12-28,38,91,0.3
13279,Toombs County,2020-12-29,26,117,0.4
13279,Toombs County,2020-12-30,29,146,0.5
13279,Toombs County,2020-12-31,6,152,0.6
13279,Toombs County,2021-01-01,29,181,0.7
13279,Toombs County,2021-01-03,2,183,0.7
13279,Toombs County,2021-01-04,30,213,0.8
13279,Toombs County,2021-01-05,16,229,0.8
13279,Toombs County,2021-01-06,29,258,1
13279,Toombs County,2021-01-07,26,284,1.1
13279,Toombs County,2021-01-08,14,298,1.1
13279,Toombs County,2021-01-09,2,300,1.1
13279,Toombs County,2021-01-10,3,303,1.1
13279,Toombs County,2021-01-11,54,357,1.3
13279,Toombs County,2021-01-12,46,403,1.5
13279,Toombs County,2021-01-13,59,462,1.7
13279,Toombs County,2021-01-14,50,512,1.9
13279,Toombs County,2021-01-15,50,562,2.1
13279,Toombs County,2021-01-16,44,606,2.2
13279,Toombs County,2021-01-17,9,615,2.3
13279,Toombs County,2021-01-18,81,696,2.6
13279,Toombs County,2021-01-19,85,781,2.9
13279,Toombs County,2021-01-20,83,864,3.2
13279,Toombs County,2021-01-21,67,931,3.5
13279,Toombs County,2021-01-22,70,1001,3.7
13279,Toombs County,2021-01-23,6,1007,3.7
13279,Toombs County,2021-01-24,1,1008,3.7
13279,Toombs County,2021-01-25,48,1056,3.9
13279,Toombs County,2021-01-26,50,1106,4.1
13279,Toombs County,2021-01-27,57,1163,4.3
13279,Toombs County,2021-01-28,71,1234,4.6
13279,Toombs County,2021-01-29,28,1262,4.7
13279,Toombs County,2021-01-30,4,1266,4.7
13279,Toombs County,2021-01-31,1,1267,4.7
13279,Toombs County,2021-02-01,105,1372,5.1
13279,Toombs County,2021-02-02,63,1435,5.3
13279,Toombs County,2021-02-03,80,1515,5.6
13279,Toombs County,2021-02-04,32,1547,5.7
13279,Toombs County,2021-02-05,25,1572,5.8
13279,Toombs County,2021-02-06,32,1604,5.9
13279,Toombs County,2021-02-07,2,1606,6
13279,Toombs County,2021-02-08,78,1684,6.2
13279,Toombs County,2021-02-09,85,1769,6.6
13279,Toombs County,2021-02-10,67,1836,6.8
13279,Toombs County,2021-02-11,153,1989,7.4
13279,Toombs County,2021-02-12,27,2016,7.5
13279,Toombs County,2021-02-13,9,2025,7.5
13279,Toombs County,2021-02-14,1,2026,7.5
13279,Toombs County,2021-02-15,70,2096,7.8
13279,Toombs County,2021-02-16,55,2151,8
13279,Toombs County,2021-02-17,92,2243,8.3
13279,Toombs County,2021-02-18,47,2290,8.5
13279,Toombs County,2021-02-19,32,2322,8.6
13279,Toombs County,2021-02-20,18,2340,8.7
13279,Toombs County,2021-02-21,2,2342,8.7
13279,Toombs County,2021-02-22,56,2398,8.9
13279,Toombs County,2021-02-23,33,2431,9
13279,Toombs County,2021-02-24,33,2464,9.1
13279,Toombs County,2021-02-25,30,2494,9.2
13279,Toombs County,2021-02-26,28,2522,9.4
13279,Toombs County,2021-02-27,3,2525,9.4
13279,Toombs County,2021-02-28,3,2528,9.4
13279,Toombs County,2021-03-01,67,2595,9.6
13279,Toombs County,2021-03-02,176,2771,10.3
13279,Toombs County,2021-03-03,63,2834,10.5
13279,Toombs County,2021-03-04,63,2897,10.7
13279,Toombs County,2021-03-05,34,2931,10.9
13279,Toombs County,2021-03-06,4,2935,10.9
13279,Toombs County,2021-03-07,2,2937,10.9
13279,Toombs County,2021-03-08,46,2983,11.1
13279,Toombs County,2021-03-09,108,3091,11.5
13279,Toombs County,2021-03-10,91,3182,11.8
13279,Toombs County,2021-03-11,97,3279,12.2
13279,Toombs County,2021-03-12,213,3492,12.9
13279,Toombs County,2021-03-13,12,3504,13
13279,Toombs County,2021-03-14,4,3508,13
13279,Toombs County,2021-03-15,77,3585,13.3
13279,Toombs County,2021-03-16,169,3754,13.9
13279,Toombs County,2021-03-17,104,3858,14.3
13279,Toombs County,2021-03-18,114,3972,14.7
13279,Toombs County,2021-03-19,56,4028,14.9
13279,Toombs County,2021-03-20,16,4044,15
13279,Toombs County,2021-03-21,24,4068,15.1
13279,Toombs County,2021-03-22,105,4173,15.5
13279,Toombs County,2021-03-23,138,4311,16
13279,Toombs County,2021-03-24,76,4387,16.3
13279,Toombs County,2021-03-25,96,4483,16.6
13279,Toombs County,2021-03-26,99,4582,17
13279,Toombs County,2021-03-27,31,4613,17.1
13279,Toombs County,2021-03-28,2,4615,17.1
13279,Toombs County,2021-03-29,81,4696,17.4
13279,Toombs County,2021-03-30,174,4870,18.1
13279,Toombs County,2021-03-31,241,5111,18.9
13279,Toombs County,2021-04-01,85,5196,19.3
13279,Toombs County,2021-04-02,69,5265,19.5
13279,Toombs County,2021-04-03,12,5277,19.6
13279,Toombs County,2021-04-04,6,5283,19.6
13279,Toombs County,2021-04-05,65,5348,19.8
13279,Toombs County,2021-04-06,173,5521,20.5
13279,Toombs County,2021-04-07,225,5746,21.3
13279,Toombs County,2021-04-08,117,5863,21.7
13279,Toombs County,2021-04-09,49,5912,21.9
13279,Toombs County,2021-04-10,25,5937,22
13279,Toombs County,2021-04-11,7,5944,22
13279,Toombs County,2021-04-12,31,5975,22.2
13279,Toombs County,2021-04-13,83,6058,22.5
13279,Toombs County,2021-04-14,30,6088,22.6
13279,Toombs County,2021-04-15,51,6139,22.8
13279,Toombs County,2021-04-16,28,6167,22.9
13279,Toombs County,2021-04-17,12,6179,22.9
13279,Toombs County,2021-04-18,5,6184,22.9
13279,Toombs County,2021-04-19,15,6199,23
13279,Toombs County,2021-04-20,62,6261,23.2
13279,Toombs County,2021-04-21,41,6302,23.4
13279,Toombs County,2021-04-22,26,6328,23.5
13279,Toombs County,2021-04-23,31,6359,23.6
13279,Toombs County,2021-04-24,24,6383,23.7
13279,Toombs County,2021-04-25,2,6385,23.7
13279,Toombs County,2021-04-26,21,6406,23.8
13279,Toombs County,2021-04-27,41,6447,23.9
13279,Toombs County,2021-04-28,54,6501,24.1
13279,Toombs County,2021-04-29,38,6539,24.2
13279,Toombs County,2021-04-30,36,6575,24.4
13279,Toombs County,2021-05-01,24,6599,24.5
13279,Toombs County,2021-05-02,7,6606,24.5
13279,Toombs County,2021-05-03,17,6623,24.6
13279,Toombs County,2021-05-04,43,6666,24.7
13279,Toombs County,2021-05-05,66,6732,25
13279,Toombs County,2021-05-06,56,6788,25.2
13279,Toombs County,2021-05-07,29,6817,25.3
13279,Toombs County,2021-05-08,16,6833,25.3
13279,Toombs County,2021-05-10,9,6842,25.4
13279,Toombs County,2021-05-11,42,6884,25.5
13279,Toombs County,2021-05-12,21,6905,25.6
13279,Toombs County,2021-05-13,29,6934,25.7
13279,Toombs County,2021-05-14,13,6947,25.8
13279,Toombs County,2021-05-15,18,6965,25.8
13279,Toombs County,2021-05-16,6,6971,25.8
13279,Toombs County,2021-05-17,30,7001,26
13279,Toombs County,2021-05-18,40,7041,26.1
13279,Toombs County,2021-05-19,22,7063,26.2
13279,Toombs County,2021-05-20,22,7085,26.3
13279,Toombs County,2021-05-21,26,7111,26.4
13279,Toombs County,2021-05-22,15,7126,26.4
13279,Toombs County,2021-05-23,10,7136,26.5
13279,Toombs County,2021-05-24,14,7150,26.5
13279,Toombs County,2021-05-25,47,7197,26.7
13279,Toombs County,2021-05-26,29,7226,26.8
13279,Toombs County,2021-05-27,89,7315,27.1
13279,Toombs County,2021-05-28,17,7332,27.2
13279,Toombs County,2021-05-29,19,7351,27.3
13279,Toombs County,2021-05-30,3,7354,27.3
13279,Toombs County,2021-05-31,1,7355,27.3
13279,Toombs County,2021-06-01,24,7379,27.4
13279,Toombs County,2021-06-02,31,7410,27.5
13279,Toombs County,2021-06-03,15,7425,27.5
13279,Toombs County,2021-06-04,25,7450,27.6
13279,Toombs County,2021-06-05,18,7468,27.7
13279,Toombs County,2021-06-06,1,7469,27.7
13279,Toombs County,2021-06-07,8,7477,27.7
13279,Toombs County,2021-06-08,51,7528,27.9
13279,Toombs County,2021-06-09,101,7629,28.3
13279,Toombs County,2021-06-10,94,7723,28.6
13279,Toombs County,2021-06-11,16,7739,28.7
13279,Toombs County,2021-06-12,7,7746,28.7
13279,Toombs County,2021-06-13,1,7747,28.7
13279,Toombs County,2021-06-14,9,7756,28.8
13279,Toombs County,2021-06-15,18,7774,28.8
13279,Toombs County,2021-06-16,8,7782,28.9
13279,Toombs County,2021-06-17,12,7794,28.9
13279,Toombs County,2021-06-18,19,7813,29
13279,Toombs County,2021-06-19,6,7819,29
13279,Toombs County,2021-06-21,11,7830,29
13279,Toombs County,2021-06-22,58,7888,29.2
13279,Toombs County,2021-06-23,54,7942,29.4
13279,Toombs County,2021-06-24,7,7949,29.5
13279,Toombs County,2021-06-25,16,7965,29.5
13279,Toombs County,2021-06-26,5,7970,29.5
13279,Toombs County,2021-06-27,5,7975,29.6
13279,Toombs County,2021-06-28,12,7987,29.6
13279,Toombs County,2021-06-29,24,8011,29.7
13279,Toombs County,2021-06-30,11,8022,29.7
13279,Toombs County,2021-07-01,4,8026,29.8
13279,Toombs County,2021-07-02,6,8032,29.8
13279,Toombs County,2021-07-03,7,8039,29.8
13279,Toombs County,2021-07-04,1,8040,29.8
13279,Toombs County,2021-07-05,11,8051,29.8
13279,Toombs County,2021-07-06,16,8067,29.9
13279,Toombs County,2021-07-07,19,8086,30
13279,Toombs County,2021-07-08,8,8094,30
13279,Toombs County,2021-07-09,15,8109,30.1
13279,Toombs County,2021-07-10,4,8113,30.1
13279,Toombs County,2021-07-11,4,8117,30.1
13279,Toombs County,2021-07-12,6,8123,30.1
13279,Toombs County,2021-07-13,20,8143,30.2
13279,Toombs County,2021-07-14,12,8155,30.2
13279,Toombs County,2021-07-15,12,8167,30.3
13279,Toombs County,2021-07-16,11,8178,30.3
13279,Toombs County,2021-07-17,12,8190,30.4
13279,Toombs County,2021-07-18,2,8192,30.4
13279,Toombs County,2021-07-19,26,8218,30.5
13279,Toombs County,2021-07-20,42,8260,30.6
13279,Toombs County,2021-07-21,53,8313,30.8
13279,Toombs County,2021-07-22,50,8363,31
13279,Toombs County,2021-07-23,48,8411,31.2
13279,Toombs County,2021-07-24,31,8442,31.3
13279,Toombs County,2021-07-25,16,8458,31.4
13279,Toombs County,2021-07-26,43,8501,31.5
13279,Toombs County,2021-07-27,79,8580,31.8
13279,Toombs County,2021-07-28,68,8648,32.1
13279,Toombs County,2021-07-29,69,8717,32.3
13279,Toombs County,2021-07-30,80,8797,32.6
13279,Toombs County,2021-07-31,16,8813,32.7
13279,Toombs County,2021-08-01,12,8825,32.7
13279,Toombs County,2021-08-02,43,8868,32.9
13279,Toombs County,2021-08-03,83,8951,33.2
13279,Toombs County,2021-08-04,57,9008,33.4
13279,Toombs County,2021-08-05,78,9086,33.7
13279,Toombs County,2021-08-06,74,9160,34
13279,Toombs County,2021-08-07,33,9193,34.1
13279,Toombs County,2021-08-08,10,9203,34.1
13279,Toombs County,2021-08-09,69,9272,34.4
13279,Toombs County,2021-08-10,96,9368,34.7
13279,Toombs County,2021-08-11,84,9452,35
13279,Toombs County,2021-08-12,63,9515,35.3
13279,Toombs County,2021-08-13,90,9605,35.6
13279,Toombs County,2021-08-14,46,9651,35.8
13279,Toombs County,2021-08-15,25,9676,35.9
13279,Toombs County,2021-08-16,80,9756,36.2
13279,Toombs County,2021-08-17,96,9852,36.5
13279,Toombs County,2021-08-18,93,9945,36.9
13279,Toombs County,2021-08-19,81,10026,37.2
13279,Toombs County,2021-08-20,99,10125,37.5
13279,Toombs County,2021-08-21,41,10166,37.7
13279,Toombs County,2021-08-22,14,10180,37.7
13279,Toombs County,2021-08-23,55,10235,37.9
13279,Toombs County,2021-08-24,83,10318,38.3
13279,Toombs County,2021-08-25,68,10386,38.5
13279,Toombs County,2021-08-26,99,10485,38.9
13279,Toombs County,2021-08-27,89,10574,39.2
13279,Toombs County,2021-08-28,33,10607,39.3
13279,Toombs County,2021-08-29,11,10618,39.4
13279,Toombs County,2021-08-30,102,10720,39.7
13279,Toombs County,2021-08-31,79,10799,40
13279,Toombs County,2021-09-01,69,10868,40.3
13279,Toombs County,2021-09-02,75,10943,40.6
13279,Toombs County,2021-09-03,92,11035,40.9
13279,Toombs County,2021-09-04,22,11057,41
13279,Toombs County,2021-09-05,26,11083,41.1
13279,Toombs County,2021-09-06,47,11130,41.3
13279,Toombs County,2021-09-07,59,11189,41.5
13279,Toombs County,2021-09-08,59,11248,41.7
13279,Toombs County,2021-09-09,57,11305,41.9
13279,Toombs County,2021-09-10,74,11379,42.2
13279,Toombs County,2021-09-11,18,11397,42.3
13279,Toombs County,2021-09-12,11,11408,42.3
13279,Toombs County,2021-09-13,14,11422,42.3
13279,Toombs County,2021-09-14,38,11460,42.5
13279,Toombs County,2021-09-15,37,11497,42.6
13279,Toombs County,2021-09-16,25,11522,42.7
13279,Toombs County,2021-09-17,21,11543,42.8
13279,Toombs County,2021-09-18,16,11559,42.9
13279,Toombs County,2021-09-19,8,11567,42.9
13279,Toombs County,2021-09-20,29,11596,43
13279,Toombs County,2021-09-21,43,11639,43.2
13279,Toombs County,2021-09-22,16,11655,43.2
13279,Toombs County,2021-09-23,19,11674,43.3
13279,Toombs County,2021-09-24,16,11690,43.3
13279,Toombs County,2021-09-25,11,11701,43.4
13279,Toombs County,2021-09-26,4,11705,43.4
13279,Toombs County,2021-09-27,16,11721,43.5
13279,Toombs County,2021-09-28,16,11737,43.5
13279,Toombs County,2021-09-29,23,11760,43.6
13279,Toombs County,2021-09-30,14,11774,43.7
13279,Toombs County,2021-10-01,12,11786,43.7
13279,Toombs County,2021-10-02,8,11794,43.7
13279,Toombs County,2021-10-03,3,11797,43.7
13279,Toombs County,2021-10-04,9,11806,43.8
13279,Toombs County,2021-10-05,6,11812,43.8
13279,Toombs County,2021-10-06,8,11820,43.8
13279,Toombs County,2021-10-07,10,11830,43.9
13281,Towns County,2020-12-15,1,1,0
13281,Towns County,2020-12-18,1,2,0
13281,Towns County,2020-12-22,4,6,0.1
13281,Towns County,2020-12-23,53,59,0.5
13281,Towns County,2020-12-24,9,68,0.6
13281,Towns County,2020-12-28,15,83,0.7
13281,Towns County,2020-12-29,61,144,1.2
13281,Towns County,2020-12-30,53,197,1.7
13281,Towns County,2020-12-31,4,201,1.7
13281,Towns County,2021-01-01,3,204,1.8
13281,Towns County,2021-01-03,2,206,1.8
13281,Towns County,2021-01-04,97,303,2.6
13281,Towns County,2021-01-05,37,340,2.9
13281,Towns County,2021-01-06,25,365,3.1
13281,Towns County,2021-01-07,22,387,3.3
13281,Towns County,2021-01-08,7,394,3.4
13281,Towns County,2021-01-09,1,395,3.4
13281,Towns County,2021-01-10,5,400,3.4
13281,Towns County,2021-01-11,69,469,4
13281,Towns County,2021-01-12,72,541,4.7
13281,Towns County,2021-01-13,88,629,5.4
13281,Towns County,2021-01-14,129,758,6.5
13281,Towns County,2021-01-15,41,799,6.9
13281,Towns County,2021-01-16,25,824,7.1
13281,Towns County,2021-01-17,20,844,7.3
13281,Towns County,2021-01-18,60,904,7.8
13281,Towns County,2021-01-19,93,997,8.6
13281,Towns County,2021-01-20,76,1073,9.2
13281,Towns County,2021-01-21,52,1125,9.7
13281,Towns County,2021-01-22,225,1350,11.6
13281,Towns County,2021-01-23,19,1369,11.8
13281,Towns County,2021-01-24,14,1383,11.9
13281,Towns County,2021-01-25,63,1446,12.4
13281,Towns County,2021-01-26,54,1500,12.9
13281,Towns County,2021-01-27,129,1629,14
13281,Towns County,2021-01-28,48,1677,14.4
13281,Towns County,2021-01-29,72,1749,15.1
13281,Towns County,2021-01-30,1,1750,15.1
13281,Towns County,2021-01-31,2,1752,15.1
13281,Towns County,2021-02-01,70,1822,15.7
13281,Towns County,2021-02-02,56,1878,16.2
13281,Towns County,2021-02-03,86,1964,16.9
13281,Towns County,2021-02-04,94,2058,17.7
13281,Towns County,2021-02-05,278,2336,20.1
13281,Towns County,2021-02-06,6,2342,20.2
13281,Towns County,2021-02-07,2,2344,20.2
13281,Towns County,2021-02-08,50,2394,20.6
13281,Towns County,2021-02-09,32,2426,20.9
13281,Towns County,2021-02-10,103,2529,21.8
13281,Towns County,2021-02-11,30,2559,22
13281,Towns County,2021-02-12,22,2581,22.2
13281,Towns County,2021-02-13,6,2587,22.3
13281,Towns County,2021-02-14,4,2591,22.3
13281,Towns County,2021-02-15,24,2615,22.5
13281,Towns County,2021-02-16,12,2627,22.6
13281,Towns County,2021-02-17,26,2653,22.8
13281,Towns County,2021-02-18,9,2662,22.9
13281,Towns County,2021-02-19,7,2669,23
13281,Towns County,2021-02-20,4,2673,23
13281,Towns County,2021-02-22,15,2688,23.1
13281,Towns County,2021-02-23,47,2735,23.5
13281,Towns County,2021-02-24,48,2783,24
13281,Towns County,2021-02-25,37,2820,24.3
13281,Towns County,2021-02-26,150,2970,25.6
13281,Towns County,2021-02-27,30,3000,25.8
13281,Towns County,2021-02-28,40,3040,26.2
13281,Towns County,2021-03-01,48,3088,26.6
13281,Towns County,2021-03-02,36,3124,26.9
13281,Towns County,2021-03-03,48,3172,27.3
13281,Towns County,2021-03-04,55,3227,27.8
13281,Towns County,2021-03-05,130,3357,28.9
13281,Towns County,2021-03-06,17,3374,29
13281,Towns County,2021-03-07,26,3400,29.3
13281,Towns County,2021-03-08,41,3441,29.6
13281,Towns County,2021-03-09,38,3479,29.9
13281,Towns County,2021-03-10,52,3531,30.4
13281,Towns County,2021-03-11,44,3575,30.8
13281,Towns County,2021-03-12,84,3659,31.5
13281,Towns County,2021-03-13,11,3670,31.6
13281,Towns County,2021-03-14,15,3685,31.7
13281,Towns County,2021-03-15,61,3746,32.2
13281,Towns County,2021-03-16,44,3790,32.6
13281,Towns County,2021-03-17,76,3866,33.3
13281,Towns County,2021-03-18,76,3942,33.9
13281,Towns County,2021-03-19,170,4112,35.4
13281,Towns County,2021-03-20,21,4133,35.6
13281,Towns County,2021-03-21,6,4139,35.6
13281,Towns County,2021-03-22,39,4178,36
13281,Towns County,2021-03-23,30,4208,36.2
13281,Towns County,2021-03-24,40,4248,36.6
13281,Towns County,2021-03-25,81,4329,37.3
13281,Towns County,2021-03-26,75,4404,37.9
13281,Towns County,2021-03-27,7,4411,38
13281,Towns County,2021-03-28,9,4420,38
13281,Towns County,2021-03-29,51,4471,38.5
13281,Towns County,2021-03-30,33,4504,38.8
13281,Towns County,2021-03-31,30,4534,39
13281,Towns County,2021-04-01,64,4598,39.6
13281,Towns County,2021-04-02,24,4622,39.8
13281,Towns County,2021-04-03,7,4629,39.8
13281,Towns County,2021-04-04,17,4646,40
13281,Towns County,2021-04-05,26,4672,40.2
13281,Towns County,2021-04-06,26,4698,40.4
13281,Towns County,2021-04-07,21,4719,40.6
13281,Towns County,2021-04-08,33,4752,40.9
13281,Towns County,2021-04-09,43,4795,41.3
13281,Towns County,2021-04-10,10,4805,41.4
13281,Towns County,2021-04-11,8,4813,41.4
13281,Towns County,2021-04-12,32,4845,41.7
13281,Towns County,2021-04-13,21,4866,41.9
13281,Towns County,2021-04-14,10,4876,42
13281,Towns County,2021-04-15,10,4886,42.1
13281,Towns County,2021-04-16,28,4914,42.3
13281,Towns County,2021-04-17,7,4921,42.4
13281,Towns County,2021-04-18,2,4923,42.4
13281,Towns County,2021-04-19,10,4933,42.5
13281,Towns County,2021-04-20,17,4950,42.6
13281,Towns County,2021-04-21,22,4972,42.8
13281,Towns County,2021-04-22,8,4980,42.9
13281,Towns County,2021-04-23,21,5001,43
13281,Towns County,2021-04-24,7,5008,43.1
13281,Towns County,2021-04-25,6,5014,43.2
13281,Towns County,2021-04-26,6,5020,43.2
13281,Towns County,2021-04-27,17,5037,43.4
13281,Towns County,2021-04-28,18,5055,43.5
13281,Towns County,2021-04-29,5,5060,43.6
13281,Towns County,2021-04-30,14,5074,43.7
13281,Towns County,2021-05-01,4,5078,43.7
13281,Towns County,2021-05-02,1,5079,43.7
13281,Towns County,2021-05-03,9,5088,43.8
13281,Towns County,2021-05-04,20,5108,44
13281,Towns County,2021-05-05,13,5121,44.1
13281,Towns County,2021-05-06,14,5135,44.2
13281,Towns County,2021-05-07,15,5150,44.3
13281,Towns County,2021-05-08,6,5156,44.4
13281,Towns County,2021-05-09,3,5159,44.4
13281,Towns County,2021-05-10,2,5161,44.4
13281,Towns County,2021-05-11,8,5169,44.5
13281,Towns County,2021-05-12,5,5174,44.5
13281,Towns County,2021-05-13,11,5185,44.6
13281,Towns County,2021-05-14,14,5199,44.8
13281,Towns County,2021-05-15,11,5210,44.8
13281,Towns County,2021-05-16,4,5214,44.9
13281,Towns County,2021-05-17,7,5221,44.9
13281,Towns County,2021-05-18,8,5229,45
13281,Towns County,2021-05-19,9,5238,45.1
13281,Towns County,2021-05-20,13,5251,45.2
13281,Towns County,2021-05-21,10,5261,45.3
13281,Towns County,2021-05-22,5,5266,45.3
13281,Towns County,2021-05-23,2,5268,45.3
13281,Towns County,2021-05-24,8,5276,45.4
13281,Towns County,2021-05-25,5,5281,45.5
13281,Towns County,2021-05-26,4,5285,45.5
13281,Towns County,2021-05-27,6,5291,45.5
13281,Towns County,2021-05-28,3,5294,45.6
13281,Towns County,2021-05-29,5,5299,45.6
13281,Towns County,2021-05-30,1,5300,45.6
13281,Towns County,2021-05-31,1,5301,45.6
13281,Towns County,2021-06-01,9,5310,45.7
13281,Towns County,2021-06-02,6,5316,45.8
13281,Towns County,2021-06-03,8,5324,45.8
13281,Towns County,2021-06-04,10,5334,45.9
13281,Towns County,2021-06-05,3,5337,45.9
13281,Towns County,2021-06-07,3,5340,46
13281,Towns County,2021-06-08,3,5343,46
13281,Towns County,2021-06-09,6,5349,46
13281,Towns County,2021-06-10,3,5352,46.1
13281,Towns County,2021-06-11,5,5357,46.1
13281,Towns County,2021-06-12,3,5360,46.1
13281,Towns County,2021-06-13,3,5363,46.2
13281,Towns County,2021-06-14,3,5366,46.2
13281,Towns County,2021-06-15,6,5372,46.2
13281,Towns County,2021-06-16,5,5377,46.3
13281,Towns County,2021-06-17,8,5385,46.4
13281,Towns County,2021-06-18,5,5390,46.4
13281,Towns County,2021-06-19,3,5393,46.4
13281,Towns County,2021-06-20,1,5394,46.4
13281,Towns County,2021-06-21,5,5399,46.5
13281,Towns County,2021-06-22,11,5410,46.6
13281,Towns County,2021-06-23,8,5418,46.6
13281,Towns County,2021-06-25,7,5425,46.7
13281,Towns County,2021-06-26,3,5428,46.7
13281,Towns County,2021-06-27,3,5431,46.8
13281,Towns County,2021-06-28,4,5435,46.8
13281,Towns County,2021-06-29,4,5439,46.8
13281,Towns County,2021-06-30,6,5445,46.9
13281,Towns County,2021-07-01,5,5450,46.9
13281,Towns County,2021-07-02,8,5458,47
13281,Towns County,2021-07-03,1,5459,47
13281,Towns County,2021-07-05,2,5461,47
13281,Towns County,2021-07-06,4,5465,47
13281,Towns County,2021-07-07,6,5471,47.1
13281,Towns County,2021-07-08,2,5473,47.1
13281,Towns County,2021-07-09,3,5476,47.1
13281,Towns County,2021-07-10,2,5478,47.2
13281,Towns County,2021-07-11,4,5482,47.2
13281,Towns County,2021-07-12,2,5484,47.2
13281,Towns County,2021-07-13,5,5489,47.2
13281,Towns County,2021-07-14,5,5494,47.3
13281,Towns County,2021-07-15,7,5501,47.4
13281,Towns County,2021-07-16,8,5509,47.4
13281,Towns County,2021-07-17,2,5511,47.4
13281,Towns County,2021-07-18,1,5512,47.4
13281,Towns County,2021-07-19,4,5516,47.5
13281,Towns County,2021-07-20,10,5526,47.6
13281,Towns County,2021-07-21,14,5540,47.7
13281,Towns County,2021-07-22,6,5546,47.7
13281,Towns County,2021-07-23,5,5551,47.8
13281,Towns County,2021-07-25,3,5554,47.8
13281,Towns County,2021-07-26,7,5561,47.9
13281,Towns County,2021-07-27,14,5575,48
13281,Towns County,2021-07-28,7,5582,48.1
13281,Towns County,2021-07-29,7,5589,48.1
13281,Towns County,2021-07-30,10,5599,48.2
13281,Towns County,2021-07-31,3,5602,48.2
13281,Towns County,2021-08-01,6,5608,48.3
13281,Towns County,2021-08-02,18,5626,48.4
13281,Towns County,2021-08-03,8,5634,48.5
13281,Towns County,2021-08-04,12,5646,48.6
13281,Towns County,2021-08-05,12,5658,48.7
13281,Towns County,2021-08-06,9,5667,48.8
13281,Towns County,2021-08-07,5,5672,48.8
13281,Towns County,2021-08-08,6,5678,48.9
13281,Towns County,2021-08-09,17,5695,49
13281,Towns County,2021-08-10,19,5714,49.2
13281,Towns County,2021-08-11,17,5731,49.3
13281,Towns County,2021-08-12,24,5755,49.5
13281,Towns County,2021-08-13,22,5777,49.7
13281,Towns County,2021-08-14,9,5786,49.8
13281,Towns County,2021-08-15,9,5795,49.9
13281,Towns County,2021-08-16,20,5815,50.1
13281,Towns County,2021-08-17,18,5833,50.2
13281,Towns County,2021-08-18,17,5850,50.4
13281,Towns County,2021-08-19,6,5856,50.4
13281,Towns County,2021-08-20,16,5872,50.5
13281,Towns County,2021-08-21,5,5877,50.6
13281,Towns County,2021-08-22,7,5884,50.6
13281,Towns County,2021-08-23,22,5906,50.8
13281,Towns County,2021-08-24,11,5917,50.9
13281,Towns County,2021-08-25,22,5939,51.1
13281,Towns County,2021-08-26,16,5955,51.3
13281,Towns County,2021-08-27,24,5979,51.5
13281,Towns County,2021-08-28,7,5986,51.5
13281,Towns County,2021-08-29,20,6006,51.7
13281,Towns County,2021-08-30,23,6029,51.9
13281,Towns County,2021-08-31,16,6045,52
13281,Towns County,2021-09-01,25,6070,52.3
13281,Towns County,2021-09-02,16,6086,52.4
13281,Towns County,2021-09-03,18,6104,52.5
13281,Towns County,2021-09-04,9,6113,52.6
13281,Towns County,2021-09-05,4,6117,52.7
13281,Towns County,2021-09-06,2,6119,52.7
13281,Towns County,2021-09-07,17,6136,52.8
13281,Towns County,2021-09-08,18,6154,53
13281,Towns County,2021-09-09,13,6167,53.1
13281,Towns County,2021-09-10,22,6189,53.3
13281,Towns County,2021-09-11,15,6204,53.4
13281,Towns County,2021-09-12,2,6206,53.4
13281,Towns County,2021-09-13,14,6220,53.5
13281,Towns County,2021-09-14,9,6229,53.6
13281,Towns County,2021-09-15,18,6247,53.8
13281,Towns County,2021-09-16,6,6253,53.8
13281,Towns County,2021-09-17,10,6263,53.9
13281,Towns County,2021-09-18,6,6269,54
13281,Towns County,2021-09-19,1,6270,54
13281,Towns County,2021-09-20,11,6281,54.1
13281,Towns County,2021-09-21,6,6287,54.1
13281,Towns County,2021-09-22,22,6309,54.3
13281,Towns County,2021-09-23,2,6311,54.3
13281,Towns County,2021-09-24,8,6319,54.4
13281,Towns County,2021-09-25,5,6324,54.4
13281,Towns County,2021-09-26,1,6325,54.4
13281,Towns County,2021-09-27,5,6330,54.5
13281,Towns County,2021-09-28,6,6336,54.5
13281,Towns County,2021-09-29,6,6342,54.6
13281,Towns County,2021-09-30,3,6345,54.6
13281,Towns County,2021-10-01,3,6348,54.6
13281,Towns County,2021-10-02,3,6351,54.7
13281,Towns County,2021-10-05,1,6352,54.7
13281,Towns County,2021-10-06,5,6357,54.7
13281,Towns County,2021-10-07,2,6359,54.7
13283,Treutlen County,2020-12-18,3,3,0
13283,Treutlen County,2020-12-21,1,4,0.1
13283,Treutlen County,2020-12-22,1,5,0.1
13283,Treutlen County,2020-12-23,3,8,0.1
13283,Treutlen County,2020-12-27,2,10,0.1
13283,Treutlen County,2020-12-28,10,20,0.3
13283,Treutlen County,2020-12-29,3,23,0.3
13283,Treutlen County,2020-12-30,9,32,0.5
13283,Treutlen County,2020-12-31,4,36,0.5
13283,Treutlen County,2021-01-01,1,37,0.5
13283,Treutlen County,2021-01-02,1,38,0.6
13283,Treutlen County,2021-01-04,7,45,0.7
13283,Treutlen County,2021-01-05,17,62,0.9
13283,Treutlen County,2021-01-06,2,64,0.9
13283,Treutlen County,2021-01-07,15,79,1.2
13283,Treutlen County,2021-01-08,12,91,1.3
13283,Treutlen County,2021-01-09,1,92,1.4
13283,Treutlen County,2021-01-10,1,93,1.4
13283,Treutlen County,2021-01-11,6,99,1.5
13283,Treutlen County,2021-01-12,2,101,1.5
13283,Treutlen County,2021-01-13,158,259,3.8
13283,Treutlen County,2021-01-14,14,273,4
13283,Treutlen County,2021-01-15,31,304,4.5
13283,Treutlen County,2021-01-16,5,309,4.5
13283,Treutlen County,2021-01-17,35,344,5.1
13283,Treutlen County,2021-01-18,8,352,5.2
13283,Treutlen County,2021-01-19,6,358,5.3
13283,Treutlen County,2021-01-20,102,460,6.8
13283,Treutlen County,2021-01-21,8,468,6.9
13283,Treutlen County,2021-01-22,4,472,6.9
13283,Treutlen County,2021-01-23,1,473,7
13283,Treutlen County,2021-01-25,6,479,7
13283,Treutlen County,2021-01-26,5,484,7.1
13283,Treutlen County,2021-01-27,11,495,7.3
13283,Treutlen County,2021-01-28,121,616,9.1
13283,Treutlen County,2021-01-29,3,619,9.1
13283,Treutlen County,2021-01-30,1,620,9.1
13283,Treutlen County,2021-02-01,2,622,9.2
13283,Treutlen County,2021-02-02,8,630,9.3
13283,Treutlen County,2021-02-03,70,700,10.3
13283,Treutlen County,2021-02-04,1,701,10.3
13283,Treutlen County,2021-02-05,5,706,10.4
13283,Treutlen County,2021-02-07,10,716,10.5
13283,Treutlen County,2021-02-09,8,724,10.7
13283,Treutlen County,2021-02-10,10,734,10.8
13283,Treutlen County,2021-02-11,4,738,10.9
13283,Treutlen County,2021-02-15,3,741,10.9
13283,Treutlen County,2021-02-16,4,745,11
13283,Treutlen County,2021-02-17,38,783,11.5
13283,Treutlen County,2021-02-18,2,785,11.6
13283,Treutlen County,2021-02-20,1,786,11.6
13283,Treutlen County,2021-02-22,6,792,11.7
13283,Treutlen County,2021-02-23,4,796,11.7
13283,Treutlen County,2021-02-24,1,797,11.7
13283,Treutlen County,2021-02-25,13,810,11.9
13283,Treutlen County,2021-02-26,1,811,11.9
13283,Treutlen County,2021-02-28,1,812,11.9
13283,Treutlen County,2021-03-01,1,813,12
13283,Treutlen County,2021-03-02,1,814,12
13283,Treutlen County,2021-03-03,29,843,12.4
13283,Treutlen County,2021-03-04,3,846,12.5
13283,Treutlen County,2021-03-05,4,850,12.5
13283,Treutlen County,2021-03-08,2,852,12.5
13283,Treutlen County,2021-03-09,6,858,12.6
13283,Treutlen County,2021-03-10,41,899,13.2
13283,Treutlen County,2021-03-11,5,904,13.3
13283,Treutlen County,2021-03-12,15,919,13.5
13283,Treutlen County,2021-03-13,1,920,13.5
13283,Treutlen County,2021-03-15,4,924,13.6
13283,Treutlen County,2021-03-16,26,950,14
13283,Treutlen County,2021-03-17,56,1006,14.8
13283,Treutlen County,2021-03-18,7,1013,14.9
13283,Treutlen County,2021-03-19,5,1018,15
13283,Treutlen County,2021-03-20,1,1019,15
13283,Treutlen County,2021-03-21,3,1022,15
13283,Treutlen County,2021-03-22,3,1025,15.1
13283,Treutlen County,2021-03-23,8,1033,15.2
13283,Treutlen County,2021-03-24,41,1074,15.8
13283,Treutlen County,2021-03-25,10,1084,16
13283,Treutlen County,2021-03-26,5,1089,16
13283,Treutlen County,2021-03-27,4,1093,16.1
13283,Treutlen County,2021-03-29,17,1110,16.3
13283,Treutlen County,2021-03-30,11,1121,16.5
13283,Treutlen County,2021-03-31,39,1160,17.1
13283,Treutlen County,2021-04-01,6,1166,17.2
13283,Treutlen County,2021-04-02,8,1174,17.3
13283,Treutlen County,2021-04-03,4,1178,17.3
13283,Treutlen County,2021-04-05,5,1183,17.4
13283,Treutlen County,2021-04-06,13,1196,17.6
13283,Treutlen County,2021-04-07,29,1225,18
13283,Treutlen County,2021-04-08,15,1240,18.2
13283,Treutlen County,2021-04-09,9,1249,18.4
13283,Treutlen County,2021-04-10,12,1261,18.6
13283,Treutlen County,2021-04-11,3,1264,18.6
13283,Treutlen County,2021-04-12,13,1277,18.8
13283,Treutlen County,2021-04-13,8,1285,18.9
13283,Treutlen County,2021-04-14,21,1306,19.2
13283,Treutlen County,2021-04-15,3,1309,19.3
13283,Treutlen County,2021-04-16,6,1315,19.4
13283,Treutlen County,2021-04-19,5,1320,19.4
13283,Treutlen County,2021-04-20,6,1326,19.5
13283,Treutlen County,2021-04-21,37,1363,20.1
13283,Treutlen County,2021-04-22,3,1366,20.1
13283,Treutlen County,2021-04-23,8,1374,20.2
13283,Treutlen County,2021-04-24,2,1376,20.3
13283,Treutlen County,2021-04-26,2,1378,20.3
13283,Treutlen County,2021-04-27,2,1380,20.3
13283,Treutlen County,2021-04-28,11,1391,20.5
13283,Treutlen County,2021-04-29,4,1395,20.5
13283,Treutlen County,2021-04-30,6,1401,20.6
13283,Treutlen County,2021-05-01,3,1404,20.7
13283,Treutlen County,2021-05-03,1,1405,20.7
13283,Treutlen County,2021-05-04,9,1414,20.8
13283,Treutlen County,2021-05-05,10,1424,21
13283,Treutlen County,2021-05-06,2,1426,21
13283,Treutlen County,2021-05-07,6,1432,21.1
13283,Treutlen County,2021-05-08,2,1434,21.1
13283,Treutlen County,2021-05-11,6,1440,21.2
13283,Treutlen County,2021-05-12,5,1445,21.3
13283,Treutlen County,2021-05-13,1,1446,21.3
13283,Treutlen County,2021-05-14,5,1451,21.4
13283,Treutlen County,2021-05-15,3,1454,21.4
13283,Treutlen County,2021-05-17,5,1459,21.5
13283,Treutlen County,2021-05-18,3,1462,21.5
13283,Treutlen County,2021-05-19,12,1474,21.7
13283,Treutlen County,2021-05-20,2,1476,21.7
13283,Treutlen County,2021-05-21,2,1478,21.8
13283,Treutlen County,2021-05-24,4,1482,21.8
13283,Treutlen County,2021-05-25,2,1484,21.8
13283,Treutlen County,2021-05-26,14,1498,22
13283,Treutlen County,2021-05-27,6,1504,22.1
13283,Treutlen County,2021-06-01,6,1510,22.2
13283,Treutlen County,2021-06-02,4,1514,22.3
13283,Treutlen County,2021-06-03,5,1519,22.4
13283,Treutlen County,2021-06-04,3,1522,22.4
13283,Treutlen County,2021-06-05,1,1523,22.4
13283,Treutlen County,2021-06-07,6,1529,22.5
13283,Treutlen County,2021-06-08,9,1538,22.6
13283,Treutlen County,2021-06-09,4,1542,22.7
13283,Treutlen County,2021-06-10,2,1544,22.7
13283,Treutlen County,2021-06-11,7,1551,22.8
13283,Treutlen County,2021-06-12,1,1552,22.8
13283,Treutlen County,2021-06-14,3,1555,22.9
13283,Treutlen County,2021-06-15,10,1565,23
13283,Treutlen County,2021-06-16,4,1569,23.1
13283,Treutlen County,2021-06-17,2,1571,23.1
13283,Treutlen County,2021-06-18,4,1575,23.2
13283,Treutlen County,2021-06-19,2,1577,23.2
13283,Treutlen County,2021-06-21,1,1578,23.2
13283,Treutlen County,2021-06-22,2,1580,23.3
13283,Treutlen County,2021-06-23,1,1581,23.3
13283,Treutlen County,2021-06-24,4,1585,23.3
13283,Treutlen County,2021-06-25,6,1591,23.4
13283,Treutlen County,2021-06-26,1,1592,23.4
13283,Treutlen County,2021-06-28,1,1593,23.4
13283,Treutlen County,2021-06-29,3,1596,23.5
13283,Treutlen County,2021-06-30,2,1598,23.5
13283,Treutlen County,2021-07-01,2,1600,23.5
13283,Treutlen County,2021-07-02,1,1601,23.6
13283,Treutlen County,2021-07-03,2,1603,23.6
13283,Treutlen County,2021-07-05,3,1606,23.6
13283,Treutlen County,2021-07-07,4,1610,23.7
13283,Treutlen County,2021-07-08,2,1612,23.7
13283,Treutlen County,2021-07-12,5,1617,23.8
13283,Treutlen County,2021-07-13,5,1622,23.9
13283,Treutlen County,2021-07-14,2,1624,23.9
13283,Treutlen County,2021-07-15,10,1634,24
13283,Treutlen County,2021-07-16,6,1640,24.1
13283,Treutlen County,2021-07-17,3,1643,24.2
13283,Treutlen County,2021-07-18,1,1644,24.2
13283,Treutlen County,2021-07-19,7,1651,24.3
13283,Treutlen County,2021-07-20,8,1659,24.4
13283,Treutlen County,2021-07-21,9,1668,24.5
13283,Treutlen County,2021-07-22,6,1674,24.6
13283,Treutlen County,2021-07-23,9,1683,24.8
13283,Treutlen County,2021-07-24,3,1686,24.8
13283,Treutlen County,2021-07-25,1,1687,24.8
13283,Treutlen County,2021-07-26,10,1697,25
13283,Treutlen County,2021-07-27,15,1712,25.2
13283,Treutlen County,2021-07-28,28,1740,25.6
13283,Treutlen County,2021-07-29,21,1761,25.9
13283,Treutlen County,2021-07-30,13,1774,26.1
13283,Treutlen County,2021-07-31,3,1777,26.2
13283,Treutlen County,2021-08-01,2,1779,26.2
13283,Treutlen County,2021-08-02,31,1810,26.6
13283,Treutlen County,2021-08-03,32,1842,27.1
13283,Treutlen County,2021-08-04,18,1860,27.4
13283,Treutlen County,2021-08-05,14,1874,27.6
13283,Treutlen County,2021-08-06,20,1894,27.9
13283,Treutlen County,2021-08-07,4,1898,27.9
13283,Treutlen County,2021-08-08,3,1901,28
13283,Treutlen County,2021-08-09,27,1928,28.4
13283,Treutlen County,2021-08-10,21,1949,28.7
13283,Treutlen County,2021-08-11,26,1975,29.1
13283,Treutlen County,2021-08-12,23,1998,29.4
13283,Treutlen County,2021-08-13,20,2018,29.7
13283,Treutlen County,2021-08-14,12,2030,29.9
13283,Treutlen County,2021-08-15,1,2031,29.9
13283,Treutlen County,2021-08-16,26,2057,30.3
13283,Treutlen County,2021-08-17,15,2072,30.5
13283,Treutlen County,2021-08-18,19,2091,30.8
13283,Treutlen County,2021-08-19,21,2112,31.1
13283,Treutlen County,2021-08-20,20,2132,31.4
13283,Treutlen County,2021-08-21,2,2134,31.4
13283,Treutlen County,2021-08-22,1,2135,31.4
13283,Treutlen County,2021-08-23,15,2150,31.6
13283,Treutlen County,2021-08-24,20,2170,31.9
13283,Treutlen County,2021-08-25,20,2190,32.2
13283,Treutlen County,2021-08-26,17,2207,32.5
13283,Treutlen County,2021-08-27,17,2224,32.7
13283,Treutlen County,2021-08-28,6,2230,32.8
13283,Treutlen County,2021-08-29,1,2231,32.8
13283,Treutlen County,2021-08-30,22,2253,33.2
13283,Treutlen County,2021-08-31,25,2278,33.5
13283,Treutlen County,2021-09-01,17,2295,33.8
13283,Treutlen County,2021-09-02,15,2310,34
13283,Treutlen County,2021-09-03,9,2319,34.1
13283,Treutlen County,2021-09-04,7,2326,34.2
13283,Treutlen County,2021-09-05,5,2331,34.3
13283,Treutlen County,2021-09-06,3,2334,34.3
13283,Treutlen County,2021-09-07,25,2359,34.7
13283,Treutlen County,2021-09-08,11,2370,34.9
13283,Treutlen County,2021-09-09,22,2392,35.2
13283,Treutlen County,2021-09-10,7,2399,35.3
13283,Treutlen County,2021-09-13,12,2411,35.5
13283,Treutlen County,2021-09-14,3,2414,35.5
13283,Treutlen County,2021-09-15,6,2420,35.6
13283,Treutlen County,2021-09-16,17,2437,35.9
13283,Treutlen County,2021-09-17,4,2441,35.9
13283,Treutlen County,2021-09-18,1,2442,35.9
13283,Treutlen County,2021-09-19,2,2444,36
13283,Treutlen County,2021-09-20,13,2457,36.2
13283,Treutlen County,2021-09-21,4,2461,36.2
13283,Treutlen County,2021-09-22,3,2464,36.3
13283,Treutlen County,2021-09-23,10,2474,36.4
13283,Treutlen County,2021-09-24,4,2478,36.5
13283,Treutlen County,2021-09-25,4,2482,36.5
13283,Treutlen County,2021-09-26,2,2484,36.6
13283,Treutlen County,2021-09-27,6,2490,36.6
13283,Treutlen County,2021-09-28,2,2492,36.7
13283,Treutlen County,2021-09-29,5,2497,36.7
13283,Treutlen County,2021-09-30,8,2505,36.9
13283,Treutlen County,2021-10-03,1,2506,36.9
13283,Treutlen County,2021-10-04,3,2509,36.9
13283,Treutlen County,2021-10-06,3,2512,37
13283,Treutlen County,2021-10-07,2,2514,37
13285,Troup County,2020-12-17,2,2,0
13285,Troup County,2020-12-18,4,6,0
13285,Troup County,2020-12-19,6,12,0
13285,Troup County,2020-12-20,3,15,0
13285,Troup County,2020-12-21,45,60,0.1
13285,Troup County,2020-12-22,54,114,0.2
13285,Troup County,2020-12-23,92,206,0.3
13285,Troup County,2020-12-24,6,212,0.3
13285,Troup County,2020-12-26,45,257,0.4
13285,Troup County,2020-12-27,1,258,0.4
13285,Troup County,2020-12-28,145,403,0.6
13285,Troup County,2020-12-29,166,569,0.8
13285,Troup County,2020-12-30,52,621,0.9
13285,Troup County,2020-12-31,79,700,1
13285,Troup County,2021-01-01,16,716,1
13285,Troup County,2021-01-02,3,719,1
13285,Troup County,2021-01-03,4,723,1
13285,Troup County,2021-01-04,78,801,1.1
13285,Troup County,2021-01-05,20,821,1.2
13285,Troup County,2021-01-06,84,905,1.3
13285,Troup County,2021-01-07,84,989,1.4
13285,Troup County,2021-01-08,127,1116,1.6
13285,Troup County,2021-01-09,14,1130,1.6
13285,Troup County,2021-01-10,11,1141,1.6
13285,Troup County,2021-01-11,27,1168,1.7
13285,Troup County,2021-01-12,93,1261,1.8
13285,Troup County,2021-01-13,102,1363,1.9
13285,Troup County,2021-01-14,167,1530,2.2
13285,Troup County,2021-01-15,370,1900,2.7
13285,Troup County,2021-01-16,71,1971,2.8
13285,Troup County,2021-01-17,20,1991,2.8
13285,Troup County,2021-01-18,28,2019,2.9
13285,Troup County,2021-01-19,194,2213,3.2
13285,Troup County,2021-01-20,153,2366,3.4
13285,Troup County,2021-01-21,140,2506,3.6
13285,Troup County,2021-01-22,360,2866,4.1
13285,Troup County,2021-01-23,85,2951,4.2
13285,Troup County,2021-01-24,1,2952,4.2
13285,Troup County,2021-01-25,201,3153,4.5
13285,Troup County,2021-01-26,196,3349,4.8
13285,Troup County,2021-01-27,205,3554,5.1
13285,Troup County,2021-01-28,226,3780,5.4
13285,Troup County,2021-01-29,170,3950,5.6
13285,Troup County,2021-01-30,40,3990,5.7
13285,Troup County,2021-01-31,4,3994,5.7
13285,Troup County,2021-02-01,84,4078,5.8
13285,Troup County,2021-02-02,86,4164,6
13285,Troup County,2021-02-03,41,4205,6
13285,Troup County,2021-02-04,64,4269,6.1
13285,Troup County,2021-02-05,52,4321,6.2
13285,Troup County,2021-02-06,11,4332,6.2
13285,Troup County,2021-02-07,3,4335,6.2
13285,Troup County,2021-02-08,24,4359,6.2
13285,Troup County,2021-02-09,54,4413,6.3
13285,Troup County,2021-02-10,55,4468,6.4
13285,Troup County,2021-02-11,35,4503,6.4
13285,Troup County,2021-02-12,281,4784,6.8
13285,Troup County,2021-02-13,18,4802,6.9
13285,Troup County,2021-02-14,3,4805,6.9
13285,Troup County,2021-02-15,61,4866,7
13285,Troup County,2021-02-16,68,4934,7.1
13285,Troup County,2021-02-17,53,4987,7.1
13285,Troup County,2021-02-18,105,5092,7.3
13285,Troup County,2021-02-19,40,5132,7.3
13285,Troup County,2021-02-20,5,5137,7.3
13285,Troup County,2021-02-21,4,5141,7.4
13285,Troup County,2021-02-22,50,5191,7.4
13285,Troup County,2021-02-23,77,5268,7.5
13285,Troup County,2021-02-24,127,5395,7.7
13285,Troup County,2021-02-25,107,5502,7.9
13285,Troup County,2021-02-26,248,5750,8.2
13285,Troup County,2021-02-27,21,5771,8.3
13285,Troup County,2021-02-28,19,5790,8.3
13285,Troup County,2021-03-01,53,5843,8.4
13285,Troup County,2021-03-02,120,5963,8.5
13285,Troup County,2021-03-03,170,6133,8.8
13285,Troup County,2021-03-04,107,6240,8.9
13285,Troup County,2021-03-05,228,6468,9.3
13285,Troup County,2021-03-06,27,6495,9.3
13285,Troup County,2021-03-07,18,6513,9.3
13285,Troup County,2021-03-08,91,6604,9.4
13285,Troup County,2021-03-09,142,6746,9.6
13285,Troup County,2021-03-10,195,6941,9.9
13285,Troup County,2021-03-11,161,7102,10.2
13285,Troup County,2021-03-12,168,7270,10.4
13285,Troup County,2021-03-13,27,7297,10.4
13285,Troup County,2021-03-14,20,7317,10.5
13285,Troup County,2021-03-15,690,8007,11.5
13285,Troup County,2021-03-16,144,8151,11.7
13285,Troup County,2021-03-17,263,8414,12
13285,Troup County,2021-03-18,171,8585,12.3
13285,Troup County,2021-03-19,614,9199,13.2
13285,Troup County,2021-03-20,74,9273,13.3
13285,Troup County,2021-03-21,50,9323,13.3
13285,Troup County,2021-03-22,155,9478,13.6
13285,Troup County,2021-03-23,188,9666,13.8
13285,Troup County,2021-03-24,262,9928,14.2
13285,Troup County,2021-03-25,199,10127,14.5
13285,Troup County,2021-03-26,293,10420,14.9
13285,Troup County,2021-03-27,833,11253,16.1
13285,Troup County,2021-03-28,34,11287,16.1
13285,Troup County,2021-03-29,145,11432,16.4
13285,Troup County,2021-03-30,305,11737,16.8
13285,Troup County,2021-03-31,232,11969,17.1
13285,Troup County,2021-04-01,242,12211,17.5
13285,Troup County,2021-04-02,246,12457,17.8
13285,Troup County,2021-04-03,77,12534,17.9
13285,Troup County,2021-04-04,66,12600,18
13285,Troup County,2021-04-05,256,12856,18.4
13285,Troup County,2021-04-06,220,13076,18.7
13285,Troup County,2021-04-07,206,13282,19
13285,Troup County,2021-04-08,268,13550,19.4
13285,Troup County,2021-04-09,453,14003,20
13285,Troup County,2021-04-10,165,14168,20.3
13285,Troup County,2021-04-11,41,14209,20.3
13285,Troup County,2021-04-12,174,14383,20.6
13285,Troup County,2021-04-13,149,14532,20.8
13285,Troup County,2021-04-14,130,14662,21
13285,Troup County,2021-04-15,107,14769,21.1
13285,Troup County,2021-04-16,95,14864,21.3
13285,Troup County,2021-04-17,54,14918,21.3
13285,Troup County,2021-04-18,27,14945,21.4
13285,Troup County,2021-04-19,116,15061,21.5
13285,Troup County,2021-04-20,116,15177,21.7
13285,Troup County,2021-04-21,116,15293,21.9
13285,Troup County,2021-04-22,242,15535,22.2
13285,Troup County,2021-04-23,120,15655,22.4
13285,Troup County,2021-04-24,38,15693,22.4
13285,Troup County,2021-04-25,28,15721,22.5
13285,Troup County,2021-04-26,102,15823,22.6
13285,Troup County,2021-04-27,124,15947,22.8
13285,Troup County,2021-04-28,106,16053,23
13285,Troup County,2021-04-29,107,16160,23.1
13285,Troup County,2021-04-30,126,16286,23.3
13285,Troup County,2021-05-01,60,16346,23.4
13285,Troup County,2021-05-02,41,16387,23.4
13285,Troup County,2021-05-03,75,16462,23.5
13285,Troup County,2021-05-04,78,16540,23.7
13285,Troup County,2021-05-05,92,16632,23.8
13285,Troup County,2021-05-06,68,16700,23.9
13285,Troup County,2021-05-07,164,16864,24.1
13285,Troup County,2021-05-08,69,16933,24.2
13285,Troup County,2021-05-09,26,16959,24.3
13285,Troup County,2021-05-10,104,17063,24.4
13285,Troup County,2021-05-11,63,17126,24.5
13285,Troup County,2021-05-12,68,17194,24.6
13285,Troup County,2021-05-13,81,17275,24.7
13285,Troup County,2021-05-14,64,17339,24.8
13285,Troup County,2021-05-15,61,17400,24.9
13285,Troup County,2021-05-16,61,17461,25
13285,Troup County,2021-05-17,81,17542,25.1
13285,Troup County,2021-05-18,116,17658,25.3
13285,Troup County,2021-05-19,90,17748,25.4
13285,Troup County,2021-05-20,114,17862,25.5
13285,Troup County,2021-05-21,111,17973,25.7
13285,Troup County,2021-05-22,52,18025,25.8
13285,Troup County,2021-05-23,40,18065,25.8
13285,Troup County,2021-05-24,83,18148,26
13285,Troup County,2021-05-25,90,18238,26.1
13285,Troup County,2021-05-26,64,18302,26.2
13285,Troup County,2021-05-27,59,18361,26.3
13285,Troup County,2021-05-28,56,18417,26.3
13285,Troup County,2021-05-29,27,18444,26.4
13285,Troup County,2021-05-30,26,18470,26.4
13285,Troup County,2021-05-31,16,18486,26.4
13285,Troup County,2021-06-01,69,18555,26.5
13285,Troup County,2021-06-02,67,18622,26.6
13285,Troup County,2021-06-03,53,18675,26.7
13285,Troup County,2021-06-04,109,18784,26.9
13285,Troup County,2021-06-05,39,18823,26.9
13285,Troup County,2021-06-06,36,18859,27
13285,Troup County,2021-06-07,42,18901,27
13285,Troup County,2021-06-08,70,18971,27.1
13285,Troup County,2021-06-09,37,19008,27.2
13285,Troup County,2021-06-10,60,19068,27.3
13285,Troup County,2021-06-11,93,19161,27.4
13285,Troup County,2021-06-12,75,19236,27.5
13285,Troup County,2021-06-13,4,19240,27.5
13285,Troup County,2021-06-14,27,19267,27.6
13285,Troup County,2021-06-15,41,19308,27.6
13285,Troup County,2021-06-16,37,19345,27.7
13285,Troup County,2021-06-17,41,19386,27.7
13285,Troup County,2021-06-18,67,19453,27.8
13285,Troup County,2021-06-19,17,19470,27.8
13285,Troup County,2021-06-20,12,19482,27.9
13285,Troup County,2021-06-21,32,19514,27.9
13285,Troup County,2021-06-22,41,19555,28
13285,Troup County,2021-06-23,38,19593,28
13285,Troup County,2021-06-24,25,19618,28.1
13285,Troup County,2021-06-25,47,19665,28.1
13285,Troup County,2021-06-26,33,19698,28.2
13285,Troup County,2021-06-27,11,19709,28.2
13285,Troup County,2021-06-28,37,19746,28.2
13285,Troup County,2021-06-29,42,19788,28.3
13285,Troup County,2021-06-30,28,19816,28.3
13285,Troup County,2021-07-01,18,19834,28.4
13285,Troup County,2021-07-02,38,19872,28.4
13285,Troup County,2021-07-03,17,19889,28.4
13285,Troup County,2021-07-04,1,19890,28.4
13285,Troup County,2021-07-05,26,19916,28.5
13285,Troup County,2021-07-06,41,19957,28.5
13285,Troup County,2021-07-07,41,19998,28.6
13285,Troup County,2021-07-08,43,20041,28.7
13285,Troup County,2021-07-09,34,20075,28.7
13285,Troup County,2021-07-10,43,20118,28.8
13285,Troup County,2021-07-11,16,20134,28.8
13285,Troup County,2021-07-12,43,20177,28.9
13285,Troup County,2021-07-13,49,20226,28.9
13285,Troup County,2021-07-14,25,20251,29
13285,Troup County,2021-07-15,69,20320,29.1
13285,Troup County,2021-07-16,75,20395,29.2
13285,Troup County,2021-07-17,31,20426,29.2
13285,Troup County,2021-07-18,26,20452,29.3
13285,Troup County,2021-07-19,67,20519,29.3
13285,Troup County,2021-07-20,72,20591,29.4
13285,Troup County,2021-07-21,76,20667,29.6
13285,Troup County,2021-07-22,103,20770,29.7
13285,Troup County,2021-07-23,147,20917,29.9
13285,Troup County,2021-07-24,80,20997,30
13285,Troup County,2021-07-25,34,21031,30.1
13285,Troup County,2021-07-26,111,21142,30.2
13285,Troup County,2021-07-27,127,21269,30.4
13285,Troup County,2021-07-28,104,21373,30.6
13285,Troup County,2021-07-29,118,21491,30.7
13285,Troup County,2021-07-30,160,21651,31
13285,Troup County,2021-07-31,77,21728,31.1
13285,Troup County,2021-08-01,59,21787,31.2
13285,Troup County,2021-08-02,112,21899,31.3
13285,Troup County,2021-08-03,135,22034,31.5
13285,Troup County,2021-08-04,146,22180,31.7
13285,Troup County,2021-08-05,113,22293,31.9
13285,Troup County,2021-08-06,180,22473,32.1
13285,Troup County,2021-08-07,78,22551,32.3
13285,Troup County,2021-08-08,48,22599,32.3
13285,Troup County,2021-08-09,103,22702,32.5
13285,Troup County,2021-08-10,132,22834,32.7
13285,Troup County,2021-08-11,104,22938,32.8
13285,Troup County,2021-08-12,92,23030,32.9
13285,Troup County,2021-08-13,162,23192,33.2
13285,Troup County,2021-08-14,80,23272,33.3
13285,Troup County,2021-08-15,47,23319,33.4
13285,Troup County,2021-08-16,99,23418,33.5
13285,Troup County,2021-08-17,167,23585,33.7
13285,Troup County,2021-08-18,161,23746,34
13285,Troup County,2021-08-19,162,23908,34.2
13285,Troup County,2021-08-20,177,24085,34.4
13285,Troup County,2021-08-21,83,24168,34.6
13285,Troup County,2021-08-22,50,24218,34.6
13285,Troup County,2021-08-23,83,24301,34.8
13285,Troup County,2021-08-24,152,24453,35
13285,Troup County,2021-08-25,107,24560,35.1
13285,Troup County,2021-08-26,144,24704,35.3
13285,Troup County,2021-08-27,142,24846,35.5
13285,Troup County,2021-08-28,65,24911,35.6
13285,Troup County,2021-08-29,59,24970,35.7
13285,Troup County,2021-08-30,108,25078,35.9
13285,Troup County,2021-08-31,109,25187,36
13285,Troup County,2021-09-01,97,25284,36.2
13285,Troup County,2021-09-02,161,25445,36.4
13285,Troup County,2021-09-03,175,25620,36.6
13285,Troup County,2021-09-04,67,25687,36.7
13285,Troup County,2021-09-05,59,25746,36.8
13285,Troup County,2021-09-06,17,25763,36.8
13285,Troup County,2021-09-07,139,25902,37
13285,Troup County,2021-09-08,127,26029,37.2
13285,Troup County,2021-09-09,146,26175,37.4
13285,Troup County,2021-09-10,147,26322,37.6
13285,Troup County,2021-09-11,92,26414,37.8
13285,Troup County,2021-09-12,50,26464,37.8
13285,Troup County,2021-09-13,135,26599,38
13285,Troup County,2021-09-14,117,26716,38.2
13285,Troup County,2021-09-15,68,26784,38.3
13285,Troup County,2021-09-16,96,26880,38.4
13285,Troup County,2021-09-17,99,26979,38.6
13285,Troup County,2021-09-18,49,27028,38.7
13285,Troup County,2021-09-19,34,27062,38.7
13285,Troup County,2021-09-20,47,27109,38.8
13285,Troup County,2021-09-21,65,27174,38.9
13285,Troup County,2021-09-22,51,27225,38.9
13285,Troup County,2021-09-23,42,27267,39
13285,Troup County,2021-09-24,55,27322,39.1
13285,Troup County,2021-09-25,26,27348,39.1
13285,Troup County,2021-09-26,11,27359,39.1
13285,Troup County,2021-09-27,41,27400,39.2
13285,Troup County,2021-09-28,88,27488,39.3
13285,Troup County,2021-09-29,47,27535,39.4
13285,Troup County,2021-09-30,50,27585,39.5
13285,Troup County,2021-10-01,31,27616,39.5
13285,Troup County,2021-10-02,18,27634,39.5
13285,Troup County,2021-10-03,10,27644,39.5
13285,Troup County,2021-10-04,23,27667,39.6
13285,Troup County,2021-10-05,32,27699,39.6
13285,Troup County,2021-10-06,53,27752,39.7
13285,Troup County,2021-10-07,32,27784,39.7
13287,Turner County,2020-12-17,2,2,0
13287,Turner County,2020-12-18,2,4,0.1
13287,Turner County,2020-12-20,1,5,0.1
13287,Turner County,2020-12-21,3,8,0.1
13287,Turner County,2020-12-22,2,10,0.1
13287,Turner County,2020-12-23,17,27,0.3
13287,Turner County,2020-12-24,4,31,0.4
13287,Turner County,2020-12-26,1,32,0.4
13287,Turner County,2020-12-28,28,60,0.8
13287,Turner County,2020-12-29,11,71,0.9
13287,Turner County,2020-12-30,18,89,1.1
13287,Turner County,2020-12-31,14,103,1.3
13287,Turner County,2021-01-01,1,104,1.3
13287,Turner County,2021-01-03,43,147,1.9
13287,Turner County,2021-01-04,28,175,2.2
13287,Turner County,2021-01-05,14,189,2.4
13287,Turner County,2021-01-06,24,213,2.7
13287,Turner County,2021-01-07,18,231,2.9
13287,Turner County,2021-01-08,12,243,3.1
13287,Turner County,2021-01-09,1,244,3.1
13287,Turner County,2021-01-11,52,296,3.7
13287,Turner County,2021-01-12,11,307,3.9
13287,Turner County,2021-01-13,47,354,4.5
13287,Turner County,2021-01-14,46,400,5
13287,Turner County,2021-01-15,57,457,5.8
13287,Turner County,2021-01-16,2,459,5.8
13287,Turner County,2021-01-18,49,508,6.4
13287,Turner County,2021-01-19,18,526,6.6
13287,Turner County,2021-01-20,39,565,7.1
13287,Turner County,2021-01-21,79,644,8.1
13287,Turner County,2021-01-22,64,708,8.9
13287,Turner County,2021-01-24,13,721,9.1
13287,Turner County,2021-01-25,45,766,9.6
13287,Turner County,2021-01-26,25,791,10
13287,Turner County,2021-01-27,52,843,10.6
13287,Turner County,2021-01-28,56,899,11.3
13287,Turner County,2021-01-29,38,937,11.8
13287,Turner County,2021-01-30,1,938,11.8
13287,Turner County,2021-01-31,2,940,11.8
13287,Turner County,2021-02-01,55,995,12.5
13287,Turner County,2021-02-02,14,1009,12.7
13287,Turner County,2021-02-03,58,1067,13.4
13287,Turner County,2021-02-04,59,1126,14.2
13287,Turner County,2021-02-05,38,1164,14.7
13287,Turner County,2021-02-08,32,1196,15.1
13287,Turner County,2021-02-09,7,1203,15.1
13287,Turner County,2021-02-10,7,1210,15.2
13287,Turner County,2021-02-11,18,1228,15.5
13287,Turner County,2021-02-12,23,1251,15.7
13287,Turner County,2021-02-13,1,1252,15.8
13287,Turner County,2021-02-14,1,1253,15.8
13287,Turner County,2021-02-15,12,1265,15.9
13287,Turner County,2021-02-16,4,1269,16
13287,Turner County,2021-02-17,33,1302,16.4
13287,Turner County,2021-02-18,6,1308,16.5
13287,Turner County,2021-02-19,13,1321,16.6
13287,Turner County,2021-02-22,9,1330,16.7
13287,Turner County,2021-02-23,8,1338,16.8
13287,Turner County,2021-02-24,24,1362,17.1
13287,Turner County,2021-02-25,13,1375,17.3
13287,Turner County,2021-02-26,20,1395,17.6
13287,Turner County,2021-02-27,2,1397,17.6
13287,Turner County,2021-02-28,2,1399,17.6
13287,Turner County,2021-03-01,31,1430,18
13287,Turner County,2021-03-02,14,1444,18.2
13287,Turner County,2021-03-03,16,1460,18.4
13287,Turner County,2021-03-04,17,1477,18.6
13287,Turner County,2021-03-05,14,1491,18.8
13287,Turner County,2021-03-06,2,1493,18.8
13287,Turner County,2021-03-07,2,1495,18.8
13287,Turner County,2021-03-08,15,1510,19
13287,Turner County,2021-03-09,12,1522,19.2
13287,Turner County,2021-03-10,90,1612,20.3
13287,Turner County,2021-03-11,46,1658,20.9
13287,Turner County,2021-03-12,27,1685,21.2
13287,Turner County,2021-03-13,8,1693,21.3
13287,Turner County,2021-03-14,9,1702,21.4
13287,Turner County,2021-03-15,36,1738,21.9
13287,Turner County,2021-03-16,37,1775,22.3
13287,Turner County,2021-03-17,61,1836,23.1
13287,Turner County,2021-03-18,19,1855,23.4
13287,Turner County,2021-03-19,38,1893,23.8
13287,Turner County,2021-03-20,1,1894,23.8
13287,Turner County,2021-03-21,10,1904,24
13287,Turner County,2021-03-22,18,1922,24.2
13287,Turner County,2021-03-23,18,1940,24.4
13287,Turner County,2021-03-24,29,1969,24.8
13287,Turner County,2021-03-25,89,2058,25.9
13287,Turner County,2021-03-26,15,2073,26.1
13287,Turner County,2021-03-28,8,2081,26.2
13287,Turner County,2021-03-29,6,2087,26.3
13287,Turner County,2021-03-30,46,2133,26.9
13287,Turner County,2021-03-31,35,2168,27.3
13287,Turner County,2021-04-01,35,2203,27.7
13287,Turner County,2021-04-02,47,2250,28.3
13287,Turner County,2021-04-03,5,2255,28.4
13287,Turner County,2021-04-04,1,2256,28.4
13287,Turner County,2021-04-05,41,2297,28.9
13287,Turner County,2021-04-06,21,2318,29.2
13287,Turner County,2021-04-07,29,2347,29.5
13287,Turner County,2021-04-08,23,2370,29.8
13287,Turner County,2021-04-09,15,2385,30
13287,Turner County,2021-04-10,2,2387,30.1
13287,Turner County,2021-04-11,1,2388,30.1
13287,Turner County,2021-04-12,21,2409,30.3
13287,Turner County,2021-04-13,17,2426,30.5
13287,Turner County,2021-04-14,31,2457,30.9
13287,Turner County,2021-04-15,42,2499,31.5
13287,Turner County,2021-04-16,8,2507,31.6
13287,Turner County,2021-04-17,1,2508,31.6
13287,Turner County,2021-04-19,12,2520,31.7
13287,Turner County,2021-04-20,10,2530,31.9
13287,Turner County,2021-04-21,27,2557,32.2
13287,Turner County,2021-04-22,12,2569,32.3
13287,Turner County,2021-04-23,22,2591,32.6
13287,Turner County,2021-04-25,2,2593,32.6
13287,Turner County,2021-04-26,10,2603,32.8
13287,Turner County,2021-04-27,17,2620,33
13287,Turner County,2021-04-28,21,2641,33.2
13287,Turner County,2021-04-29,18,2659,33.5
13287,Turner County,2021-04-30,9,2668,33.6
13287,Turner County,2021-05-01,1,2669,33.6
13287,Turner County,2021-05-03,10,2679,33.7
13287,Turner County,2021-05-04,3,2682,33.8
13287,Turner County,2021-05-05,15,2697,34
13287,Turner County,2021-05-06,23,2720,34.2
13287,Turner County,2021-05-07,7,2727,34.3
13287,Turner County,2021-05-08,4,2731,34.4
13287,Turner County,2021-05-09,1,2732,34.4
13287,Turner County,2021-05-10,7,2739,34.5
13287,Turner County,2021-05-11,23,2762,34.8
13287,Turner County,2021-05-12,13,2775,34.9
13287,Turner County,2021-05-13,5,2780,35
13287,Turner County,2021-05-14,32,2812,35.4
13287,Turner County,2021-05-15,5,2817,35.5
13287,Turner County,2021-05-16,2,2819,35.5
13287,Turner County,2021-05-17,3,2822,35.5
13287,Turner County,2021-05-18,11,2833,35.7
13287,Turner County,2021-05-19,17,2850,35.9
13287,Turner County,2021-05-20,22,2872,36.2
13287,Turner County,2021-05-21,11,2883,36.3
13287,Turner County,2021-05-22,3,2886,36.3
13287,Turner County,2021-05-23,1,2887,36.3
13287,Turner County,2021-05-24,6,2893,36.4
13287,Turner County,2021-05-25,6,2899,36.5
13287,Turner County,2021-05-26,14,2913,36.7
13287,Turner County,2021-05-27,18,2931,36.9
13287,Turner County,2021-05-28,12,2943,37.1
13287,Turner County,2021-05-29,3,2946,37.1
13287,Turner County,2021-05-30,3,2949,37.1
13287,Turner County,2021-06-01,4,2953,37.2
13287,Turner County,2021-06-02,10,2963,37.3
13287,Turner County,2021-06-03,11,2974,37.4
13287,Turner County,2021-06-04,6,2980,37.5
13287,Turner County,2021-06-05,2,2982,37.5
13287,Turner County,2021-06-06,1,2983,37.6
13287,Turner County,2021-06-07,6,2989,37.6
13287,Turner County,2021-06-08,4,2993,37.7
13287,Turner County,2021-06-09,14,3007,37.9
13287,Turner County,2021-06-10,2,3009,37.9
13287,Turner County,2021-06-11,8,3017,38
13287,Turner County,2021-06-12,6,3023,38.1
13287,Turner County,2021-06-14,2,3025,38.1
13287,Turner County,2021-06-15,4,3029,38.1
13287,Turner County,2021-06-16,13,3042,38.3
13287,Turner County,2021-06-17,2,3044,38.3
13287,Turner County,2021-06-18,3,3047,38.4
13287,Turner County,2021-06-19,1,3048,38.4
13287,Turner County,2021-06-20,1,3049,38.4
13287,Turner County,2021-06-21,3,3052,38.4
13287,Turner County,2021-06-22,64,3116,39.2
13287,Turner County,2021-06-23,4,3120,39.3
13287,Turner County,2021-06-24,4,3124,39.3
13287,Turner County,2021-06-25,11,3135,39.5
13287,Turner County,2021-06-26,18,3153,39.7
13287,Turner County,2021-06-28,2,3155,39.7
13287,Turner County,2021-06-29,1,3156,39.7
13287,Turner County,2021-06-30,5,3161,39.8
13287,Turner County,2021-07-01,5,3166,39.9
13287,Turner County,2021-07-02,6,3172,39.9
13287,Turner County,2021-07-03,3,3175,40
13287,Turner County,2021-07-05,1,3176,40
13287,Turner County,2021-07-06,1,3177,40
13287,Turner County,2021-07-07,3,3180,40
13287,Turner County,2021-07-08,7,3187,40.1
13287,Turner County,2021-07-09,5,3192,40.2
13287,Turner County,2021-07-10,1,3193,40.2
13287,Turner County,2021-07-12,4,3197,40.2
13287,Turner County,2021-07-13,6,3203,40.3
13287,Turner County,2021-07-14,6,3209,40.4
13287,Turner County,2021-07-15,4,3213,40.5
13287,Turner County,2021-07-16,3,3216,40.5
13287,Turner County,2021-07-17,5,3221,40.6
13287,Turner County,2021-07-18,1,3222,40.6
13287,Turner County,2021-07-19,4,3226,40.6
13287,Turner County,2021-07-20,10,3236,40.7
13287,Turner County,2021-07-21,9,3245,40.9
13287,Turner County,2021-07-22,30,3275,41.2
13287,Turner County,2021-07-23,13,3288,41.4
13287,Turner County,2021-07-24,5,3293,41.5
13287,Turner County,2021-07-25,8,3301,41.6
13287,Turner County,2021-07-26,27,3328,41.9
13287,Turner County,2021-07-27,37,3365,42.4
13287,Turner County,2021-07-28,24,3389,42.7
13287,Turner County,2021-07-29,20,3409,42.9
13287,Turner County,2021-07-30,18,3427,43.1
13287,Turner County,2021-07-31,6,3433,43.2
13287,Turner County,2021-08-01,2,3435,43.2
13287,Turner County,2021-08-02,23,3458,43.5
13287,Turner County,2021-08-03,19,3477,43.8
13287,Turner County,2021-08-04,27,3504,44.1
13287,Turner County,2021-08-05,38,3542,44.6
13287,Turner County,2021-08-06,29,3571,45
13287,Turner County,2021-08-07,14,3585,45.1
13287,Turner County,2021-08-08,4,3589,45.2
13287,Turner County,2021-08-09,31,3620,45.6
13287,Turner County,2021-08-10,16,3636,45.8
13287,Turner County,2021-08-11,25,3661,46.1
13287,Turner County,2021-08-12,38,3699,46.6
13287,Turner County,2021-08-13,32,3731,47
13287,Turner County,2021-08-14,16,3747,47.2
13287,Turner County,2021-08-15,5,3752,47.2
13287,Turner County,2021-08-16,23,3775,47.5
13287,Turner County,2021-08-17,44,3819,48.1
13287,Turner County,2021-08-18,16,3835,48.3
13287,Turner County,2021-08-19,19,3854,48.5
13287,Turner County,2021-08-20,27,3881,48.9
13287,Turner County,2021-08-21,4,3885,48.9
13287,Turner County,2021-08-22,6,3891,49
13287,Turner County,2021-08-23,33,3924,49.4
13287,Turner County,2021-08-24,21,3945,49.7
13287,Turner County,2021-08-25,10,3955,49.8
13287,Turner County,2021-08-26,25,3980,50.1
13287,Turner County,2021-08-27,13,3993,50.3
13287,Turner County,2021-08-28,5,3998,50.3
13287,Turner County,2021-08-29,2,4000,50.4
13287,Turner County,2021-08-30,21,4021,50.6
13287,Turner County,2021-08-31,13,4034,50.8
13287,Turner County,2021-09-01,17,4051,51
13287,Turner County,2021-09-02,18,4069,51.2
13287,Turner County,2021-09-03,20,4089,51.5
13287,Turner County,2021-09-04,4,4093,51.5
13287,Turner County,2021-09-05,3,4096,51.6
13287,Turner County,2021-09-06,2,4098,51.6
13287,Turner County,2021-09-07,11,4109,51.7
13287,Turner County,2021-09-08,7,4116,51.8
13287,Turner County,2021-09-09,30,4146,52.2
13287,Turner County,2021-09-10,20,4166,52.4
13287,Turner County,2021-09-11,5,4171,52.5
13287,Turner County,2021-09-13,10,4181,52.6
13287,Turner County,2021-09-14,5,4186,52.7
13287,Turner County,2021-09-15,10,4196,52.8
13287,Turner County,2021-09-16,10,4206,53
13287,Turner County,2021-09-17,17,4223,53.2
13287,Turner County,2021-09-19,3,4226,53.2
13287,Turner County,2021-09-20,5,4231,53.3
13287,Turner County,2021-09-21,7,4238,53.4
13287,Turner County,2021-09-22,6,4244,53.4
13287,Turner County,2021-09-23,6,4250,53.5
13287,Turner County,2021-09-25,4,4254,53.6
13287,Turner County,2021-09-26,1,4255,53.6
13287,Turner County,2021-09-27,4,4259,53.6
13287,Turner County,2021-09-28,3,4262,53.7
13287,Turner County,2021-09-29,3,4265,53.7
13287,Turner County,2021-09-30,2,4267,53.7
13287,Turner County,2021-10-01,7,4274,53.8
13287,Turner County,2021-10-02,1,4275,53.8
13287,Turner County,2021-10-03,2,4277,53.8
13287,Turner County,2021-10-05,1,4278,53.9
13287,Turner County,2021-10-06,5,4283,53.9
13287,Turner County,2021-10-07,2,4285,53.9
13289,Twiggs County,2020-12-17,1,1,0
13289,Twiggs County,2020-12-18,2,3,0
13289,Twiggs County,2020-12-19,1,4,0
13289,Twiggs County,2020-12-22,5,9,0.1
13289,Twiggs County,2020-12-23,7,16,0.2
13289,Twiggs County,2020-12-24,4,20,0.2
13289,Twiggs County,2020-12-26,2,22,0.3
13289,Twiggs County,2020-12-27,26,48,0.6
13289,Twiggs County,2020-12-28,39,87,1.1
13289,Twiggs County,2020-12-29,7,94,1.1
13289,Twiggs County,2020-12-30,10,104,1.3
13289,Twiggs County,2020-12-31,4,108,1.3
13289,Twiggs County,2021-01-03,1,109,1.3
13289,Twiggs County,2021-01-04,3,112,1.4
13289,Twiggs County,2021-01-05,4,116,1.4
13289,Twiggs County,2021-01-06,22,138,1.7
13289,Twiggs County,2021-01-07,4,142,1.7
13289,Twiggs County,2021-01-08,8,150,1.8
13289,Twiggs County,2021-01-09,1,151,1.8
13289,Twiggs County,2021-01-10,2,153,1.9
13289,Twiggs County,2021-01-11,11,164,2
13289,Twiggs County,2021-01-12,6,170,2.1
13289,Twiggs County,2021-01-13,24,194,2.4
13289,Twiggs County,2021-01-14,20,214,2.6
13289,Twiggs County,2021-01-15,35,249,3
13289,Twiggs County,2021-01-16,9,258,3.1
13289,Twiggs County,2021-01-17,10,268,3.3
13289,Twiggs County,2021-01-18,32,300,3.6
13289,Twiggs County,2021-01-19,16,316,3.8
13289,Twiggs County,2021-01-20,81,397,4.8
13289,Twiggs County,2021-01-21,39,436,5.3
13289,Twiggs County,2021-01-22,64,500,6.1
13289,Twiggs County,2021-01-23,9,509,6.2
13289,Twiggs County,2021-01-24,1,510,6.2
13289,Twiggs County,2021-01-25,43,553,6.7
13289,Twiggs County,2021-01-26,12,565,6.9
13289,Twiggs County,2021-01-27,89,654,7.9
13289,Twiggs County,2021-01-28,21,675,8.2
13289,Twiggs County,2021-01-29,30,705,8.6
13289,Twiggs County,2021-02-01,20,725,8.8
13289,Twiggs County,2021-02-02,10,735,8.9
13289,Twiggs County,2021-02-03,56,791,9.6
13289,Twiggs County,2021-02-04,26,817,9.9
13289,Twiggs County,2021-02-05,26,843,10.2
13289,Twiggs County,2021-02-06,2,845,10.3
13289,Twiggs County,2021-02-08,27,872,10.6
13289,Twiggs County,2021-02-09,12,884,10.7
13289,Twiggs County,2021-02-10,32,916,11.1
13289,Twiggs County,2021-02-11,8,924,11.2
13289,Twiggs County,2021-02-12,25,949,11.5
13289,Twiggs County,2021-02-13,19,968,11.8
13289,Twiggs County,2021-02-14,1,969,11.8
13289,Twiggs County,2021-02-15,27,996,12.1
13289,Twiggs County,2021-02-16,14,1010,12.3
13289,Twiggs County,2021-02-17,24,1034,12.6
13289,Twiggs County,2021-02-18,22,1056,12.8
13289,Twiggs County,2021-02-19,10,1066,13
13289,Twiggs County,2021-02-20,4,1070,13
13289,Twiggs County,2021-02-22,13,1083,13.2
13289,Twiggs County,2021-02-23,15,1098,13.3
13289,Twiggs County,2021-02-24,55,1153,14
13289,Twiggs County,2021-02-25,23,1176,14.3
13289,Twiggs County,2021-02-26,33,1209,14.7
13289,Twiggs County,2021-02-27,5,1214,14.8
13289,Twiggs County,2021-02-28,2,1216,14.8
13289,Twiggs County,2021-03-01,46,1262,15.3
13289,Twiggs County,2021-03-02,21,1283,15.6
13289,Twiggs County,2021-03-03,37,1320,16
13289,Twiggs County,2021-03-04,24,1344,16.3
13289,Twiggs County,2021-03-05,32,1376,16.7
13289,Twiggs County,2021-03-06,6,1382,16.8
13289,Twiggs County,2021-03-07,4,1386,16.8
13289,Twiggs County,2021-03-08,29,1415,17.2
13289,Twiggs County,2021-03-09,11,1426,17.3
13289,Twiggs County,2021-03-10,74,1500,18.2
13289,Twiggs County,2021-03-11,26,1526,18.5
13289,Twiggs County,2021-03-12,69,1595,19.4
13289,Twiggs County,2021-03-13,12,1607,19.5
13289,Twiggs County,2021-03-14,3,1610,19.6
13289,Twiggs County,2021-03-15,34,1644,20
13289,Twiggs County,2021-03-16,23,1667,20.3
13289,Twiggs County,2021-03-17,87,1754,21.3
13289,Twiggs County,2021-03-18,22,1776,21.6
13289,Twiggs County,2021-03-19,76,1852,22.5
13289,Twiggs County,2021-03-20,4,1856,22.6
13289,Twiggs County,2021-03-21,2,1858,22.6
13289,Twiggs County,2021-03-22,46,1904,23.1
13289,Twiggs County,2021-03-23,18,1922,23.4
13289,Twiggs County,2021-03-24,78,2000,24.3
13289,Twiggs County,2021-03-25,34,2034,24.7
13289,Twiggs County,2021-03-26,59,2093,25.4
13289,Twiggs County,2021-03-27,11,2104,25.6
13289,Twiggs County,2021-03-28,4,2108,25.6
13289,Twiggs County,2021-03-29,28,2136,26
13289,Twiggs County,2021-03-30,19,2155,26.2
13289,Twiggs County,2021-03-31,64,2219,27
13289,Twiggs County,2021-04-01,34,2253,27.4
13289,Twiggs County,2021-04-02,50,2303,28
13289,Twiggs County,2021-04-03,8,2311,28.1
13289,Twiggs County,2021-04-04,4,2315,28.1
13289,Twiggs County,2021-04-05,22,2337,28.4
13289,Twiggs County,2021-04-06,18,2355,28.6
13289,Twiggs County,2021-04-07,46,2401,29.2
13289,Twiggs County,2021-04-08,38,2439,29.6
13289,Twiggs County,2021-04-09,50,2489,30.2
13289,Twiggs County,2021-04-10,16,2505,30.4
13289,Twiggs County,2021-04-11,4,2509,30.5
13289,Twiggs County,2021-04-12,27,2536,30.8
13289,Twiggs County,2021-04-13,18,2554,31
13289,Twiggs County,2021-04-14,30,2584,31.4
13289,Twiggs County,2021-04-15,17,2601,31.6
13289,Twiggs County,2021-04-16,14,2615,31.8
13289,Twiggs County,2021-04-17,7,2622,31.9
13289,Twiggs County,2021-04-18,6,2628,31.9
13289,Twiggs County,2021-04-19,19,2647,32.2
13289,Twiggs County,2021-04-20,20,2667,32.4
13289,Twiggs County,2021-04-21,36,2703,32.8
13289,Twiggs County,2021-04-22,20,2723,33.1
13289,Twiggs County,2021-04-23,22,2745,33.4
13289,Twiggs County,2021-04-24,2,2747,33.4
13289,Twiggs County,2021-04-25,1,2748,33.4
13289,Twiggs County,2021-04-26,12,2760,33.5
13289,Twiggs County,2021-04-27,7,2767,33.6
13289,Twiggs County,2021-04-28,15,2782,33.8
13289,Twiggs County,2021-04-29,11,2793,33.9
13289,Twiggs County,2021-04-30,24,2817,34.2
13289,Twiggs County,2021-05-01,8,2825,34.3
13289,Twiggs County,2021-05-02,1,2826,34.3
13289,Twiggs County,2021-05-03,9,2835,34.5
13289,Twiggs County,2021-05-04,13,2848,34.6
13289,Twiggs County,2021-05-05,15,2863,34.8
13289,Twiggs County,2021-05-06,19,2882,35
13289,Twiggs County,2021-05-07,13,2895,35.2
13289,Twiggs County,2021-05-08,8,2903,35.3
13289,Twiggs County,2021-05-09,1,2904,35.3
13289,Twiggs County,2021-05-10,4,2908,35.3
13289,Twiggs County,2021-05-11,13,2921,35.5
13289,Twiggs County,2021-05-12,20,2941,35.7
13289,Twiggs County,2021-05-13,9,2950,35.8
13289,Twiggs County,2021-05-14,10,2960,36
13289,Twiggs County,2021-05-15,3,2963,36
13289,Twiggs County,2021-05-16,8,2971,36.1
13289,Twiggs County,2021-05-17,17,2988,36.3
13289,Twiggs County,2021-05-18,15,3003,36.5
13289,Twiggs County,2021-05-19,24,3027,36.8
13289,Twiggs County,2021-05-20,17,3044,37
13289,Twiggs County,2021-05-21,17,3061,37.2
13289,Twiggs County,2021-05-22,18,3079,37.4
13289,Twiggs County,2021-05-23,6,3085,37.5
13289,Twiggs County,2021-05-24,11,3096,37.6
13289,Twiggs County,2021-05-25,7,3103,37.7
13289,Twiggs County,2021-05-26,18,3121,37.9
13289,Twiggs County,2021-05-27,10,3131,38
13289,Twiggs County,2021-05-28,13,3144,38.2
13289,Twiggs County,2021-05-29,6,3150,38.3
13289,Twiggs County,2021-05-30,10,3160,38.4
13289,Twiggs County,2021-06-01,9,3169,38.5
13289,Twiggs County,2021-06-02,18,3187,38.7
13289,Twiggs County,2021-06-03,7,3194,38.8
13289,Twiggs County,2021-06-04,8,3202,38.9
13289,Twiggs County,2021-06-05,29,3231,39.3
13289,Twiggs County,2021-06-06,35,3266,39.7
13289,Twiggs County,2021-06-07,6,3272,39.8
13289,Twiggs County,2021-06-08,4,3276,39.8
13289,Twiggs County,2021-06-09,10,3286,39.9
13289,Twiggs County,2021-06-10,13,3299,40.1
13289,Twiggs County,2021-06-11,8,3307,40.2
13289,Twiggs County,2021-06-12,23,3330,40.5
13289,Twiggs County,2021-06-13,6,3336,40.5
13289,Twiggs County,2021-06-14,1,3337,40.6
13289,Twiggs County,2021-06-15,3,3340,40.6
13289,Twiggs County,2021-06-16,6,3346,40.7
13289,Twiggs County,2021-06-17,9,3355,40.8
13289,Twiggs County,2021-06-18,6,3361,40.8
13289,Twiggs County,2021-06-19,3,3364,40.9
13289,Twiggs County,2021-06-20,2,3366,40.9
13289,Twiggs County,2021-06-21,4,3370,41
13289,Twiggs County,2021-06-22,2,3372,41
13289,Twiggs County,2021-06-23,7,3379,41.1
13289,Twiggs County,2021-06-24,6,3385,41.1
13289,Twiggs County,2021-06-25,6,3391,41.2
13289,Twiggs County,2021-06-26,15,3406,41.4
13289,Twiggs County,2021-06-27,23,3429,41.7
13289,Twiggs County,2021-06-28,6,3435,41.7
13289,Twiggs County,2021-06-29,14,3449,41.9
13289,Twiggs County,2021-06-30,6,3455,42
13289,Twiggs County,2021-07-01,6,3461,42.1
13289,Twiggs County,2021-07-02,13,3474,42.2
13289,Twiggs County,2021-07-03,7,3481,42.3
13289,Twiggs County,2021-07-05,3,3484,42.3
13289,Twiggs County,2021-07-06,4,3488,42.4
13289,Twiggs County,2021-07-07,22,3510,42.7
13289,Twiggs County,2021-07-08,6,3516,42.7
13289,Twiggs County,2021-07-09,4,3520,42.8
13289,Twiggs County,2021-07-10,4,3524,42.8
13289,Twiggs County,2021-07-11,1,3525,42.8
13289,Twiggs County,2021-07-12,3,3528,42.9
13289,Twiggs County,2021-07-13,8,3536,43
13289,Twiggs County,2021-07-14,10,3546,43.1
13289,Twiggs County,2021-07-15,11,3557,43.2
13289,Twiggs County,2021-07-16,7,3564,43.3
13289,Twiggs County,2021-07-17,18,3582,43.5
13289,Twiggs County,2021-07-19,7,3589,43.6
13289,Twiggs County,2021-07-20,11,3600,43.7
13289,Twiggs County,2021-07-21,22,3622,44
13289,Twiggs County,2021-07-22,10,3632,44.1
13289,Twiggs County,2021-07-23,13,3645,44.3
13289,Twiggs County,2021-07-24,13,3658,44.5
13289,Twiggs County,2021-07-25,2,3660,44.5
13289,Twiggs County,2021-07-26,15,3675,44.7
13289,Twiggs County,2021-07-27,9,3684,44.8
13289,Twiggs County,2021-07-28,39,3723,45.2
13289,Twiggs County,2021-07-29,13,3736,45.4
13289,Twiggs County,2021-07-30,18,3754,45.6
13289,Twiggs County,2021-07-31,31,3785,46
13289,Twiggs County,2021-08-01,4,3789,46
13289,Twiggs County,2021-08-02,10,3799,46.2
13289,Twiggs County,2021-08-03,8,3807,46.3
13289,Twiggs County,2021-08-04,26,3833,46.6
13289,Twiggs County,2021-08-05,26,3859,46.9
13289,Twiggs County,2021-08-06,24,3883,47.2
13289,Twiggs County,2021-08-07,23,3906,47.5
13289,Twiggs County,2021-08-08,5,3911,47.5
13289,Twiggs County,2021-08-09,14,3925,47.7
13289,Twiggs County,2021-08-10,11,3936,47.8
13289,Twiggs County,2021-08-11,43,3979,48.4
13289,Twiggs County,2021-08-12,16,3995,48.5
13289,Twiggs County,2021-08-13,19,4014,48.8
13289,Twiggs County,2021-08-14,30,4044,49.1
13289,Twiggs County,2021-08-15,9,4053,49.3
13289,Twiggs County,2021-08-16,19,4072,49.5
13289,Twiggs County,2021-08-17,46,4118,50
13289,Twiggs County,2021-08-18,29,4147,50.4
13289,Twiggs County,2021-08-19,21,4168,50.7
13289,Twiggs County,2021-08-20,26,4194,51
13289,Twiggs County,2021-08-21,43,4237,51.5
13289,Twiggs County,2021-08-22,8,4245,51.6
13289,Twiggs County,2021-08-23,20,4265,51.8
13289,Twiggs County,2021-08-24,16,4281,52
13289,Twiggs County,2021-08-25,20,4301,52.3
13289,Twiggs County,2021-08-26,16,4317,52.5
13289,Twiggs County,2021-08-27,26,4343,52.8
13289,Twiggs County,2021-08-28,8,4351,52.9
13289,Twiggs County,2021-08-29,6,4357,52.9
13289,Twiggs County,2021-08-30,12,4369,53.1
13289,Twiggs County,2021-08-31,10,4379,53.2
13289,Twiggs County,2021-09-01,22,4401,53.5
13289,Twiggs County,2021-09-02,13,4414,53.6
13289,Twiggs County,2021-09-03,17,4431,53.8
13289,Twiggs County,2021-09-04,13,4444,54
13289,Twiggs County,2021-09-05,2,4446,54
13289,Twiggs County,2021-09-06,3,4449,54.1
13289,Twiggs County,2021-09-07,12,4461,54.2
13289,Twiggs County,2021-09-08,15,4476,54.4
13289,Twiggs County,2021-09-09,26,4502,54.7
13289,Twiggs County,2021-09-10,13,4515,54.9
13289,Twiggs County,2021-09-11,15,4530,55
13289,Twiggs County,2021-09-12,5,4535,55.1
13289,Twiggs County,2021-09-13,11,4546,55.2
13289,Twiggs County,2021-09-14,11,4557,55.4
13289,Twiggs County,2021-09-15,20,4577,55.6
13289,Twiggs County,2021-09-16,13,4590,55.8
13289,Twiggs County,2021-09-17,22,4612,56
13289,Twiggs County,2021-09-18,14,4626,56.2
13289,Twiggs County,2021-09-19,2,4628,56.2
13289,Twiggs County,2021-09-20,4,4632,56.3
13289,Twiggs County,2021-09-21,5,4637,56.3
13289,Twiggs County,2021-09-22,21,4658,56.6
13289,Twiggs County,2021-09-23,5,4663,56.7
13289,Twiggs County,2021-09-24,1,4664,56.7
13289,Twiggs County,2021-09-25,1,4665,56.7
13289,Twiggs County,2021-09-26,1,4666,56.7
13289,Twiggs County,2021-09-27,3,4669,56.7
13289,Twiggs County,2021-09-28,3,4672,56.8
13289,Twiggs County,2021-09-29,6,4678,56.8
13289,Twiggs County,2021-09-30,7,4685,56.9
13289,Twiggs County,2021-10-01,6,4691,57
13289,Twiggs County,2021-10-02,3,4694,57
13289,Twiggs County,2021-10-03,3,4697,57.1
13289,Twiggs County,2021-10-04,2,4699,57.1
13289,Twiggs County,2021-10-05,1,4700,57.1
13289,Twiggs County,2021-10-06,5,4705,57.2
13289,Twiggs County,2021-10-07,1,4706,57.2
13291,Union County,2020-12-16,1,1,0
13291,Union County,2020-12-18,3,4,0
13291,Union County,2020-12-19,2,6,0
13291,Union County,2020-12-20,6,12,0.1
13291,Union County,2020-12-21,1,13,0.1
13291,Union County,2020-12-22,2,15,0.1
13291,Union County,2020-12-23,86,101,0.4
13291,Union County,2020-12-24,62,163,0.7
13291,Union County,2020-12-26,1,164,0.7
13291,Union County,2020-12-28,46,210,0.9
13291,Union County,2020-12-29,104,314,1.3
13291,Union County,2020-12-30,10,324,1.4
13291,Union County,2020-12-31,6,330,1.4
13291,Union County,2021-01-01,9,339,1.5
13291,Union County,2021-01-02,1,340,1.5
13291,Union County,2021-01-04,80,420,1.8
13291,Union County,2021-01-05,88,508,2.2
13291,Union County,2021-01-06,51,559,2.4
13291,Union County,2021-01-07,39,598,2.6
13291,Union County,2021-01-08,8,606,2.6
13291,Union County,2021-01-09,4,610,2.6
13291,Union County,2021-01-10,2,612,2.6
13291,Union County,2021-01-11,43,655,2.8
13291,Union County,2021-01-12,162,817,3.5
13291,Union County,2021-01-13,126,943,4
13291,Union County,2021-01-14,295,1238,5.3
13291,Union County,2021-01-15,66,1304,5.6
13291,Union County,2021-01-16,40,1344,5.8
13291,Union County,2021-01-17,20,1364,5.9
13291,Union County,2021-01-18,141,1505,6.5
13291,Union County,2021-01-19,134,1639,7
13291,Union County,2021-01-20,119,1758,7.5
13291,Union County,2021-01-21,95,1853,8
13291,Union County,2021-01-22,769,2622,11.3
13291,Union County,2021-01-23,25,2647,11.4
13291,Union County,2021-01-24,5,2652,11.4
13291,Union County,2021-01-25,89,2741,11.8
13291,Union County,2021-01-26,75,2816,12.1
13291,Union County,2021-01-27,97,2913,12.5
13291,Union County,2021-01-28,66,2979,12.8
13291,Union County,2021-01-29,222,3201,13.7
13291,Union County,2021-01-30,14,3215,13.8
13291,Union County,2021-01-31,2,3217,13.8
13291,Union County,2021-02-01,190,3407,14.6
13291,Union County,2021-02-02,57,3464,14.9
13291,Union County,2021-02-03,77,3541,15.2
13291,Union County,2021-02-04,230,3771,16.2
13291,Union County,2021-02-05,107,3878,16.7
13291,Union County,2021-02-06,19,3897,16.7
13291,Union County,2021-02-07,13,3910,16.8
13291,Union County,2021-02-08,150,4060,17.4
13291,Union County,2021-02-09,67,4127,17.7
13291,Union County,2021-02-10,126,4253,18.3
13291,Union County,2021-02-11,88,4341,18.6
13291,Union County,2021-02-12,37,4378,18.8
13291,Union County,2021-02-13,3,4381,18.8
13291,Union County,2021-02-14,2,4383,18.8
13291,Union County,2021-02-15,38,4421,19
13291,Union County,2021-02-16,22,4443,19.1
13291,Union County,2021-02-17,23,4466,19.2
13291,Union County,2021-02-18,21,4487,19.3
13291,Union County,2021-02-19,6,4493,19.3
13291,Union County,2021-02-20,2,4495,19.3
13291,Union County,2021-02-21,1,4496,19.3
13291,Union County,2021-02-22,22,4518,19.4
13291,Union County,2021-02-23,53,4571,19.6
13291,Union County,2021-02-24,56,4627,19.9
13291,Union County,2021-02-25,60,4687,20.1
13291,Union County,2021-02-26,121,4808,20.6
13291,Union County,2021-02-27,18,4826,20.7
13291,Union County,2021-02-28,39,4865,20.9
13291,Union County,2021-03-01,88,4953,21.3
13291,Union County,2021-03-02,79,5032,21.6
13291,Union County,2021-03-03,145,5177,22.2
13291,Union County,2021-03-04,74,5251,22.5
13291,Union County,2021-03-05,95,5346,23
13291,Union County,2021-03-06,11,5357,23
13291,Union County,2021-03-07,33,5390,23.1
13291,Union County,2021-03-08,54,5444,23.4
13291,Union County,2021-03-09,170,5614,24.1
13291,Union County,2021-03-10,98,5712,24.5
13291,Union County,2021-03-11,92,5804,24.9
13291,Union County,2021-03-12,216,6020,25.9
13291,Union County,2021-03-13,26,6046,26
13291,Union County,2021-03-14,46,6092,26.2
13291,Union County,2021-03-15,147,6239,26.8
13291,Union County,2021-03-16,90,6329,27.2
13291,Union County,2021-03-17,417,6746,29
13291,Union County,2021-03-18,139,6885,29.6
13291,Union County,2021-03-19,187,7072,30.4
13291,Union County,2021-03-20,23,7095,30.5
13291,Union County,2021-03-21,42,7137,30.6
13291,Union County,2021-03-22,111,7248,31.1
13291,Union County,2021-03-23,119,7367,31.6
13291,Union County,2021-03-24,121,7488,32.2
13291,Union County,2021-03-25,121,7609,32.7
13291,Union County,2021-03-26,120,7729,33.2
13291,Union County,2021-03-27,25,7754,33.3
13291,Union County,2021-03-28,26,7780,33.4
13291,Union County,2021-03-29,89,7869,33.8
13291,Union County,2021-03-30,105,7974,34.2
13291,Union County,2021-03-31,110,8084,34.7
13291,Union County,2021-04-01,129,8213,35.3
13291,Union County,2021-04-02,49,8262,35.5
13291,Union County,2021-04-03,23,8285,35.6
13291,Union County,2021-04-04,14,8299,35.6
13291,Union County,2021-04-05,83,8382,36
13291,Union County,2021-04-06,76,8458,36.3
13291,Union County,2021-04-07,71,8529,36.6
13291,Union County,2021-04-08,75,8604,36.9
13291,Union County,2021-04-09,44,8648,37.1
13291,Union County,2021-04-10,18,8666,37.2
13291,Union County,2021-04-11,9,8675,37.3
13291,Union County,2021-04-12,44,8719,37.4
13291,Union County,2021-04-13,41,8760,37.6
13291,Union County,2021-04-14,62,8822,37.9
13291,Union County,2021-04-15,23,8845,38
13291,Union County,2021-04-16,19,8864,38.1
13291,Union County,2021-04-17,59,8923,38.3
13291,Union County,2021-04-18,2,8925,38.3
13291,Union County,2021-04-19,37,8962,38.5
13291,Union County,2021-04-20,25,8987,38.6
13291,Union County,2021-04-21,28,9015,38.7
13291,Union County,2021-04-22,29,9044,38.8
13291,Union County,2021-04-23,38,9082,39
13291,Union County,2021-04-24,7,9089,39
13291,Union County,2021-04-25,6,9095,39.1
13291,Union County,2021-04-26,18,9113,39.1
13291,Union County,2021-04-27,33,9146,39.3
13291,Union County,2021-04-28,25,9171,39.4
13291,Union County,2021-04-29,30,9201,39.5
13291,Union County,2021-04-30,18,9219,39.6
13291,Union County,2021-05-01,15,9234,39.7
13291,Union County,2021-05-02,5,9239,39.7
13291,Union County,2021-05-03,15,9254,39.7
13291,Union County,2021-05-04,54,9308,40
13291,Union County,2021-05-05,27,9335,40.1
13291,Union County,2021-05-06,28,9363,40.2
13291,Union County,2021-05-07,31,9394,40.3
13291,Union County,2021-05-08,11,9405,40.4
13291,Union County,2021-05-09,6,9411,40.4
13291,Union County,2021-05-10,22,9433,40.5
13291,Union County,2021-05-11,17,9450,40.6
13291,Union County,2021-05-12,30,9480,40.7
13291,Union County,2021-05-13,14,9494,40.8
13291,Union County,2021-05-14,17,9511,40.8
13291,Union County,2021-05-15,15,9526,40.9
13291,Union County,2021-05-16,5,9531,40.9
13291,Union County,2021-05-17,23,9554,41
13291,Union County,2021-05-18,31,9585,41.2
13291,Union County,2021-05-19,30,9615,41.3
13291,Union County,2021-05-20,22,9637,41.4
13291,Union County,2021-05-21,17,9654,41.5
13291,Union County,2021-05-22,7,9661,41.5
13291,Union County,2021-05-23,11,9672,41.5
13291,Union County,2021-05-24,11,9683,41.6
13291,Union County,2021-05-25,26,9709,41.7
13291,Union County,2021-05-26,21,9730,41.8
13291,Union County,2021-05-27,15,9745,41.8
13291,Union County,2021-05-28,11,9756,41.9
13291,Union County,2021-05-29,6,9762,41.9
13291,Union County,2021-05-30,3,9765,41.9
13291,Union County,2021-05-31,8,9773,42
13291,Union County,2021-06-01,10,9783,42
13291,Union County,2021-06-02,18,9801,42.1
13291,Union County,2021-06-03,7,9808,42.1
13291,Union County,2021-06-04,13,9821,42.2
13291,Union County,2021-06-05,10,9831,42.2
13291,Union County,2021-06-06,2,9833,42.2
13291,Union County,2021-06-07,11,9844,42.3
13291,Union County,2021-06-08,12,9856,42.3
13291,Union County,2021-06-09,11,9867,42.4
13291,Union County,2021-06-10,12,9879,42.4
13291,Union County,2021-06-11,9,9888,42.5
13291,Union County,2021-06-12,3,9891,42.5
13291,Union County,2021-06-13,2,9893,42.5
13291,Union County,2021-06-14,11,9904,42.5
13291,Union County,2021-06-15,8,9912,42.6
13291,Union County,2021-06-16,11,9923,42.6
13291,Union County,2021-06-17,6,9929,42.6
13291,Union County,2021-06-18,8,9937,42.7
13291,Union County,2021-06-19,3,9940,42.7
13291,Union County,2021-06-20,1,9941,42.7
13291,Union County,2021-06-21,8,9949,42.7
13291,Union County,2021-06-22,19,9968,42.8
13291,Union County,2021-06-23,11,9979,42.9
13291,Union County,2021-06-24,10,9989,42.9
13291,Union County,2021-06-25,15,10004,43
13291,Union County,2021-06-26,3,10007,43
13291,Union County,2021-06-27,2,10009,43
13291,Union County,2021-06-28,3,10012,43
13291,Union County,2021-06-29,10,10022,43
13291,Union County,2021-06-30,14,10036,43.1
13291,Union County,2021-07-01,5,10041,43.1
13291,Union County,2021-07-02,12,10053,43.2
13291,Union County,2021-07-03,3,10056,43.2
13291,Union County,2021-07-05,6,10062,43.2
13291,Union County,2021-07-06,4,10066,43.2
13291,Union County,2021-07-07,12,10078,43.3
13291,Union County,2021-07-08,13,10091,43.3
13291,Union County,2021-07-09,10,10101,43.4
13291,Union County,2021-07-10,3,10104,43.4
13291,Union County,2021-07-11,4,10108,43.4
13291,Union County,2021-07-12,9,10117,43.4
13291,Union County,2021-07-13,8,10125,43.5
13291,Union County,2021-07-14,3,10128,43.5
13291,Union County,2021-07-15,5,10133,43.5
13291,Union County,2021-07-16,10,10143,43.6
13291,Union County,2021-07-17,1,10144,43.6
13291,Union County,2021-07-18,4,10148,43.6
13291,Union County,2021-07-19,10,10158,43.6
13291,Union County,2021-07-20,19,10177,43.7
13291,Union County,2021-07-21,14,10191,43.8
13291,Union County,2021-07-22,16,10207,43.8
13291,Union County,2021-07-23,20,10227,43.9
13291,Union County,2021-07-24,14,10241,44
13291,Union County,2021-07-25,5,10246,44
13291,Union County,2021-07-26,13,10259,44.1
13291,Union County,2021-07-27,17,10276,44.1
13291,Union County,2021-07-28,25,10301,44.2
13291,Union County,2021-07-29,13,10314,44.3
13291,Union County,2021-07-30,26,10340,44.4
13291,Union County,2021-07-31,13,10353,44.5
13291,Union County,2021-08-01,9,10362,44.5
13291,Union County,2021-08-02,20,10382,44.6
13291,Union County,2021-08-03,20,10402,44.7
13291,Union County,2021-08-04,21,10423,44.8
13291,Union County,2021-08-05,22,10445,44.9
13291,Union County,2021-08-06,42,10487,45
13291,Union County,2021-08-07,23,10510,45.1
13291,Union County,2021-08-08,6,10516,45.2
13291,Union County,2021-08-09,33,10549,45.3
13291,Union County,2021-08-10,48,10597,45.5
13291,Union County,2021-08-11,33,10630,45.6
13291,Union County,2021-08-12,39,10669,45.8
13291,Union County,2021-08-13,47,10716,46
13291,Union County,2021-08-14,18,10734,46.1
13291,Union County,2021-08-15,14,10748,46.2
13291,Union County,2021-08-16,39,10787,46.3
13291,Union County,2021-08-17,25,10812,46.4
13291,Union County,2021-08-18,42,10854,46.6
13291,Union County,2021-08-19,38,10892,46.8
13291,Union County,2021-08-20,49,10941,47
13291,Union County,2021-08-21,22,10963,47.1
13291,Union County,2021-08-22,8,10971,47.1
13291,Union County,2021-08-23,61,11032,47.4
13291,Union County,2021-08-24,50,11082,47.6
13291,Union County,2021-08-25,40,11122,47.8
13291,Union County,2021-08-26,42,11164,47.9
13291,Union County,2021-08-27,66,11230,48.2
13291,Union County,2021-08-28,23,11253,48.3
13291,Union County,2021-08-29,21,11274,48.4
13291,Union County,2021-08-30,56,11330,48.7
13291,Union County,2021-08-31,27,11357,48.8
13291,Union County,2021-09-01,65,11422,49
13291,Union County,2021-09-02,51,11473,49.3
13291,Union County,2021-09-03,57,11530,49.5
13291,Union County,2021-09-04,31,11561,49.6
13291,Union County,2021-09-05,11,11572,49.7
13291,Union County,2021-09-06,8,11580,49.7
13291,Union County,2021-09-07,36,11616,49.9
13291,Union County,2021-09-08,55,11671,50.1
13291,Union County,2021-09-09,36,11707,50.3
13291,Union County,2021-09-10,46,11753,50.5
13291,Union County,2021-09-11,20,11773,50.6
13291,Union County,2021-09-12,6,11779,50.6
13291,Union County,2021-09-13,28,11807,50.7
13291,Union County,2021-09-14,20,11827,50.8
13291,Union County,2021-09-15,26,11853,50.9
13291,Union County,2021-09-16,22,11875,51
13291,Union County,2021-09-17,36,11911,51.1
13291,Union County,2021-09-18,6,11917,51.2
13291,Union County,2021-09-19,8,11925,51.2
13291,Union County,2021-09-20,18,11943,51.3
13291,Union County,2021-09-21,19,11962,51.4
13291,Union County,2021-09-22,23,11985,51.5
13291,Union County,2021-09-23,20,12005,51.6
13291,Union County,2021-09-24,16,12021,51.6
13291,Union County,2021-09-25,5,12026,51.6
13291,Union County,2021-09-26,3,12029,51.7
13291,Union County,2021-09-27,9,12038,51.7
13291,Union County,2021-09-28,11,12049,51.7
13291,Union County,2021-09-29,8,12057,51.8
13291,Union County,2021-09-30,12,12069,51.8
13291,Union County,2021-10-01,7,12076,51.9
13291,Union County,2021-10-02,1,12077,51.9
13291,Union County,2021-10-03,2,12079,51.9
13291,Union County,2021-10-04,4,12083,51.9
13291,Union County,2021-10-05,9,12092,51.9
13291,Union County,2021-10-06,6,12098,51.9
13293,Upson County,2020-12-16,1,1,0
13293,Upson County,2020-12-18,1,2,0
13293,Upson County,2020-12-19,5,7,0
13293,Upson County,2020-12-20,1,8,0
13293,Upson County,2020-12-21,17,25,0.1
13293,Upson County,2020-12-22,37,62,0.2
13293,Upson County,2020-12-23,72,134,0.5
13293,Upson County,2020-12-24,1,135,0.5
13293,Upson County,2020-12-26,2,137,0.5
13293,Upson County,2020-12-28,17,154,0.6
13293,Upson County,2020-12-29,108,262,1
13293,Upson County,2020-12-30,24,286,1.1
13293,Upson County,2020-12-31,90,376,1.4
13293,Upson County,2021-01-01,3,379,1.4
13293,Upson County,2021-01-03,7,386,1.5
13293,Upson County,2021-01-04,103,489,1.9
13293,Upson County,2021-01-05,126,615,2.3
13293,Upson County,2021-01-06,29,644,2.5
13293,Upson County,2021-01-07,6,650,2.5
13293,Upson County,2021-01-08,33,683,2.6
13293,Upson County,2021-01-09,13,696,2.7
13293,Upson County,2021-01-10,12,708,2.7
13293,Upson County,2021-01-11,15,723,2.8
13293,Upson County,2021-01-12,117,840,3.2
13293,Upson County,2021-01-13,171,1011,3.9
13293,Upson County,2021-01-14,150,1161,4.4
13293,Upson County,2021-01-15,181,1342,5.1
13293,Upson County,2021-01-16,26,1368,5.2
13293,Upson County,2021-01-17,12,1380,5.3
13293,Upson County,2021-01-18,35,1415,5.4
13293,Upson County,2021-01-19,144,1559,5.9
13293,Upson County,2021-01-20,33,1592,6.1
13293,Upson County,2021-01-21,218,1810,6.9
13293,Upson County,2021-01-22,195,2005,7.6
13293,Upson County,2021-01-23,4,2009,7.7
13293,Upson County,2021-01-24,28,2037,7.8
13293,Upson County,2021-01-25,142,2179,8.3
13293,Upson County,2021-01-26,158,2337,8.9
13293,Upson County,2021-01-27,24,2361,9
13293,Upson County,2021-01-28,116,2477,9.4
13293,Upson County,2021-01-29,111,2588,9.9
13293,Upson County,2021-01-30,5,2593,9.9
13293,Upson County,2021-01-31,3,2596,9.9
13293,Upson County,2021-02-01,34,2630,10
13293,Upson County,2021-02-02,68,2698,10.3
13293,Upson County,2021-02-03,31,2729,10.4
13293,Upson County,2021-02-04,155,2884,11
13293,Upson County,2021-02-05,38,2922,11.1
13293,Upson County,2021-02-06,2,2924,11.1
13293,Upson County,2021-02-07,1,2925,11.1
13293,Upson County,2021-02-08,3,2928,11.2
13293,Upson County,2021-02-09,58,2986,11.4
13293,Upson County,2021-02-10,6,2992,11.4
13293,Upson County,2021-02-11,72,3064,11.7
13293,Upson County,2021-02-12,38,3102,11.8
13293,Upson County,2021-02-13,6,3108,11.8
13293,Upson County,2021-02-14,5,3113,11.9
13293,Upson County,2021-02-15,7,3120,11.9
13293,Upson County,2021-02-16,31,3151,12
13293,Upson County,2021-02-17,7,3158,12
13293,Upson County,2021-02-18,92,3250,12.4
13293,Upson County,2021-02-19,55,3305,12.6
13293,Upson County,2021-02-20,12,3317,12.6
13293,Upson County,2021-02-22,6,3323,12.7
13293,Upson County,2021-02-23,58,3381,12.9
13293,Upson County,2021-02-24,8,3389,12.9
13293,Upson County,2021-02-25,113,3502,13.3
13293,Upson County,2021-02-26,94,3596,13.7
13293,Upson County,2021-02-27,9,3605,13.7
13293,Upson County,2021-02-28,22,3627,13.8
13293,Upson County,2021-03-01,27,3654,13.9
13293,Upson County,2021-03-02,92,3746,14.3
13293,Upson County,2021-03-03,39,3785,14.4
13293,Upson County,2021-03-04,132,3917,14.9
13293,Upson County,2021-03-05,106,4023,15.3
13293,Upson County,2021-03-06,15,4038,15.4
13293,Upson County,2021-03-07,8,4046,15.4
13293,Upson County,2021-03-08,222,4268,16.3
13293,Upson County,2021-03-09,109,4377,16.7
13293,Upson County,2021-03-10,47,4424,16.9
13293,Upson County,2021-03-11,177,4601,17.5
13293,Upson County,2021-03-12,130,4731,18
13293,Upson County,2021-03-13,17,4748,18.1
13293,Upson County,2021-03-14,10,4758,18.1
13293,Upson County,2021-03-15,39,4797,18.3
13293,Upson County,2021-03-16,98,4895,18.7
13293,Upson County,2021-03-17,57,4952,18.9
13293,Upson County,2021-03-18,111,5063,19.3
13293,Upson County,2021-03-19,98,5161,19.7
13293,Upson County,2021-03-20,14,5175,19.7
13293,Upson County,2021-03-21,13,5188,19.8
13293,Upson County,2021-03-22,52,5240,20
13293,Upson County,2021-03-23,134,5374,20.5
13293,Upson County,2021-03-24,66,5440,20.7
13293,Upson County,2021-03-25,182,5622,21.4
13293,Upson County,2021-03-26,117,5739,21.9
13293,Upson County,2021-03-27,22,5761,22
13293,Upson County,2021-03-28,9,5770,22
13293,Upson County,2021-03-29,74,5844,22.3
13293,Upson County,2021-03-30,96,5940,22.6
13293,Upson County,2021-03-31,55,5995,22.9
13293,Upson County,2021-04-01,209,6204,23.6
13293,Upson County,2021-04-02,94,6298,24
13293,Upson County,2021-04-03,13,6311,24.1
13293,Upson County,2021-04-04,19,6330,24.1
13293,Upson County,2021-04-05,53,6383,24.3
13293,Upson County,2021-04-06,121,6504,24.8
13293,Upson County,2021-04-07,98,6602,25.2
13293,Upson County,2021-04-08,161,6763,25.8
13293,Upson County,2021-04-09,156,6919,26.4
13293,Upson County,2021-04-10,26,6945,26.5
13293,Upson County,2021-04-11,16,6961,26.5
13293,Upson County,2021-04-12,52,7013,26.7
13293,Upson County,2021-04-13,109,7122,27.1
13293,Upson County,2021-04-14,39,7161,27.3
13293,Upson County,2021-04-15,152,7313,27.9
13293,Upson County,2021-04-16,159,7472,28.5
13293,Upson County,2021-04-17,10,7482,28.5
13293,Upson County,2021-04-18,4,7486,28.5
13293,Upson County,2021-04-19,15,7501,28.6
13293,Upson County,2021-04-20,133,7634,29.1
13293,Upson County,2021-04-21,32,7666,29.2
13293,Upson County,2021-04-22,74,7740,29.5
13293,Upson County,2021-04-23,51,7791,29.7
13293,Upson County,2021-04-24,19,7810,29.8
13293,Upson County,2021-04-25,2,7812,29.8
13293,Upson County,2021-04-26,22,7834,29.9
13293,Upson County,2021-04-27,48,7882,30
13293,Upson County,2021-04-28,32,7914,30.2
13293,Upson County,2021-04-29,46,7960,30.3
13293,Upson County,2021-04-30,58,8018,30.6
13293,Upson County,2021-05-01,13,8031,30.6
13293,Upson County,2021-05-02,13,8044,30.7
13293,Upson County,2021-05-03,29,8073,30.8
13293,Upson County,2021-05-04,47,8120,30.9
13293,Upson County,2021-05-05,38,8158,31.1
13293,Upson County,2021-05-06,48,8206,31.3
13293,Upson County,2021-05-07,60,8266,31.5
13293,Upson County,2021-05-08,26,8292,31.6
13293,Upson County,2021-05-09,2,8294,31.6
13293,Upson County,2021-05-10,11,8305,31.7
13293,Upson County,2021-05-11,41,8346,31.8
13293,Upson County,2021-05-12,20,8366,31.9
13293,Upson County,2021-05-13,33,8399,32
13293,Upson County,2021-05-14,64,8463,32.3
13293,Upson County,2021-05-15,25,8488,32.4
13293,Upson County,2021-05-16,10,8498,32.4
13293,Upson County,2021-05-17,20,8518,32.5
13293,Upson County,2021-05-18,48,8566,32.6
13293,Upson County,2021-05-19,22,8588,32.7
13293,Upson County,2021-05-20,25,8613,32.8
13293,Upson County,2021-05-21,38,8651,33
13293,Upson County,2021-05-22,15,8666,33
13293,Upson County,2021-05-23,7,8673,33.1
13293,Upson County,2021-05-24,9,8682,33.1
13293,Upson County,2021-05-25,43,8725,33.3
13293,Upson County,2021-05-26,27,8752,33.4
13293,Upson County,2021-05-27,25,8777,33.5
13293,Upson County,2021-05-28,23,8800,33.5
13293,Upson County,2021-05-29,4,8804,33.6
13293,Upson County,2021-05-30,6,8810,33.6
13293,Upson County,2021-05-31,7,8817,33.6
13293,Upson County,2021-06-01,38,8855,33.8
13293,Upson County,2021-06-02,19,8874,33.8
13293,Upson County,2021-06-03,22,8896,33.9
13293,Upson County,2021-06-04,33,8929,34
13293,Upson County,2021-06-05,13,8942,34.1
13293,Upson County,2021-06-06,5,8947,34.1
13293,Upson County,2021-06-07,11,8958,34.1
13293,Upson County,2021-06-08,19,8977,34.2
13293,Upson County,2021-06-09,10,8987,34.3
13293,Upson County,2021-06-10,19,9006,34.3
13293,Upson County,2021-06-11,17,9023,34.4
13293,Upson County,2021-06-12,9,9032,34.4
13293,Upson County,2021-06-13,1,9033,34.4
13293,Upson County,2021-06-14,5,9038,34.4
13293,Upson County,2021-06-15,27,9065,34.6
13293,Upson County,2021-06-16,18,9083,34.6
13293,Upson County,2021-06-17,19,9102,34.7
13293,Upson County,2021-06-18,20,9122,34.8
13293,Upson County,2021-06-19,1,9123,34.8
13293,Upson County,2021-06-20,6,9129,34.8
13293,Upson County,2021-06-21,13,9142,34.8
13293,Upson County,2021-06-22,21,9163,34.9
13293,Upson County,2021-06-23,13,9176,35
13293,Upson County,2021-06-24,9,9185,35
13293,Upson County,2021-06-25,19,9204,35.1
13293,Upson County,2021-06-26,4,9208,35.1
13293,Upson County,2021-06-27,5,9213,35.1
13293,Upson County,2021-06-28,14,9227,35.2
13293,Upson County,2021-06-29,15,9242,35.2
13293,Upson County,2021-06-30,10,9252,35.3
13293,Upson County,2021-07-01,14,9266,35.3
13293,Upson County,2021-07-02,7,9273,35.3
13293,Upson County,2021-07-03,8,9281,35.4
13293,Upson County,2021-07-04,1,9282,35.4
13293,Upson County,2021-07-05,5,9287,35.4
13293,Upson County,2021-07-06,15,9302,35.5
13293,Upson County,2021-07-07,10,9312,35.5
13293,Upson County,2021-07-08,14,9326,35.5
13293,Upson County,2021-07-09,15,9341,35.6
13293,Upson County,2021-07-10,4,9345,35.6
13293,Upson County,2021-07-11,8,9353,35.6
13293,Upson County,2021-07-12,9,9362,35.7
13293,Upson County,2021-07-13,18,9380,35.8
13293,Upson County,2021-07-14,4,9384,35.8
13293,Upson County,2021-07-15,16,9400,35.8
13293,Upson County,2021-07-16,23,9423,35.9
13293,Upson County,2021-07-17,8,9431,35.9
13293,Upson County,2021-07-18,2,9433,36
13293,Upson County,2021-07-19,15,9448,36
13293,Upson County,2021-07-20,15,9463,36.1
13293,Upson County,2021-07-21,26,9489,36.2
13293,Upson County,2021-07-22,23,9512,36.3
13293,Upson County,2021-07-23,33,9545,36.4
13293,Upson County,2021-07-24,18,9563,36.4
13293,Upson County,2021-07-25,12,9575,36.5
13293,Upson County,2021-07-26,34,9609,36.6
13293,Upson County,2021-07-27,37,9646,36.8
13293,Upson County,2021-07-28,44,9690,36.9
13293,Upson County,2021-07-29,47,9737,37.1
13293,Upson County,2021-07-30,73,9810,37.4
13293,Upson County,2021-07-31,16,9826,37.5
13293,Upson County,2021-08-01,21,9847,37.5
13293,Upson County,2021-08-02,30,9877,37.6
13293,Upson County,2021-08-03,36,9913,37.8
13293,Upson County,2021-08-04,33,9946,37.9
13293,Upson County,2021-08-05,50,9996,38.1
13293,Upson County,2021-08-06,81,10077,38.4
13293,Upson County,2021-08-07,31,10108,38.5
13293,Upson County,2021-08-08,15,10123,38.6
13293,Upson County,2021-08-09,41,10164,38.7
13293,Upson County,2021-08-10,67,10231,39
13293,Upson County,2021-08-11,40,10271,39.1
13293,Upson County,2021-08-12,50,10321,39.3
13293,Upson County,2021-08-13,95,10416,39.7
13293,Upson County,2021-08-14,26,10442,39.8
13293,Upson County,2021-08-15,25,10467,39.9
13293,Upson County,2021-08-16,48,10515,40.1
13293,Upson County,2021-08-17,67,10582,40.3
13293,Upson County,2021-08-18,63,10645,40.6
13293,Upson County,2021-08-19,47,10692,40.8
13293,Upson County,2021-08-20,99,10791,41.1
13293,Upson County,2021-08-21,36,10827,41.3
13293,Upson County,2021-08-22,33,10860,41.4
13293,Upson County,2021-08-23,53,10913,41.6
13293,Upson County,2021-08-24,118,11031,42
13293,Upson County,2021-08-25,54,11085,42.3
13293,Upson County,2021-08-26,58,11143,42.5
13293,Upson County,2021-08-27,87,11230,42.8
13293,Upson County,2021-08-28,31,11261,42.9
13293,Upson County,2021-08-29,30,11291,43
13293,Upson County,2021-08-30,66,11357,43.3
13293,Upson County,2021-08-31,73,11430,43.6
13293,Upson County,2021-09-01,58,11488,43.8
13293,Upson County,2021-09-02,53,11541,44
13293,Upson County,2021-09-03,121,11662,44.5
13293,Upson County,2021-09-04,28,11690,44.6
13293,Upson County,2021-09-05,21,11711,44.6
13293,Upson County,2021-09-06,13,11724,44.7
13293,Upson County,2021-09-07,70,11794,45
13293,Upson County,2021-09-08,37,11831,45.1
13293,Upson County,2021-09-09,51,11882,45.3
13293,Upson County,2021-09-10,71,11953,45.6
13293,Upson County,2021-09-11,27,11980,45.7
13293,Upson County,2021-09-12,19,11999,45.7
13293,Upson County,2021-09-13,56,12055,45.9
13293,Upson County,2021-09-14,56,12111,46.2
13293,Upson County,2021-09-15,26,12137,46.3
13293,Upson County,2021-09-16,27,12164,46.4
13293,Upson County,2021-09-17,67,12231,46.6
13293,Upson County,2021-09-18,22,12253,46.7
13293,Upson County,2021-09-19,18,12271,46.8
13293,Upson County,2021-09-20,24,12295,46.9
13293,Upson County,2021-09-21,28,12323,47
13293,Upson County,2021-09-22,18,12341,47
13293,Upson County,2021-09-23,28,12369,47.1
13293,Upson County,2021-09-24,34,12403,47.3
13293,Upson County,2021-09-25,9,12412,47.3
13293,Upson County,2021-09-26,7,12419,47.3
13293,Upson County,2021-09-27,14,12433,47.4
13293,Upson County,2021-09-28,16,12449,47.5
13293,Upson County,2021-09-29,9,12458,47.5
13293,Upson County,2021-09-30,28,12486,47.6
13293,Upson County,2021-10-01,29,12515,47.7
13293,Upson County,2021-10-02,5,12520,47.7
13293,Upson County,2021-10-03,7,12527,47.7
13293,Upson County,2021-10-04,4,12531,47.8
13293,Upson County,2021-10-05,13,12544,47.8
13293,Upson County,2021-10-06,8,12552,47.8
13293,Upson County,2021-10-07,2,12554,47.9
13295,Walker County,2020-12-14,1,1,0
13295,Walker County,2020-12-18,13,14,0
13295,Walker County,2020-12-19,4,18,0
13295,Walker County,2020-12-20,4,22,0
13295,Walker County,2020-12-21,16,38,0.1
13295,Walker County,2020-12-22,30,68,0.1
13295,Walker County,2020-12-23,30,98,0.1
13295,Walker County,2020-12-24,1,99,0.1
13295,Walker County,2020-12-26,2,101,0.1
13295,Walker County,2020-12-27,2,103,0.1
13295,Walker County,2020-12-28,49,152,0.2
13295,Walker County,2020-12-29,21,173,0.3
13295,Walker County,2020-12-30,29,202,0.3
13295,Walker County,2020-12-31,15,217,0.3
13295,Walker County,2021-01-01,2,219,0.3
13295,Walker County,2021-01-03,112,331,0.5
13295,Walker County,2021-01-04,40,371,0.5
13295,Walker County,2021-01-05,89,460,0.7
13295,Walker County,2021-01-06,50,510,0.7
13295,Walker County,2021-01-07,40,550,0.8
13295,Walker County,2021-01-08,62,612,0.9
13295,Walker County,2021-01-09,8,620,0.9
13295,Walker County,2021-01-10,3,623,0.9
13295,Walker County,2021-01-11,141,764,1.1
13295,Walker County,2021-01-12,196,960,1.4
13295,Walker County,2021-01-13,207,1167,1.7
13295,Walker County,2021-01-14,408,1575,2.3
13295,Walker County,2021-01-15,185,1760,2.5
13295,Walker County,2021-01-16,46,1806,2.6
13295,Walker County,2021-01-17,9,1815,2.6
13295,Walker County,2021-01-18,115,1930,2.8
13295,Walker County,2021-01-19,224,2154,3.1
13295,Walker County,2021-01-20,244,2398,3.5
13295,Walker County,2021-01-21,289,2687,3.9
13295,Walker County,2021-01-22,223,2910,4.2
13295,Walker County,2021-01-23,4,2914,4.2
13295,Walker County,2021-01-24,21,2935,4.3
13295,Walker County,2021-01-25,262,3197,4.6
13295,Walker County,2021-01-26,230,3427,5
13295,Walker County,2021-01-27,383,3810,5.5
13295,Walker County,2021-01-28,411,4221,6.1
13295,Walker County,2021-01-29,296,4517,6.5
13295,Walker County,2021-01-30,9,4526,6.6
13295,Walker County,2021-02-01,386,4912,7.1
13295,Walker County,2021-02-02,275,5187,7.5
13295,Walker County,2021-02-03,241,5428,7.9
13295,Walker County,2021-02-04,199,5627,8.2
13295,Walker County,2021-02-05,171,5798,8.4
13295,Walker County,2021-02-06,1,5799,8.4
13295,Walker County,2021-02-07,4,5803,8.4
13295,Walker County,2021-02-08,61,5864,8.5
13295,Walker County,2021-02-09,31,5895,8.5
13295,Walker County,2021-02-10,101,5996,8.7
13295,Walker County,2021-02-11,122,6118,8.9
13295,Walker County,2021-02-12,25,6143,8.9
13295,Walker County,2021-02-13,4,6147,8.9
13295,Walker County,2021-02-14,2,6149,8.9
13295,Walker County,2021-02-15,150,6299,9.1
13295,Walker County,2021-02-16,12,6311,9.1
13295,Walker County,2021-02-17,10,6321,9.2
13295,Walker County,2021-02-18,71,6392,9.3
13295,Walker County,2021-02-19,40,6432,9.3
13295,Walker County,2021-02-20,1,6433,9.3
13295,Walker County,2021-02-21,4,6437,9.3
13295,Walker County,2021-02-22,29,6466,9.4
13295,Walker County,2021-02-23,23,6489,9.4
13295,Walker County,2021-02-24,99,6588,9.5
13295,Walker County,2021-02-25,66,6654,9.6
13295,Walker County,2021-02-26,47,6701,9.7
13295,Walker County,2021-02-27,18,6719,9.7
13295,Walker County,2021-02-28,10,6729,9.7
13295,Walker County,2021-03-01,172,6901,10
13295,Walker County,2021-03-02,93,6994,10.1
13295,Walker County,2021-03-03,400,7394,10.7
13295,Walker County,2021-03-04,181,7575,11
13295,Walker County,2021-03-05,185,7760,11.2
13295,Walker County,2021-03-06,16,7776,11.3
13295,Walker County,2021-03-07,20,7796,11.3
13295,Walker County,2021-03-08,224,8020,11.6
13295,Walker County,2021-03-09,401,8421,12.2
13295,Walker County,2021-03-10,647,9068,13.1
13295,Walker County,2021-03-11,505,9573,13.9
13295,Walker County,2021-03-12,337,9910,14.4
13295,Walker County,2021-03-13,28,9938,14.4
13295,Walker County,2021-03-14,11,9949,14.4
13295,Walker County,2021-03-15,211,10160,14.7
13295,Walker County,2021-03-16,336,10496,15.2
13295,Walker County,2021-03-17,393,10889,15.8
13295,Walker County,2021-03-18,247,11136,16.1
13295,Walker County,2021-03-19,187,11323,16.4
13295,Walker County,2021-03-20,25,11348,16.4
13295,Walker County,2021-03-21,16,11364,16.5
13295,Walker County,2021-03-22,238,11602,16.8
13295,Walker County,2021-03-23,175,11777,17.1
13295,Walker County,2021-03-24,280,12057,17.5
13295,Walker County,2021-03-25,301,12358,17.9
13295,Walker County,2021-03-26,411,12769,18.5
13295,Walker County,2021-03-27,26,12795,18.5
13295,Walker County,2021-03-28,36,12831,18.6
13295,Walker County,2021-03-29,124,12955,18.8
13295,Walker County,2021-03-30,218,13173,19.1
13295,Walker County,2021-03-31,248,13421,19.4
13295,Walker County,2021-04-01,415,13836,20
13295,Walker County,2021-04-02,118,13954,20.2
13295,Walker County,2021-04-03,26,13980,20.2
13295,Walker County,2021-04-04,14,13994,20.3
13295,Walker County,2021-04-05,129,14123,20.5
13295,Walker County,2021-04-06,103,14226,20.6
13295,Walker County,2021-04-07,183,14409,20.9
13295,Walker County,2021-04-08,223,14632,21.2
13295,Walker County,2021-04-09,148,14780,21.4
13295,Walker County,2021-04-10,162,14942,21.6
13295,Walker County,2021-04-11,28,14970,21.7
13295,Walker County,2021-04-12,114,15084,21.8
13295,Walker County,2021-04-13,129,15213,22
13295,Walker County,2021-04-14,106,15319,22.2
13295,Walker County,2021-04-15,84,15403,22.3
13295,Walker County,2021-04-16,96,15499,22.4
13295,Walker County,2021-04-17,17,15516,22.5
13295,Walker County,2021-04-18,13,15529,22.5
13295,Walker County,2021-04-19,63,15592,22.6
13295,Walker County,2021-04-20,48,15640,22.7
13295,Walker County,2021-04-21,121,15761,22.8
13295,Walker County,2021-04-22,128,15889,23
13295,Walker County,2021-04-23,85,15974,23.1
13295,Walker County,2021-04-24,21,15995,23.2
13295,Walker County,2021-04-25,8,16003,23.2
13295,Walker County,2021-04-26,43,16046,23.2
13295,Walker County,2021-04-27,52,16098,23.3
13295,Walker County,2021-04-28,89,16187,23.4
13295,Walker County,2021-04-29,102,16289,23.6
13295,Walker County,2021-04-30,93,16382,23.7
13295,Walker County,2021-05-01,29,16411,23.8
13295,Walker County,2021-05-02,19,16430,23.8
13295,Walker County,2021-05-03,39,16469,23.9
13295,Walker County,2021-05-04,269,16738,24.2
13295,Walker County,2021-05-05,43,16781,24.3
13295,Walker County,2021-05-06,112,16893,24.5
13295,Walker County,2021-05-07,90,16983,24.6
13295,Walker County,2021-05-08,34,17017,24.6
13295,Walker County,2021-05-09,5,17022,24.7
13295,Walker County,2021-05-10,30,17052,24.7
13295,Walker County,2021-05-11,36,17088,24.8
13295,Walker County,2021-05-12,60,17148,24.8
13295,Walker County,2021-05-13,109,17257,25
13295,Walker County,2021-05-14,75,17332,25.1
13295,Walker County,2021-05-15,57,17389,25.2
13295,Walker County,2021-05-16,35,17424,25.2
13295,Walker County,2021-05-17,72,17496,25.3
13295,Walker County,2021-05-18,61,17557,25.4
13295,Walker County,2021-05-19,86,17643,25.6
13295,Walker County,2021-05-20,60,17703,25.6
13295,Walker County,2021-05-21,116,17819,25.8
13295,Walker County,2021-05-22,80,17899,25.9
13295,Walker County,2021-05-23,14,17913,25.9
13295,Walker County,2021-05-24,70,17983,26
13295,Walker County,2021-05-25,51,18034,26.1
13295,Walker County,2021-05-26,35,18069,26.2
13295,Walker County,2021-05-27,33,18102,26.2
13295,Walker County,2021-05-28,51,18153,26.3
13295,Walker County,2021-05-29,31,18184,26.3
13295,Walker County,2021-05-30,22,18206,26.4
13295,Walker County,2021-05-31,9,18215,26.4
13295,Walker County,2021-06-01,33,18248,26.4
13295,Walker County,2021-06-02,37,18285,26.5
13295,Walker County,2021-06-03,46,18331,26.6
13295,Walker County,2021-06-04,50,18381,26.6
13295,Walker County,2021-06-05,16,18397,26.6
13295,Walker County,2021-06-06,16,18413,26.7
13295,Walker County,2021-06-07,25,18438,26.7
13295,Walker County,2021-06-08,25,18463,26.7
13295,Walker County,2021-06-09,24,18487,26.8
13295,Walker County,2021-06-10,59,18546,26.9
13295,Walker County,2021-06-11,44,18590,26.9
13295,Walker County,2021-06-12,20,18610,27
13295,Walker County,2021-06-13,7,18617,27
13295,Walker County,2021-06-14,34,18651,27
13295,Walker County,2021-06-15,26,18677,27.1
13295,Walker County,2021-06-16,23,18700,27.1
13295,Walker County,2021-06-17,31,18731,27.1
13295,Walker County,2021-06-18,41,18772,27.2
13295,Walker County,2021-06-19,8,18780,27.2
13295,Walker County,2021-06-20,10,18790,27.2
13295,Walker County,2021-06-21,29,18819,27.3
13295,Walker County,2021-06-22,17,18836,27.3
13295,Walker County,2021-06-23,18,18854,27.3
13295,Walker County,2021-06-24,37,18891,27.4
13295,Walker County,2021-06-25,32,18923,27.4
13295,Walker County,2021-06-26,25,18948,27.4
13295,Walker County,2021-06-27,11,18959,27.5
13295,Walker County,2021-06-28,18,18977,27.5
13295,Walker County,2021-06-29,22,18999,27.5
13295,Walker County,2021-06-30,30,19029,27.6
13295,Walker County,2021-07-01,28,19057,27.6
13295,Walker County,2021-07-02,35,19092,27.7
13295,Walker County,2021-07-03,15,19107,27.7
13295,Walker County,2021-07-04,2,19109,27.7
13295,Walker County,2021-07-05,17,19126,27.7
13295,Walker County,2021-07-06,14,19140,27.7
13295,Walker County,2021-07-07,21,19161,27.8
13295,Walker County,2021-07-08,24,19185,27.8
13295,Walker County,2021-07-09,37,19222,27.8
13295,Walker County,2021-07-10,20,19242,27.9
13295,Walker County,2021-07-11,9,19251,27.9
13295,Walker County,2021-07-12,24,19275,27.9
13295,Walker County,2021-07-13,22,19297,28
13295,Walker County,2021-07-14,19,19316,28
13295,Walker County,2021-07-15,31,19347,28
13295,Walker County,2021-07-16,33,19380,28.1
13295,Walker County,2021-07-17,20,19400,28.1
13295,Walker County,2021-07-18,13,19413,28.1
13295,Walker County,2021-07-19,21,19434,28.1
13295,Walker County,2021-07-20,43,19477,28.2
13295,Walker County,2021-07-21,42,19519,28.3
13295,Walker County,2021-07-22,56,19575,28.4
13295,Walker County,2021-07-23,99,19674,28.5
13295,Walker County,2021-07-24,51,19725,28.6
13295,Walker County,2021-07-25,29,19754,28.6
13295,Walker County,2021-07-26,53,19807,28.7
13295,Walker County,2021-07-27,78,19885,28.8
13295,Walker County,2021-07-28,68,19953,28.9
13295,Walker County,2021-07-29,87,20040,29
13295,Walker County,2021-07-30,93,20133,29.2
13295,Walker County,2021-07-31,48,20181,29.2
13295,Walker County,2021-08-01,49,20230,29.3
13295,Walker County,2021-08-02,63,20293,29.4
13295,Walker County,2021-08-03,102,20395,29.5
13295,Walker County,2021-08-04,85,20480,29.7
13295,Walker County,2021-08-05,120,20600,29.8
13295,Walker County,2021-08-06,122,20722,30
13295,Walker County,2021-08-07,78,20800,30.1
13295,Walker County,2021-08-08,37,20837,30.2
13295,Walker County,2021-08-09,61,20898,30.3
13295,Walker County,2021-08-10,78,20976,30.4
13295,Walker County,2021-08-11,63,21039,30.5
13295,Walker County,2021-08-12,92,21131,30.6
13295,Walker County,2021-08-13,101,21232,30.8
13295,Walker County,2021-08-14,68,21300,30.9
13295,Walker County,2021-08-15,43,21343,30.9
13295,Walker County,2021-08-16,82,21425,31
13295,Walker County,2021-08-17,91,21516,31.2
13295,Walker County,2021-08-18,90,21606,31.3
13295,Walker County,2021-08-19,130,21736,31.5
13295,Walker County,2021-08-20,136,21872,31.7
13295,Walker County,2021-08-21,71,21943,31.8
13295,Walker County,2021-08-22,45,21988,31.8
13295,Walker County,2021-08-23,90,22078,32
13295,Walker County,2021-08-24,84,22162,32.1
13295,Walker County,2021-08-25,88,22250,32.2
13295,Walker County,2021-08-26,116,22366,32.4
13295,Walker County,2021-08-27,130,22496,32.6
13295,Walker County,2021-08-28,70,22566,32.7
13295,Walker County,2021-08-29,47,22613,32.8
13295,Walker County,2021-08-30,102,22715,32.9
13295,Walker County,2021-08-31,59,22774,33
13295,Walker County,2021-09-01,101,22875,33.1
13295,Walker County,2021-09-02,103,22978,33.3
13295,Walker County,2021-09-03,137,23115,33.5
13295,Walker County,2021-09-04,57,23172,33.6
13295,Walker County,2021-09-05,45,23217,33.6
13295,Walker County,2021-09-06,31,23248,33.7
13295,Walker County,2021-09-07,63,23311,33.8
13295,Walker County,2021-09-08,54,23365,33.8
13295,Walker County,2021-09-09,103,23468,34
13295,Walker County,2021-09-10,79,23547,34.1
13295,Walker County,2021-09-11,40,23587,34.2
13295,Walker County,2021-09-12,31,23618,34.2
13295,Walker County,2021-09-13,52,23670,34.3
13295,Walker County,2021-09-14,58,23728,34.4
13295,Walker County,2021-09-15,61,23789,34.5
13295,Walker County,2021-09-16,77,23866,34.6
13295,Walker County,2021-09-17,50,23916,34.6
13295,Walker County,2021-09-18,25,23941,34.7
13295,Walker County,2021-09-19,29,23970,34.7
13295,Walker County,2021-09-20,33,24003,34.8
13295,Walker County,2021-09-21,46,24049,34.8
13295,Walker County,2021-09-22,38,24087,34.9
13295,Walker County,2021-09-23,35,24122,34.9
13295,Walker County,2021-09-24,30,24152,35
13295,Walker County,2021-09-25,23,24175,35
13295,Walker County,2021-09-26,12,24187,35
13295,Walker County,2021-09-27,26,24213,35.1
13295,Walker County,2021-09-28,23,24236,35.1
13295,Walker County,2021-09-29,15,24251,35.1
13295,Walker County,2021-09-30,23,24274,35.2
13295,Walker County,2021-10-01,27,24301,35.2
13295,Walker County,2021-10-02,19,24320,35.2
13295,Walker County,2021-10-03,9,24329,35.2
13295,Walker County,2021-10-04,15,24344,35.3
13295,Walker County,2021-10-05,10,24354,35.3
13295,Walker County,2021-10-06,17,24371,35.3
13295,Walker County,2021-10-07,10,24381,35.3
13297,Walton County,2020-12-12,1,1,0
13297,Walton County,2020-12-16,2,3,0
13297,Walton County,2020-12-17,27,30,0
13297,Walton County,2020-12-18,26,56,0.1
13297,Walton County,2020-12-19,21,77,0.1
13297,Walton County,2020-12-20,18,95,0.1
13297,Walton County,2020-12-21,34,129,0.1
13297,Walton County,2020-12-22,62,191,0.2
13297,Walton County,2020-12-23,87,278,0.3
13297,Walton County,2020-12-24,18,296,0.3
13297,Walton County,2020-12-26,8,304,0.3
13297,Walton County,2020-12-27,15,319,0.3
13297,Walton County,2020-12-28,93,412,0.5
13297,Walton County,2020-12-29,101,513,0.6
13297,Walton County,2020-12-30,93,606,0.7
13297,Walton County,2020-12-31,84,690,0.8
13297,Walton County,2021-01-01,13,703,0.8
13297,Walton County,2021-01-02,29,732,0.8
13297,Walton County,2021-01-03,33,765,0.8
13297,Walton County,2021-01-04,102,867,0.9
13297,Walton County,2021-01-05,93,960,1
13297,Walton County,2021-01-06,85,1045,1.1
13297,Walton County,2021-01-07,94,1139,1.2
13297,Walton County,2021-01-08,152,1291,1.4
13297,Walton County,2021-01-09,47,1338,1.5
13297,Walton County,2021-01-10,23,1361,1.5
13297,Walton County,2021-01-11,72,1433,1.6
13297,Walton County,2021-01-12,90,1523,1.7
13297,Walton County,2021-01-13,168,1691,1.8
13297,Walton County,2021-01-14,141,1832,2
13297,Walton County,2021-01-15,263,2095,2.3
13297,Walton County,2021-01-16,167,2262,2.5
13297,Walton County,2021-01-17,57,2319,2.5
13297,Walton County,2021-01-18,140,2459,2.7
13297,Walton County,2021-01-19,218,2677,2.9
13297,Walton County,2021-01-20,359,3036,3.3
13297,Walton County,2021-01-21,433,3469,3.8
13297,Walton County,2021-01-22,247,3716,4.1
13297,Walton County,2021-01-23,174,3890,4.3
13297,Walton County,2021-01-24,37,3927,4.3
13297,Walton County,2021-01-25,261,4188,4.6
13297,Walton County,2021-01-26,193,4381,4.8
13297,Walton County,2021-01-27,293,4674,5.1
13297,Walton County,2021-01-28,490,5164,5.6
13297,Walton County,2021-01-29,296,5460,6
13297,Walton County,2021-01-30,71,5531,6
13297,Walton County,2021-01-31,12,5543,6.1
13297,Walton County,2021-02-01,92,5635,6.2
13297,Walton County,2021-02-02,108,5743,6.3
13297,Walton County,2021-02-03,229,5972,6.5
13297,Walton County,2021-02-04,262,6234,6.8
13297,Walton County,2021-02-05,126,6360,7
13297,Walton County,2021-02-06,69,6429,7
13297,Walton County,2021-02-07,25,6454,7.1
13297,Walton County,2021-02-08,111,6565,7.2
13297,Walton County,2021-02-09,63,6628,7.2
13297,Walton County,2021-02-10,202,6830,7.5
13297,Walton County,2021-02-11,224,7054,7.7
13297,Walton County,2021-02-12,90,7144,7.8
13297,Walton County,2021-02-13,64,7208,7.9
13297,Walton County,2021-02-14,15,7223,7.9
13297,Walton County,2021-02-15,138,7361,8
13297,Walton County,2021-02-16,93,7454,8.2
13297,Walton County,2021-02-17,207,7661,8.4
13297,Walton County,2021-02-18,177,7838,8.6
13297,Walton County,2021-02-19,75,7913,8.7
13297,Walton County,2021-02-20,38,7951,8.7
13297,Walton County,2021-02-21,13,7964,8.7
13297,Walton County,2021-02-22,111,8075,8.8
13297,Walton County,2021-02-23,100,8175,8.9
13297,Walton County,2021-02-24,220,8395,9.2
13297,Walton County,2021-02-25,228,8623,9.4
13297,Walton County,2021-02-26,145,8768,9.6
13297,Walton County,2021-02-27,66,8834,9.7
13297,Walton County,2021-02-28,43,8877,9.7
13297,Walton County,2021-03-01,197,9074,9.9
13297,Walton County,2021-03-02,225,9299,10.2
13297,Walton County,2021-03-03,253,9552,10.4
13297,Walton County,2021-03-04,255,9807,10.7
13297,Walton County,2021-03-05,172,9979,10.9
13297,Walton County,2021-03-06,83,10062,11
13297,Walton County,2021-03-07,60,10122,11.1
13297,Walton County,2021-03-08,310,10432,11.4
13297,Walton County,2021-03-09,432,10864,11.9
13297,Walton County,2021-03-10,433,11297,12.4
13297,Walton County,2021-03-11,388,11685,12.8
13297,Walton County,2021-03-12,419,12104,13.2
13297,Walton County,2021-03-13,225,12329,13.5
13297,Walton County,2021-03-14,92,12421,13.6
13297,Walton County,2021-03-15,485,12906,14.1
13297,Walton County,2021-03-16,495,13401,14.7
13297,Walton County,2021-03-17,481,13882,15.2
13297,Walton County,2021-03-18,380,14262,15.6
13297,Walton County,2021-03-19,454,14716,16.1
13297,Walton County,2021-03-20,223,14939,16.3
13297,Walton County,2021-03-21,91,15030,16.4
13297,Walton County,2021-03-22,425,15455,16.9
13297,Walton County,2021-03-23,426,15881,17.4
13297,Walton County,2021-03-24,716,16597,18.2
13297,Walton County,2021-03-25,640,17237,18.9
13297,Walton County,2021-03-26,522,17759,19.4
13297,Walton County,2021-03-27,158,17917,19.6
13297,Walton County,2021-03-28,99,18016,19.7
13297,Walton County,2021-03-29,355,18371,20.1
13297,Walton County,2021-03-30,486,18857,20.6
13297,Walton County,2021-03-31,641,19498,21.3
13297,Walton County,2021-04-01,581,20079,22
13297,Walton County,2021-04-02,342,20421,22.3
13297,Walton County,2021-04-03,155,20576,22.5
13297,Walton County,2021-04-04,85,20661,22.6
13297,Walton County,2021-04-05,316,20977,22.9
13297,Walton County,2021-04-06,418,21395,23.4
13297,Walton County,2021-04-07,479,21874,23.9
13297,Walton County,2021-04-08,519,22393,24.5
13297,Walton County,2021-04-09,394,22787,24.9
13297,Walton County,2021-04-10,218,23005,25.2
13297,Walton County,2021-04-11,105,23110,25.3
13297,Walton County,2021-04-12,244,23354,25.5
13297,Walton County,2021-04-13,265,23619,25.8
13297,Walton County,2021-04-14,355,23974,26.2
13297,Walton County,2021-04-15,286,24260,26.5
13297,Walton County,2021-04-16,211,24471,26.8
13297,Walton County,2021-04-17,92,24563,26.9
13297,Walton County,2021-04-18,53,24616,26.9
13297,Walton County,2021-04-19,153,24769,27.1
13297,Walton County,2021-04-20,197,24966,27.3
13297,Walton County,2021-04-21,215,25181,27.5
13297,Walton County,2021-04-22,219,25400,27.8
13297,Walton County,2021-04-23,196,25596,28
13297,Walton County,2021-04-24,94,25690,28.1
13297,Walton County,2021-04-25,30,25720,28.1
13297,Walton County,2021-04-26,196,25916,28.3
13297,Walton County,2021-04-27,135,26051,28.5
13297,Walton County,2021-04-28,286,26337,28.8
13297,Walton County,2021-04-29,215,26552,29
13297,Walton County,2021-04-30,232,26784,29.3
13297,Walton County,2021-05-01,124,26908,29.4
13297,Walton County,2021-05-02,48,26956,29.5
13297,Walton County,2021-05-03,129,27085,29.6
13297,Walton County,2021-05-04,158,27243,29.8
13297,Walton County,2021-05-05,177,27420,30
13297,Walton County,2021-05-06,183,27603,30.2
13297,Walton County,2021-05-07,138,27741,30.3
13297,Walton County,2021-05-08,84,27825,30.4
13297,Walton County,2021-05-09,34,27859,30.5
13297,Walton County,2021-05-10,74,27933,30.5
13297,Walton County,2021-05-11,131,28064,30.7
13297,Walton County,2021-05-12,115,28179,30.8
13297,Walton County,2021-05-13,164,28343,31
13297,Walton County,2021-05-14,225,28568,31.2
13297,Walton County,2021-05-15,111,28679,31.4
13297,Walton County,2021-05-16,63,28742,31.4
13297,Walton County,2021-05-17,180,28922,31.6
13297,Walton County,2021-05-18,177,29099,31.8
13297,Walton County,2021-05-19,168,29267,32
13297,Walton County,2021-05-20,117,29384,32.1
13297,Walton County,2021-05-21,127,29511,32.3
13297,Walton County,2021-05-22,77,29588,32.4
13297,Walton County,2021-05-23,60,29648,32.4
13297,Walton County,2021-05-24,102,29750,32.5
13297,Walton County,2021-05-25,140,29890,32.7
13297,Walton County,2021-05-26,127,30017,32.8
13297,Walton County,2021-05-27,87,30104,32.9
13297,Walton County,2021-05-28,118,30222,33.1
13297,Walton County,2021-05-29,56,30278,33.1
13297,Walton County,2021-05-30,34,30312,33.1
13297,Walton County,2021-05-31,11,30323,33.2
13297,Walton County,2021-06-01,64,30387,33.2
13297,Walton County,2021-06-02,94,30481,33.3
13297,Walton County,2021-06-03,73,30554,33.4
13297,Walton County,2021-06-04,102,30656,33.5
13297,Walton County,2021-06-05,55,30711,33.6
13297,Walton County,2021-06-06,34,30745,33.6
13297,Walton County,2021-06-07,70,30815,33.7
13297,Walton County,2021-06-08,74,30889,33.8
13297,Walton County,2021-06-09,70,30959,33.9
13297,Walton County,2021-06-10,73,31032,33.9
13297,Walton County,2021-06-11,76,31108,34
13297,Walton County,2021-06-12,50,31158,34.1
13297,Walton County,2021-06-13,21,31179,34.1
13297,Walton County,2021-06-14,62,31241,34.2
13297,Walton County,2021-06-15,68,31309,34.2
13297,Walton County,2021-06-16,47,31356,34.3
13297,Walton County,2021-06-17,56,31412,34.4
13297,Walton County,2021-06-18,61,31473,34.4
13297,Walton County,2021-06-19,33,31506,34.5
13297,Walton County,2021-06-20,25,31531,34.5
13297,Walton County,2021-06-21,59,31590,34.5
13297,Walton County,2021-06-22,58,31648,34.6
13297,Walton County,2021-06-23,63,31711,34.7
13297,Walton County,2021-06-24,53,31764,34.7
13297,Walton County,2021-06-25,67,31831,34.8
13297,Walton County,2021-06-26,44,31875,34.9
13297,Walton County,2021-06-27,22,31897,34.9
13297,Walton County,2021-06-28,50,31947,34.9
13297,Walton County,2021-06-29,47,31994,35
13297,Walton County,2021-06-30,56,32050,35
13297,Walton County,2021-07-01,56,32106,35.1
13297,Walton County,2021-07-02,48,32154,35.2
13297,Walton County,2021-07-03,28,32182,35.2
13297,Walton County,2021-07-04,3,32185,35.2
13297,Walton County,2021-07-05,28,32213,35.2
13297,Walton County,2021-07-06,45,32258,35.3
13297,Walton County,2021-07-07,38,32296,35.3
13297,Walton County,2021-07-08,51,32347,35.4
13297,Walton County,2021-07-09,73,32420,35.5
13297,Walton County,2021-07-10,45,32465,35.5
13297,Walton County,2021-07-11,23,32488,35.5
13297,Walton County,2021-07-12,61,32549,35.6
13297,Walton County,2021-07-13,46,32595,35.6
13297,Walton County,2021-07-14,48,32643,35.7
13297,Walton County,2021-07-15,55,32698,35.8
13297,Walton County,2021-07-16,55,32753,35.8
13297,Walton County,2021-07-17,48,32801,35.9
13297,Walton County,2021-07-18,36,32837,35.9
13297,Walton County,2021-07-19,80,32917,36
13297,Walton County,2021-07-20,92,33009,36.1
13297,Walton County,2021-07-21,83,33092,36.2
13297,Walton County,2021-07-22,80,33172,36.3
13297,Walton County,2021-07-23,112,33284,36.4
13297,Walton County,2021-07-24,73,33357,36.5
13297,Walton County,2021-07-25,65,33422,36.5
13297,Walton County,2021-07-26,121,33543,36.7
13297,Walton County,2021-07-27,106,33649,36.8
13297,Walton County,2021-07-28,132,33781,36.9
13297,Walton County,2021-07-29,103,33884,37.1
13297,Walton County,2021-07-30,148,34032,37.2
13297,Walton County,2021-07-31,96,34128,37.3
13297,Walton County,2021-08-01,67,34195,37.4
13297,Walton County,2021-08-02,138,34333,37.5
13297,Walton County,2021-08-03,115,34448,37.7
13297,Walton County,2021-08-04,121,34569,37.8
13297,Walton County,2021-08-05,107,34676,37.9
13297,Walton County,2021-08-06,172,34848,38.1
13297,Walton County,2021-08-07,101,34949,38.2
13297,Walton County,2021-08-08,63,35012,38.3
13297,Walton County,2021-08-09,132,35144,38.4
13297,Walton County,2021-08-10,172,35316,38.6
13297,Walton County,2021-08-11,130,35446,38.8
13297,Walton County,2021-08-12,165,35611,38.9
13297,Walton County,2021-08-13,205,35816,39.2
13297,Walton County,2021-08-14,96,35912,39.3
13297,Walton County,2021-08-15,55,35967,39.3
13297,Walton County,2021-08-16,116,36083,39.5
13297,Walton County,2021-08-17,164,36247,39.6
13297,Walton County,2021-08-18,138,36385,39.8
13297,Walton County,2021-08-19,151,36536,40
13297,Walton County,2021-08-20,159,36695,40.1
13297,Walton County,2021-08-21,105,36800,40.2
13297,Walton County,2021-08-22,74,36874,40.3
13297,Walton County,2021-08-23,133,37007,40.5
13297,Walton County,2021-08-24,152,37159,40.6
13297,Walton County,2021-08-25,135,37294,40.8
13297,Walton County,2021-08-26,167,37461,41
13297,Walton County,2021-08-27,164,37625,41.1
13297,Walton County,2021-08-28,97,37722,41.3
13297,Walton County,2021-08-29,61,37783,41.3
13297,Walton County,2021-08-30,117,37900,41.4
13297,Walton County,2021-08-31,134,38034,41.6
13297,Walton County,2021-09-01,147,38181,41.8
13297,Walton County,2021-09-02,160,38341,41.9
13297,Walton County,2021-09-03,160,38501,42.1
13297,Walton County,2021-09-04,94,38595,42.2
13297,Walton County,2021-09-05,48,38643,42.3
13297,Walton County,2021-09-06,32,38675,42.3
13297,Walton County,2021-09-07,127,38802,42.4
13297,Walton County,2021-09-08,117,38919,42.6
13297,Walton County,2021-09-09,124,39043,42.7
13297,Walton County,2021-09-10,165,39208,42.9
13297,Walton County,2021-09-11,74,39282,43
13297,Walton County,2021-09-12,56,39338,43
13297,Walton County,2021-09-13,98,39436,43.1
13297,Walton County,2021-09-14,85,39521,43.2
13297,Walton County,2021-09-15,98,39619,43.3
13297,Walton County,2021-09-16,85,39704,43.4
13297,Walton County,2021-09-17,85,39789,43.5
13297,Walton County,2021-09-18,52,39841,43.6
13297,Walton County,2021-09-19,30,39871,43.6
13297,Walton County,2021-09-20,71,39942,43.7
13297,Walton County,2021-09-21,69,40011,43.8
13297,Walton County,2021-09-22,89,40100,43.9
13297,Walton County,2021-09-23,63,40163,43.9
13297,Walton County,2021-09-24,51,40214,44
13297,Walton County,2021-09-25,42,40256,44
13297,Walton County,2021-09-26,21,40277,44
13297,Walton County,2021-09-27,48,40325,44.1
13297,Walton County,2021-09-28,52,40377,44.2
13297,Walton County,2021-09-29,35,40412,44.2
13297,Walton County,2021-09-30,29,40441,44.2
13297,Walton County,2021-10-01,52,40493,44.3
13297,Walton County,2021-10-02,25,40518,44.3
13297,Walton County,2021-10-03,16,40534,44.3
13297,Walton County,2021-10-04,29,40563,44.4
13297,Walton County,2021-10-05,39,40602,44.4
13297,Walton County,2021-10-06,31,40633,44.4
13297,Walton County,2021-10-07,9,40642,44.4
13299,Ware County,2020-12-15,2,2,0
13299,Ware County,2020-12-16,1,3,0
13299,Ware County,2020-12-18,5,8,0
13299,Ware County,2020-12-19,2,10,0
13299,Ware County,2020-12-20,1,11,0
13299,Ware County,2020-12-21,3,14,0
13299,Ware County,2020-12-22,6,20,0.1
13299,Ware County,2020-12-23,28,48,0.1
13299,Ware County,2020-12-24,14,62,0.2
13299,Ware County,2020-12-26,1,63,0.2
13299,Ware County,2020-12-28,36,99,0.3
13299,Ware County,2020-12-29,57,156,0.4
13299,Ware County,2020-12-30,79,235,0.7
13299,Ware County,2020-12-31,35,270,0.8
13299,Ware County,2021-01-03,4,274,0.8
13299,Ware County,2021-01-04,21,295,0.8
13299,Ware County,2021-01-05,35,330,0.9
13299,Ware County,2021-01-06,55,385,1.1
13299,Ware County,2021-01-07,43,428,1.2
13299,Ware County,2021-01-08,77,505,1.4
13299,Ware County,2021-01-09,3,508,1.4
13299,Ware County,2021-01-10,5,513,1.4
13299,Ware County,2021-01-11,172,685,1.9
13299,Ware County,2021-01-12,71,756,2.1
13299,Ware County,2021-01-13,156,912,2.6
13299,Ware County,2021-01-14,22,934,2.6
13299,Ware County,2021-01-15,158,1092,3.1
13299,Ware County,2021-01-16,148,1240,3.5
13299,Ware County,2021-01-17,7,1247,3.5
13299,Ware County,2021-01-18,167,1414,4
13299,Ware County,2021-01-19,36,1450,4.1
13299,Ware County,2021-01-20,72,1522,4.3
13299,Ware County,2021-01-21,79,1601,4.5
13299,Ware County,2021-01-22,142,1743,4.9
13299,Ware County,2021-01-23,19,1762,5
13299,Ware County,2021-01-24,4,1766,5
13299,Ware County,2021-01-25,145,1911,5.4
13299,Ware County,2021-01-26,19,1930,5.4
13299,Ware County,2021-01-27,100,2030,5.7
13299,Ware County,2021-01-28,25,2055,5.8
13299,Ware County,2021-01-29,151,2206,6.2
13299,Ware County,2021-01-30,103,2309,6.5
13299,Ware County,2021-01-31,1,2310,6.5
13299,Ware County,2021-02-01,179,2489,7
13299,Ware County,2021-02-02,18,2507,7
13299,Ware County,2021-02-03,161,2668,7.5
13299,Ware County,2021-02-04,14,2682,7.5
13299,Ware County,2021-02-05,115,2797,7.9
13299,Ware County,2021-02-06,6,2803,7.9
13299,Ware County,2021-02-07,4,2807,7.9
13299,Ware County,2021-02-08,211,3018,8.5
13299,Ware County,2021-02-09,24,3042,8.5
13299,Ware County,2021-02-10,132,3174,8.9
13299,Ware County,2021-02-11,12,3186,9
13299,Ware County,2021-02-12,134,3320,9.3
13299,Ware County,2021-02-13,107,3427,9.6
13299,Ware County,2021-02-14,2,3429,9.6
13299,Ware County,2021-02-15,152,3581,10.1
13299,Ware County,2021-02-16,22,3603,10.1
13299,Ware County,2021-02-17,180,3783,10.6
13299,Ware County,2021-02-18,12,3795,10.7
13299,Ware County,2021-02-19,158,3953,11.1
13299,Ware County,2021-02-20,24,3977,11.2
13299,Ware County,2021-02-22,144,4121,11.6
13299,Ware County,2021-02-23,17,4138,11.6
13299,Ware County,2021-02-24,110,4248,11.9
13299,Ware County,2021-02-25,20,4268,12
13299,Ware County,2021-02-26,59,4327,12.2
13299,Ware County,2021-02-27,11,4338,12.2
13299,Ware County,2021-02-28,6,4344,12.2
13299,Ware County,2021-03-01,38,4382,12.3
13299,Ware County,2021-03-02,26,4408,12.4
13299,Ware County,2021-03-03,101,4509,12.7
13299,Ware County,2021-03-04,17,4526,12.7
13299,Ware County,2021-03-05,81,4607,12.9
13299,Ware County,2021-03-06,3,4610,13
13299,Ware County,2021-03-07,12,4622,13
13299,Ware County,2021-03-08,140,4762,13.4
13299,Ware County,2021-03-09,35,4797,13.5
13299,Ware County,2021-03-10,258,5055,14.2
13299,Ware County,2021-03-11,77,5132,14.4
13299,Ware County,2021-03-12,130,5262,14.8
13299,Ware County,2021-03-13,13,5275,14.8
13299,Ware County,2021-03-14,13,5288,14.9
13299,Ware County,2021-03-15,68,5356,15
13299,Ware County,2021-03-16,78,5434,15.3
13299,Ware County,2021-03-17,229,5663,15.9
13299,Ware County,2021-03-18,72,5735,16.1
13299,Ware County,2021-03-19,233,5968,16.8
13299,Ware County,2021-03-20,52,6020,16.9
13299,Ware County,2021-03-21,14,6034,17
13299,Ware County,2021-03-22,169,6203,17.4
13299,Ware County,2021-03-23,76,6279,17.6
13299,Ware County,2021-03-24,235,6514,18.3
13299,Ware County,2021-03-25,178,6692,18.8
13299,Ware County,2021-03-26,267,6959,19.6
13299,Ware County,2021-03-27,107,7066,19.9
13299,Ware County,2021-03-28,11,7077,19.9
13299,Ware County,2021-03-29,140,7217,20.3
13299,Ware County,2021-03-30,158,7375,20.7
13299,Ware County,2021-03-31,194,7569,21.3
13299,Ware County,2021-04-01,124,7693,21.6
13299,Ware County,2021-04-02,120,7813,22
13299,Ware County,2021-04-03,50,7863,22.1
13299,Ware County,2021-04-04,4,7867,22.1
13299,Ware County,2021-04-05,39,7906,22.2
13299,Ware County,2021-04-06,121,8027,22.6
13299,Ware County,2021-04-07,125,8152,22.9
13299,Ware County,2021-04-08,99,8251,23.2
13299,Ware County,2021-04-09,106,8357,23.5
13299,Ware County,2021-04-10,61,8418,23.7
13299,Ware County,2021-04-11,4,8422,23.7
13299,Ware County,2021-04-12,33,8455,23.8
13299,Ware County,2021-04-13,88,8543,24
13299,Ware County,2021-04-14,89,8632,24.3
13299,Ware County,2021-04-15,61,8693,24.4
13299,Ware County,2021-04-16,42,8735,24.5
13299,Ware County,2021-04-17,72,8807,24.7
13299,Ware County,2021-04-18,1,8808,24.7
13299,Ware County,2021-04-19,19,8827,24.8
13299,Ware County,2021-04-20,46,8873,24.9
13299,Ware County,2021-04-21,164,9037,25.4
13299,Ware County,2021-04-22,56,9093,25.5
13299,Ware County,2021-04-23,92,9185,25.8
13299,Ware County,2021-04-24,17,9202,25.9
13299,Ware County,2021-04-25,2,9204,25.9
13299,Ware County,2021-04-26,12,9216,25.9
13299,Ware County,2021-04-27,32,9248,26
13299,Ware County,2021-04-28,85,9333,26.2
13299,Ware County,2021-04-29,34,9367,26.3
13299,Ware County,2021-04-30,70,9437,26.5
13299,Ware County,2021-05-01,15,9452,26.6
13299,Ware County,2021-05-02,1,9453,26.6
13299,Ware County,2021-05-03,21,9474,26.6
13299,Ware County,2021-05-04,37,9511,26.7
13299,Ware County,2021-05-05,57,9568,26.9
13299,Ware County,2021-05-06,40,9608,27
13299,Ware County,2021-05-07,48,9656,27.1
13299,Ware County,2021-05-08,25,9681,27.2
13299,Ware County,2021-05-09,2,9683,27.2
13299,Ware County,2021-05-10,11,9694,27.2
13299,Ware County,2021-05-11,16,9710,27.3
13299,Ware County,2021-05-12,53,9763,27.4
13299,Ware County,2021-05-13,36,9799,27.5
13299,Ware County,2021-05-14,24,9823,27.6
13299,Ware County,2021-05-15,20,9843,27.7
13299,Ware County,2021-05-16,4,9847,27.7
13299,Ware County,2021-05-17,25,9872,27.7
13299,Ware County,2021-05-18,43,9915,27.9
13299,Ware County,2021-05-19,71,9986,28.1
13299,Ware County,2021-05-20,136,10122,28.4
13299,Ware County,2021-05-21,30,10152,28.5
13299,Ware County,2021-05-22,16,10168,28.6
13299,Ware County,2021-05-23,14,10182,28.6
13299,Ware County,2021-05-24,20,10202,28.7
13299,Ware County,2021-05-25,34,10236,28.8
13299,Ware County,2021-05-26,46,10282,28.9
13299,Ware County,2021-05-27,16,10298,28.9
13299,Ware County,2021-05-28,19,10317,29
13299,Ware County,2021-05-29,6,10323,29
13299,Ware County,2021-05-30,4,10327,29
13299,Ware County,2021-06-01,28,10355,29.1
13299,Ware County,2021-06-02,41,10396,29.2
13299,Ware County,2021-06-03,19,10415,29.3
13299,Ware County,2021-06-04,11,10426,29.3
13299,Ware County,2021-06-05,7,10433,29.3
13299,Ware County,2021-06-06,1,10434,29.3
13299,Ware County,2021-06-07,14,10448,29.4
13299,Ware County,2021-06-08,15,10463,29.4
13299,Ware County,2021-06-09,43,10506,29.5
13299,Ware County,2021-06-10,18,10524,29.6
13299,Ware County,2021-06-11,21,10545,29.6
13299,Ware County,2021-06-12,11,10556,29.7
13299,Ware County,2021-06-14,12,10568,29.7
13299,Ware County,2021-06-15,14,10582,29.7
13299,Ware County,2021-06-16,31,10613,29.8
13299,Ware County,2021-06-17,12,10625,29.9
13299,Ware County,2021-06-18,29,10654,29.9
13299,Ware County,2021-06-19,4,10658,29.9
13299,Ware County,2021-06-20,8,10666,30
13299,Ware County,2021-06-21,12,10678,30
13299,Ware County,2021-06-22,10,10688,30
13299,Ware County,2021-06-23,24,10712,30.1
13299,Ware County,2021-06-24,9,10721,30.1
13299,Ware County,2021-06-25,12,10733,30.2
13299,Ware County,2021-06-26,8,10741,30.2
13299,Ware County,2021-06-27,2,10743,30.2
13299,Ware County,2021-06-28,8,10751,30.2
13299,Ware County,2021-06-29,4,10755,30.2
13299,Ware County,2021-06-30,30,10785,30.3
13299,Ware County,2021-07-01,12,10797,30.3
13299,Ware County,2021-07-02,16,10813,30.4
13299,Ware County,2021-07-03,1,10814,30.4
13299,Ware County,2021-07-04,1,10815,30.4
13299,Ware County,2021-07-05,6,10821,30.4
13299,Ware County,2021-07-06,6,10827,30.4
13299,Ware County,2021-07-07,15,10842,30.5
13299,Ware County,2021-07-08,14,10856,30.5
13299,Ware County,2021-07-09,12,10868,30.5
13299,Ware County,2021-07-10,4,10872,30.5
13299,Ware County,2021-07-11,1,10873,30.5
13299,Ware County,2021-07-12,13,10886,30.6
13299,Ware County,2021-07-13,21,10907,30.6
13299,Ware County,2021-07-14,31,10938,30.7
13299,Ware County,2021-07-15,14,10952,30.8
13299,Ware County,2021-07-16,23,10975,30.8
13299,Ware County,2021-07-17,11,10986,30.9
13299,Ware County,2021-07-18,3,10989,30.9
13299,Ware County,2021-07-19,20,11009,30.9
13299,Ware County,2021-07-20,24,11033,31
13299,Ware County,2021-07-21,66,11099,31.2
13299,Ware County,2021-07-22,38,11137,31.3
13299,Ware County,2021-07-23,66,11203,31.5
13299,Ware County,2021-07-24,33,11236,31.6
13299,Ware County,2021-07-25,20,11256,31.6
13299,Ware County,2021-07-26,56,11312,31.8
13299,Ware County,2021-07-27,78,11390,32
13299,Ware County,2021-07-28,132,11522,32.4
13299,Ware County,2021-07-29,61,11583,32.5
13299,Ware County,2021-07-30,75,11658,32.8
13299,Ware County,2021-07-31,40,11698,32.9
13299,Ware County,2021-08-01,30,11728,33
13299,Ware County,2021-08-02,52,11780,33.1
13299,Ware County,2021-08-03,81,11861,33.3
13299,Ware County,2021-08-04,87,11948,33.6
13299,Ware County,2021-08-05,95,12043,33.8
13299,Ware County,2021-08-06,91,12134,34.1
13299,Ware County,2021-08-07,38,12172,34.2
13299,Ware County,2021-08-08,22,12194,34.3
13299,Ware County,2021-08-09,83,12277,34.5
13299,Ware County,2021-08-10,113,12390,34.8
13299,Ware County,2021-08-11,120,12510,35.1
13299,Ware County,2021-08-12,111,12621,35.5
13299,Ware County,2021-08-13,103,12724,35.7
13299,Ware County,2021-08-14,39,12763,35.9
13299,Ware County,2021-08-15,42,12805,36
13299,Ware County,2021-08-16,67,12872,36.2
13299,Ware County,2021-08-17,83,12955,36.4
13299,Ware County,2021-08-18,97,13052,36.7
13299,Ware County,2021-08-19,86,13138,36.9
13299,Ware County,2021-08-20,85,13223,37.2
13299,Ware County,2021-08-21,30,13253,37.2
13299,Ware County,2021-08-22,18,13271,37.3
13299,Ware County,2021-08-23,81,13352,37.5
13299,Ware County,2021-08-24,49,13401,37.7
13299,Ware County,2021-08-25,87,13488,37.9
13299,Ware County,2021-08-26,94,13582,38.2
13299,Ware County,2021-08-27,68,13650,38.4
13299,Ware County,2021-08-28,22,13672,38.4
13299,Ware County,2021-08-29,17,13689,38.5
13299,Ware County,2021-08-30,47,13736,38.6
13299,Ware County,2021-08-31,72,13808,38.8
13299,Ware County,2021-09-01,47,13855,38.9
13299,Ware County,2021-09-02,62,13917,39.1
13299,Ware County,2021-09-03,77,13994,39.3
13299,Ware County,2021-09-04,30,14024,39.4
13299,Ware County,2021-09-05,11,14035,39.4
13299,Ware County,2021-09-06,17,14052,39.5
13299,Ware County,2021-09-07,38,14090,39.6
13299,Ware County,2021-09-08,51,14141,39.7
13299,Ware County,2021-09-09,29,14170,39.8
13299,Ware County,2021-09-10,56,14226,40
13299,Ware County,2021-09-11,26,14252,40
13299,Ware County,2021-09-12,18,14270,40.1
13299,Ware County,2021-09-13,37,14307,40.2
13299,Ware County,2021-09-14,32,14339,40.3
13299,Ware County,2021-09-15,29,14368,40.4
13299,Ware County,2021-09-16,22,14390,40.4
13299,Ware County,2021-09-17,32,14422,40.5
13299,Ware County,2021-09-18,18,14440,40.6
13299,Ware County,2021-09-19,6,14446,40.6
13299,Ware County,2021-09-20,14,14460,40.6
13299,Ware County,2021-09-21,21,14481,40.7
13299,Ware County,2021-09-22,22,14503,40.7
13299,Ware County,2021-09-23,13,14516,40.8
13299,Ware County,2021-09-24,21,14537,40.8
13299,Ware County,2021-09-25,8,14545,40.9
13299,Ware County,2021-09-26,4,14549,40.9
13299,Ware County,2021-09-27,10,14559,40.9
13299,Ware County,2021-09-28,10,14569,40.9
13299,Ware County,2021-09-29,12,14581,41
13299,Ware County,2021-09-30,10,14591,41
13299,Ware County,2021-10-01,12,14603,41
13299,Ware County,2021-10-02,5,14608,41
13299,Ware County,2021-10-03,5,14613,41.1
13299,Ware County,2021-10-04,19,14632,41.1
13299,Ware County,2021-10-05,9,14641,41.1
13299,Ware County,2021-10-06,12,14653,41.2
13299,Ware County,2021-10-07,6,14659,41.2
13301,Warren County,2020-12-18,1,1,0
13301,Warren County,2020-12-21,1,2,0
13301,Warren County,2020-12-22,1,3,0.1
13301,Warren County,2020-12-23,4,7,0.1
13301,Warren County,2020-12-24,1,8,0.2
13301,Warren County,2020-12-27,1,9,0.2
13301,Warren County,2020-12-28,1,10,0.2
13301,Warren County,2020-12-29,6,16,0.3
13301,Warren County,2020-12-30,3,19,0.4
13301,Warren County,2021-01-02,3,22,0.4
13301,Warren County,2021-01-04,7,29,0.5
13301,Warren County,2021-01-05,7,36,0.7
13301,Warren County,2021-01-06,19,55,1
13301,Warren County,2021-01-07,8,63,1.2
13301,Warren County,2021-01-08,10,73,1.4
13301,Warren County,2021-01-09,4,77,1.5
13301,Warren County,2021-01-10,29,106,2
13301,Warren County,2021-01-11,57,163,3.1
13301,Warren County,2021-01-12,1,164,3.1
13301,Warren County,2021-01-13,11,175,3.3
13301,Warren County,2021-01-14,55,230,4.3
13301,Warren County,2021-01-15,1,231,4.4
13301,Warren County,2021-01-16,9,240,4.5
13301,Warren County,2021-01-18,85,325,6.1
13301,Warren County,2021-01-19,14,339,6.4
13301,Warren County,2021-01-20,16,355,6.7
13301,Warren County,2021-01-21,7,362,6.8
13301,Warren County,2021-01-22,1,363,6.9
13301,Warren County,2021-01-23,3,366,6.9
13301,Warren County,2021-01-25,68,434,8.2
13301,Warren County,2021-01-26,9,443,8.4
13301,Warren County,2021-01-27,8,451,8.5
13301,Warren County,2021-01-28,31,482,9.1
13301,Warren County,2021-01-29,1,483,9.1
13301,Warren County,2021-01-30,1,484,9.1
13301,Warren County,2021-01-31,9,493,9.3
13301,Warren County,2021-02-01,51,544,10.3
13301,Warren County,2021-02-02,5,549,10.4
13301,Warren County,2021-02-03,6,555,10.5
13301,Warren County,2021-02-04,4,559,10.6
13301,Warren County,2021-02-05,3,562,10.6
13301,Warren County,2021-02-08,20,582,11
13301,Warren County,2021-02-09,20,602,11.4
13301,Warren County,2021-02-10,5,607,11.5
13301,Warren County,2021-02-11,15,622,11.7
13301,Warren County,2021-02-12,6,628,11.9
13301,Warren County,2021-02-13,4,632,11.9
13301,Warren County,2021-02-14,1,633,12
13301,Warren County,2021-02-15,20,653,12.3
13301,Warren County,2021-02-16,6,659,12.4
13301,Warren County,2021-02-17,9,668,12.6
13301,Warren County,2021-02-18,6,674,12.7
13301,Warren County,2021-02-19,2,676,12.8
13301,Warren County,2021-02-21,1,677,12.8
13301,Warren County,2021-02-22,12,689,13
13301,Warren County,2021-02-23,1,690,13
13301,Warren County,2021-02-24,7,697,13.2
13301,Warren County,2021-02-25,11,708,13.4
13301,Warren County,2021-02-26,5,713,13.5
13301,Warren County,2021-02-27,3,716,13.5
13301,Warren County,2021-03-01,12,728,13.7
13301,Warren County,2021-03-02,13,741,14
13301,Warren County,2021-03-03,9,750,14.2
13301,Warren County,2021-03-04,4,754,14.2
13301,Warren County,2021-03-05,2,756,14.3
13301,Warren County,2021-03-06,1,757,14.3
13301,Warren County,2021-03-08,24,781,14.7
13301,Warren County,2021-03-09,5,786,14.8
13301,Warren County,2021-03-10,14,800,15.1
13301,Warren County,2021-03-11,36,836,15.8
13301,Warren County,2021-03-12,36,872,16.5
13301,Warren County,2021-03-13,7,879,16.6
13301,Warren County,2021-03-15,70,949,17.9
13301,Warren County,2021-03-16,13,962,18.2
13301,Warren County,2021-03-17,16,978,18.5
13301,Warren County,2021-03-18,14,992,18.7
13301,Warren County,2021-03-19,8,1000,18.9
13301,Warren County,2021-03-20,4,1004,19
13301,Warren County,2021-03-21,2,1006,19
13301,Warren County,2021-03-22,77,1083,20.4
13301,Warren County,2021-03-23,19,1102,20.8
13301,Warren County,2021-03-24,17,1119,21.1
13301,Warren County,2021-03-25,61,1180,22.3
13301,Warren County,2021-03-26,10,1190,22.5
13301,Warren County,2021-03-27,3,1193,22.5
13301,Warren County,2021-03-28,2,1195,22.6
13301,Warren County,2021-03-29,35,1230,23.2
13301,Warren County,2021-03-30,16,1246,23.5
13301,Warren County,2021-03-31,29,1275,24.1
13301,Warren County,2021-04-01,31,1306,24.7
13301,Warren County,2021-04-02,10,1316,24.8
13301,Warren County,2021-04-03,3,1319,24.9
13301,Warren County,2021-04-04,8,1327,25.1
13301,Warren County,2021-04-05,51,1378,26
13301,Warren County,2021-04-06,19,1397,26.4
13301,Warren County,2021-04-07,18,1415,26.7
13301,Warren County,2021-04-08,29,1444,27.3
13301,Warren County,2021-04-09,11,1455,27.5
13301,Warren County,2021-04-10,2,1457,27.5
13301,Warren County,2021-04-12,33,1490,28.1
13301,Warren County,2021-04-13,16,1506,28.4
13301,Warren County,2021-04-14,12,1518,28.7
13301,Warren County,2021-04-15,7,1525,28.8
13301,Warren County,2021-04-16,10,1535,29
13301,Warren County,2021-04-17,2,1537,29
13301,Warren County,2021-04-18,4,1541,29.1
13301,Warren County,2021-04-19,26,1567,29.6
13301,Warren County,2021-04-20,13,1580,29.8
13301,Warren County,2021-04-21,15,1595,30.1
13301,Warren County,2021-04-22,21,1616,30.5
13301,Warren County,2021-04-23,8,1624,30.7
13301,Warren County,2021-04-24,1,1625,30.7
13301,Warren County,2021-04-26,10,1635,30.9
13301,Warren County,2021-04-27,10,1645,31.1
13301,Warren County,2021-04-28,11,1656,31.3
13301,Warren County,2021-04-29,9,1665,31.4
13301,Warren County,2021-04-30,8,1673,31.6
13301,Warren County,2021-05-01,3,1676,31.6
13301,Warren County,2021-05-02,1,1677,31.7
13301,Warren County,2021-05-03,17,1694,32
13301,Warren County,2021-05-04,7,1701,32.1
13301,Warren County,2021-05-05,12,1713,32.3
13301,Warren County,2021-05-06,11,1724,32.5
13301,Warren County,2021-05-07,4,1728,32.6
13301,Warren County,2021-05-08,6,1734,32.7
13301,Warren County,2021-05-09,2,1736,32.8
13301,Warren County,2021-05-10,6,1742,32.9
13301,Warren County,2021-05-11,11,1753,33.1
13301,Warren County,2021-05-12,9,1762,33.3
13301,Warren County,2021-05-13,5,1767,33.4
13301,Warren County,2021-05-14,9,1776,33.5
13301,Warren County,2021-05-15,3,1779,33.6
13301,Warren County,2021-05-16,3,1782,33.6
13301,Warren County,2021-05-17,14,1796,33.9
13301,Warren County,2021-05-18,11,1807,34.1
13301,Warren County,2021-05-19,12,1819,34.3
13301,Warren County,2021-05-20,4,1823,34.4
13301,Warren County,2021-05-21,4,1827,34.5
13301,Warren County,2021-05-22,8,1835,34.6
13301,Warren County,2021-05-23,1,1836,34.7
13301,Warren County,2021-05-24,14,1850,34.9
13301,Warren County,2021-05-25,7,1857,35.1
13301,Warren County,2021-05-26,5,1862,35.2
13301,Warren County,2021-05-27,6,1868,35.3
13301,Warren County,2021-05-28,2,1870,35.3
13301,Warren County,2021-05-29,4,1874,35.4
13301,Warren County,2021-05-31,1,1875,35.4
13301,Warren County,2021-06-01,6,1881,35.5
13301,Warren County,2021-06-02,7,1888,35.6
13301,Warren County,2021-06-03,8,1896,35.8
13301,Warren County,2021-06-04,7,1903,35.9
13301,Warren County,2021-06-05,1,1904,35.9
13301,Warren County,2021-06-06,3,1907,36
13301,Warren County,2021-06-07,15,1922,36.3
13301,Warren County,2021-06-08,4,1926,36.4
13301,Warren County,2021-06-09,8,1934,36.5
13301,Warren County,2021-06-10,10,1944,36.7
13301,Warren County,2021-06-11,5,1949,36.8
13301,Warren County,2021-06-12,3,1952,36.9
13301,Warren County,2021-06-13,1,1953,36.9
13301,Warren County,2021-06-14,2,1955,36.9
13301,Warren County,2021-06-15,3,1958,37
13301,Warren County,2021-06-16,9,1967,37.1
13301,Warren County,2021-06-17,18,1985,37.5
13301,Warren County,2021-06-18,3,1988,37.5
13301,Warren County,2021-06-19,4,1992,37.6
13301,Warren County,2021-06-20,1,1993,37.6
13301,Warren County,2021-06-21,2,1995,37.7
13301,Warren County,2021-06-22,5,2000,37.8
13301,Warren County,2021-06-23,2,2002,37.8
13301,Warren County,2021-06-24,2,2004,37.8
13301,Warren County,2021-06-25,6,2010,37.9
13301,Warren County,2021-06-26,4,2014,38
13301,Warren County,2021-06-28,3,2017,38.1
13301,Warren County,2021-06-29,4,2021,38.2
13301,Warren County,2021-06-30,10,2031,38.3
13301,Warren County,2021-07-01,6,2037,38.5
13301,Warren County,2021-07-02,2,2039,38.5
13301,Warren County,2021-07-03,1,2040,38.5
13301,Warren County,2021-07-04,1,2041,38.5
13301,Warren County,2021-07-06,5,2046,38.6
13301,Warren County,2021-07-07,8,2054,38.8
13301,Warren County,2021-07-08,1,2055,38.8
13301,Warren County,2021-07-09,9,2064,39
13301,Warren County,2021-07-10,2,2066,39
13301,Warren County,2021-07-11,1,2067,39
13301,Warren County,2021-07-12,4,2071,39.1
13301,Warren County,2021-07-13,5,2076,39.2
13301,Warren County,2021-07-14,1,2077,39.2
13301,Warren County,2021-07-15,5,2082,39.3
13301,Warren County,2021-07-17,7,2089,39.4
13301,Warren County,2021-07-18,2,2091,39.5
13301,Warren County,2021-07-19,5,2096,39.6
13301,Warren County,2021-07-20,6,2102,39.7
13301,Warren County,2021-07-21,10,2112,39.9
13301,Warren County,2021-07-22,7,2119,40
13301,Warren County,2021-07-23,8,2127,40.2
13301,Warren County,2021-07-25,1,2128,40.2
13301,Warren County,2021-07-26,8,2136,40.3
13301,Warren County,2021-07-27,10,2146,40.5
13301,Warren County,2021-07-28,23,2169,40.9
13301,Warren County,2021-07-29,6,2175,41.1
13301,Warren County,2021-07-30,9,2184,41.2
13301,Warren County,2021-07-31,4,2188,41.3
13301,Warren County,2021-08-01,4,2192,41.4
13301,Warren County,2021-08-02,4,2196,41.5
13301,Warren County,2021-08-03,7,2203,41.6
13301,Warren County,2021-08-04,28,2231,42.1
13301,Warren County,2021-08-05,6,2237,42.2
13301,Warren County,2021-08-06,14,2251,42.5
13301,Warren County,2021-08-07,8,2259,42.6
13301,Warren County,2021-08-08,8,2267,42.8
13301,Warren County,2021-08-09,12,2279,43
13301,Warren County,2021-08-10,9,2288,43.2
13301,Warren County,2021-08-11,18,2306,43.5
13301,Warren County,2021-08-12,10,2316,43.7
13301,Warren County,2021-08-13,13,2329,44
13301,Warren County,2021-08-14,9,2338,44.1
13301,Warren County,2021-08-15,3,2341,44.2
13301,Warren County,2021-08-16,8,2349,44.3
13301,Warren County,2021-08-17,11,2360,44.6
13301,Warren County,2021-08-18,22,2382,45
13301,Warren County,2021-08-19,20,2402,45.3
13301,Warren County,2021-08-20,5,2407,45.4
13301,Warren County,2021-08-21,7,2414,45.6
13301,Warren County,2021-08-22,1,2415,45.6
13301,Warren County,2021-08-23,9,2424,45.8
13301,Warren County,2021-08-24,6,2430,45.9
13301,Warren County,2021-08-25,13,2443,46.1
13301,Warren County,2021-08-26,10,2453,46.3
13301,Warren County,2021-08-27,8,2461,46.5
13301,Warren County,2021-08-28,1,2462,46.5
13301,Warren County,2021-08-29,3,2465,46.5
13301,Warren County,2021-08-30,8,2473,46.7
13301,Warren County,2021-08-31,17,2490,47
13301,Warren County,2021-09-01,4,2494,47.1
13301,Warren County,2021-09-02,13,2507,47.3
13301,Warren County,2021-09-03,8,2515,47.5
13301,Warren County,2021-09-04,2,2517,47.5
13301,Warren County,2021-09-05,3,2520,47.6
13301,Warren County,2021-09-06,3,2523,47.6
13301,Warren County,2021-09-07,5,2528,47.7
13301,Warren County,2021-09-08,9,2537,47.9
13301,Warren County,2021-09-09,10,2547,48.1
13301,Warren County,2021-09-10,6,2553,48.2
13301,Warren County,2021-09-11,3,2556,48.3
13301,Warren County,2021-09-12,1,2557,48.3
13301,Warren County,2021-09-13,7,2564,48.4
13301,Warren County,2021-09-14,9,2573,48.6
13301,Warren County,2021-09-15,13,2586,48.8
13301,Warren County,2021-09-16,8,2594,49
13301,Warren County,2021-09-17,3,2597,49
13301,Warren County,2021-09-18,5,2602,49.1
13301,Warren County,2021-09-19,2,2604,49.2
13301,Warren County,2021-09-20,6,2610,49.3
13301,Warren County,2021-09-21,2,2612,49.3
13301,Warren County,2021-09-22,9,2621,49.5
13301,Warren County,2021-09-23,4,2625,49.6
13301,Warren County,2021-09-24,6,2631,49.7
13301,Warren County,2021-09-25,3,2634,49.7
13301,Warren County,2021-09-27,3,2637,49.8
13301,Warren County,2021-09-28,4,2641,49.9
13301,Warren County,2021-09-29,2,2643,49.9
13301,Warren County,2021-09-30,3,2646,50
13301,Warren County,2021-10-01,6,2652,50.1
13301,Warren County,2021-10-02,2,2654,50.1
13301,Warren County,2021-10-04,1,2655,50.1
13301,Warren County,2021-10-06,5,2660,50.2
13301,Warren County,2021-10-07,2,2662,50.3
13303,Washington County,2020-12-15,1,1,0
13303,Washington County,2020-12-18,3,4,0
13303,Washington County,2020-12-19,1,5,0
13303,Washington County,2020-12-20,1,6,0
13303,Washington County,2020-12-22,5,11,0.1
13303,Washington County,2020-12-23,11,22,0.1
13303,Washington County,2020-12-24,1,23,0.1
13303,Washington County,2020-12-25,1,24,0.1
13303,Washington County,2020-12-27,1,25,0.1
13303,Washington County,2020-12-28,10,35,0.2
13303,Washington County,2020-12-29,17,52,0.3
13303,Washington County,2020-12-30,30,82,0.4
13303,Washington County,2020-12-31,27,109,0.5
13303,Washington County,2021-01-02,1,110,0.5
13303,Washington County,2021-01-04,22,132,0.6
13303,Washington County,2021-01-05,54,186,0.9
13303,Washington County,2021-01-06,30,216,1.1
13303,Washington County,2021-01-07,15,231,1.1
13303,Washington County,2021-01-08,37,268,1.3
13303,Washington County,2021-01-09,5,273,1.3
13303,Washington County,2021-01-11,18,291,1.4
13303,Washington County,2021-01-12,136,427,2.1
13303,Washington County,2021-01-13,121,548,2.7
13303,Washington County,2021-01-14,95,643,3.1
13303,Washington County,2021-01-15,110,753,3.7
13303,Washington County,2021-01-16,45,798,3.9
13303,Washington County,2021-01-17,8,806,3.9
13303,Washington County,2021-01-18,61,867,4.2
13303,Washington County,2021-01-19,169,1036,5.1
13303,Washington County,2021-01-20,124,1160,5.7
13303,Washington County,2021-01-21,58,1218,6
13303,Washington County,2021-01-22,55,1273,6.2
13303,Washington County,2021-01-23,7,1280,6.3
13303,Washington County,2021-01-25,7,1287,6.3
13303,Washington County,2021-01-26,147,1434,7
13303,Washington County,2021-01-27,12,1446,7.1
13303,Washington County,2021-01-28,51,1497,7.3
13303,Washington County,2021-01-29,85,1582,7.7
13303,Washington County,2021-01-30,8,1590,7.8
13303,Washington County,2021-02-01,9,1599,7.8
13303,Washington County,2021-02-02,96,1695,8.3
13303,Washington County,2021-02-03,104,1799,8.8
13303,Washington County,2021-02-04,39,1838,9
13303,Washington County,2021-02-05,63,1901,9.3
13303,Washington County,2021-02-06,2,1903,9.3
13303,Washington County,2021-02-08,3,1906,9.3
13303,Washington County,2021-02-09,106,2012,9.8
13303,Washington County,2021-02-10,75,2087,10.2
13303,Washington County,2021-02-11,19,2106,10.3
13303,Washington County,2021-02-12,33,2139,10.5
13303,Washington County,2021-02-13,5,2144,10.5
13303,Washington County,2021-02-14,2,2146,10.5
13303,Washington County,2021-02-15,9,2155,10.5
13303,Washington County,2021-02-16,33,2188,10.7
13303,Washington County,2021-02-17,57,2245,11
13303,Washington County,2021-02-18,27,2272,11.1
13303,Washington County,2021-02-19,16,2288,11.2
13303,Washington County,2021-02-20,3,2291,11.2
13303,Washington County,2021-02-21,1,2292,11.2
13303,Washington County,2021-02-22,30,2322,11.4
13303,Washington County,2021-02-23,87,2409,11.8
13303,Washington County,2021-02-24,55,2464,12.1
13303,Washington County,2021-02-25,56,2520,12.3
13303,Washington County,2021-02-26,37,2557,12.5
13303,Washington County,2021-02-27,2,2559,12.5
13303,Washington County,2021-02-28,1,2560,12.5
13303,Washington County,2021-03-01,42,2602,12.7
13303,Washington County,2021-03-02,96,2698,13.2
13303,Washington County,2021-03-03,25,2723,13.3
13303,Washington County,2021-03-04,23,2746,13.4
13303,Washington County,2021-03-05,75,2821,13.8
13303,Washington County,2021-03-06,1,2822,13.8
13303,Washington County,2021-03-08,9,2831,13.9
13303,Washington County,2021-03-09,101,2932,14.3
13303,Washington County,2021-03-10,146,3078,15.1
13303,Washington County,2021-03-11,59,3137,15.4
13303,Washington County,2021-03-12,198,3335,16.3
13303,Washington County,2021-03-13,4,3339,16.3
13303,Washington County,2021-03-14,3,3342,16.4
13303,Washington County,2021-03-15,47,3389,16.6
13303,Washington County,2021-03-16,192,3581,17.5
13303,Washington County,2021-03-17,154,3735,18.3
13303,Washington County,2021-03-18,43,3778,18.5
13303,Washington County,2021-03-19,247,4025,19.7
13303,Washington County,2021-03-20,36,4061,19.9
13303,Washington County,2021-03-21,7,4068,19.9
13303,Washington County,2021-03-22,14,4082,20
13303,Washington County,2021-03-23,284,4366,21.4
13303,Washington County,2021-03-24,45,4411,21.6
13303,Washington County,2021-03-25,89,4500,22
13303,Washington County,2021-03-26,203,4703,23
13303,Washington County,2021-03-27,63,4766,23.3
13303,Washington County,2021-03-28,4,4770,23.3
13303,Washington County,2021-03-29,15,4785,23.4
13303,Washington County,2021-03-30,169,4954,24.2
13303,Washington County,2021-03-31,131,5085,24.9
13303,Washington County,2021-04-01,81,5166,25.3
13303,Washington County,2021-04-02,100,5266,25.8
13303,Washington County,2021-04-03,39,5305,26
13303,Washington County,2021-04-04,5,5310,26
13303,Washington County,2021-04-05,21,5331,26.1
13303,Washington County,2021-04-06,120,5451,26.7
13303,Washington County,2021-04-07,85,5536,27.1
13303,Washington County,2021-04-08,85,5621,27.5
13303,Washington County,2021-04-09,69,5690,27.8
13303,Washington County,2021-04-10,20,5710,27.9
13303,Washington County,2021-04-11,3,5713,28
13303,Washington County,2021-04-12,6,5719,28
13303,Washington County,2021-04-13,58,5777,28.3
13303,Washington County,2021-04-14,20,5797,28.4
13303,Washington County,2021-04-15,51,5848,28.6
13303,Washington County,2021-04-16,51,5899,28.9
13303,Washington County,2021-04-17,27,5926,29
13303,Washington County,2021-04-18,4,5930,29
13303,Washington County,2021-04-19,8,5938,29.1
13303,Washington County,2021-04-20,59,5997,29.3
13303,Washington County,2021-04-21,21,6018,29.4
13303,Washington County,2021-04-22,31,6049,29.6
13303,Washington County,2021-04-23,48,6097,29.8
13303,Washington County,2021-04-24,13,6110,29.9
13303,Washington County,2021-04-25,1,6111,29.9
13303,Washington County,2021-04-26,4,6115,29.9
13303,Washington County,2021-04-27,54,6169,30.2
13303,Washington County,2021-04-28,36,6205,30.4
13303,Washington County,2021-04-29,29,6234,30.5
13303,Washington County,2021-04-30,44,6278,30.7
13303,Washington County,2021-05-01,9,6287,30.8
13303,Washington County,2021-05-02,4,6291,30.8
13303,Washington County,2021-05-03,14,6305,30.9
13303,Washington County,2021-05-04,31,6336,31
13303,Washington County,2021-05-05,38,6374,31.2
13303,Washington County,2021-05-06,16,6390,31.3
13303,Washington County,2021-05-07,32,6422,31.4
13303,Washington County,2021-05-08,14,6436,31.5
13303,Washington County,2021-05-09,4,6440,31.5
13303,Washington County,2021-05-10,23,6463,31.6
13303,Washington County,2021-05-11,20,6483,31.7
13303,Washington County,2021-05-12,24,6507,31.8
13303,Washington County,2021-05-13,16,6523,31.9
13303,Washington County,2021-05-14,31,6554,32.1
13303,Washington County,2021-05-15,25,6579,32.2
13303,Washington County,2021-05-16,6,6585,32.2
13303,Washington County,2021-05-17,21,6606,32.3
13303,Washington County,2021-05-18,27,6633,32.5
13303,Washington County,2021-05-19,24,6657,32.6
13303,Washington County,2021-05-20,13,6670,32.6
13303,Washington County,2021-05-21,44,6714,32.9
13303,Washington County,2021-05-22,6,6720,32.9
13303,Washington County,2021-05-23,3,6723,32.9
13303,Washington County,2021-05-24,17,6740,33
13303,Washington County,2021-05-25,5,6745,33
13303,Washington County,2021-05-26,16,6761,33.1
13303,Washington County,2021-05-27,9,6770,33.1
13303,Washington County,2021-05-28,17,6787,33.2
13303,Washington County,2021-05-29,5,6792,33.2
13303,Washington County,2021-05-30,4,6796,33.3
13303,Washington County,2021-05-31,3,6799,33.3
13303,Washington County,2021-06-01,12,6811,33.3
13303,Washington County,2021-06-02,12,6823,33.4
13303,Washington County,2021-06-03,17,6840,33.5
13303,Washington County,2021-06-04,11,6851,33.5
13303,Washington County,2021-06-05,9,6860,33.6
13303,Washington County,2021-06-06,6,6866,33.6
13303,Washington County,2021-06-07,10,6876,33.6
13303,Washington County,2021-06-08,8,6884,33.7
13303,Washington County,2021-06-09,14,6898,33.8
13303,Washington County,2021-06-10,10,6908,33.8
13303,Washington County,2021-06-11,13,6921,33.9
13303,Washington County,2021-06-12,6,6927,33.9
13303,Washington County,2021-06-13,2,6929,33.9
13303,Washington County,2021-06-14,11,6940,34
13303,Washington County,2021-06-15,11,6951,34
13303,Washington County,2021-06-16,14,6965,34.1
13303,Washington County,2021-06-17,7,6972,34.1
13303,Washington County,2021-06-18,15,6987,34.2
13303,Washington County,2021-06-19,6,6993,34.2
13303,Washington County,2021-06-20,1,6994,34.2
13303,Washington County,2021-06-21,4,6998,34.2
13303,Washington County,2021-06-22,5,7003,34.3
13303,Washington County,2021-06-23,9,7012,34.3
13303,Washington County,2021-06-24,9,7021,34.4
13303,Washington County,2021-06-25,12,7033,34.4
13303,Washington County,2021-06-26,3,7036,34.4
13303,Washington County,2021-06-27,3,7039,34.4
13303,Washington County,2021-06-28,7,7046,34.5
13303,Washington County,2021-06-29,14,7060,34.5
13303,Washington County,2021-06-30,10,7070,34.6
13303,Washington County,2021-07-01,7,7077,34.6
13303,Washington County,2021-07-02,15,7092,34.7
13303,Washington County,2021-07-03,4,7096,34.7
13303,Washington County,2021-07-05,6,7102,34.8
13303,Washington County,2021-07-06,11,7113,34.8
13303,Washington County,2021-07-07,7,7120,34.8
13303,Washington County,2021-07-08,6,7126,34.9
13303,Washington County,2021-07-09,19,7145,35
13303,Washington County,2021-07-10,7,7152,35
13303,Washington County,2021-07-11,2,7154,35
13303,Washington County,2021-07-12,12,7166,35.1
13303,Washington County,2021-07-13,8,7174,35.1
13303,Washington County,2021-07-14,1,7175,35.1
13303,Washington County,2021-07-15,10,7185,35.2
13303,Washington County,2021-07-16,15,7200,35.2
13303,Washington County,2021-07-17,5,7205,35.3
13303,Washington County,2021-07-18,3,7208,35.3
13303,Washington County,2021-07-19,4,7212,35.3
13303,Washington County,2021-07-20,30,7242,35.4
13303,Washington County,2021-07-21,14,7256,35.5
13303,Washington County,2021-07-22,11,7267,35.6
13303,Washington County,2021-07-23,21,7288,35.7
13303,Washington County,2021-07-24,14,7302,35.7
13303,Washington County,2021-07-25,3,7305,35.7
13303,Washington County,2021-07-26,18,7323,35.8
13303,Washington County,2021-07-27,40,7363,36
13303,Washington County,2021-07-28,40,7403,36.2
13303,Washington County,2021-07-29,33,7436,36.4
13303,Washington County,2021-07-30,47,7483,36.6
13303,Washington County,2021-07-31,12,7495,36.7
13303,Washington County,2021-08-01,3,7498,36.7
13303,Washington County,2021-08-02,26,7524,36.8
13303,Washington County,2021-08-03,61,7585,37.1
13303,Washington County,2021-08-04,56,7641,37.4
13303,Washington County,2021-08-05,37,7678,37.6
13303,Washington County,2021-08-06,77,7755,37.9
13303,Washington County,2021-08-07,30,7785,38.1
13303,Washington County,2021-08-08,11,7796,38.1
13303,Washington County,2021-08-09,56,7852,38.4
13303,Washington County,2021-08-10,115,7967,39
13303,Washington County,2021-08-11,73,8040,39.3
13303,Washington County,2021-08-12,41,8081,39.5
13303,Washington County,2021-08-13,122,8203,40.1
13303,Washington County,2021-08-14,44,8247,40.4
13303,Washington County,2021-08-15,18,8265,40.4
13303,Washington County,2021-08-16,42,8307,40.6
13303,Washington County,2021-08-17,101,8408,41.1
13303,Washington County,2021-08-18,41,8449,41.3
13303,Washington County,2021-08-19,33,8482,41.5
13303,Washington County,2021-08-20,103,8585,42
13303,Washington County,2021-08-21,25,8610,42.1
13303,Washington County,2021-08-22,22,8632,42.2
13303,Washington County,2021-08-23,39,8671,42.4
13303,Washington County,2021-08-24,80,8751,42.8
13303,Washington County,2021-08-25,58,8809,43.1
13303,Washington County,2021-08-26,31,8840,43.3
13303,Washington County,2021-08-27,73,8913,43.6
13303,Washington County,2021-08-28,22,8935,43.7
13303,Washington County,2021-08-29,13,8948,43.8
13303,Washington County,2021-08-30,64,9012,44.1
13303,Washington County,2021-08-31,54,9066,44.4
13303,Washington County,2021-09-01,38,9104,44.5
13303,Washington County,2021-09-02,27,9131,44.7
13303,Washington County,2021-09-03,70,9201,45
13303,Washington County,2021-09-04,10,9211,45.1
13303,Washington County,2021-09-05,7,9218,45.1
13303,Washington County,2021-09-06,4,9222,45.1
13303,Washington County,2021-09-07,32,9254,45.3
13303,Washington County,2021-09-08,23,9277,45.4
13303,Washington County,2021-09-09,23,9300,45.5
13303,Washington County,2021-09-10,50,9350,45.8
13303,Washington County,2021-09-11,12,9362,45.8
13303,Washington County,2021-09-12,10,9372,45.9
13303,Washington County,2021-09-13,21,9393,46
13303,Washington County,2021-09-14,28,9421,46.1
13303,Washington County,2021-09-15,22,9443,46.2
13303,Washington County,2021-09-16,24,9467,46.3
13303,Washington County,2021-09-17,27,9494,46.5
13303,Washington County,2021-09-18,10,9504,46.5
13303,Washington County,2021-09-20,19,9523,46.6
13303,Washington County,2021-09-21,28,9551,46.7
13303,Washington County,2021-09-22,13,9564,46.8
13303,Washington County,2021-09-23,5,9569,46.8
13303,Washington County,2021-09-24,29,9598,47
13303,Washington County,2021-09-25,3,9601,47
13303,Washington County,2021-09-26,1,9602,47
13303,Washington County,2021-09-27,3,9605,47
13303,Washington County,2021-09-28,18,9623,47.1
13303,Washington County,2021-09-29,5,9628,47.1
13303,Washington County,2021-09-30,8,9636,47.2
13303,Washington County,2021-10-01,12,9648,47.2
13303,Washington County,2021-10-02,2,9650,47.2
13303,Washington County,2021-10-03,1,9651,47.2
13303,Washington County,2021-10-04,11,9662,47.3
13303,Washington County,2021-10-05,3,9665,47.3
13303,Washington County,2021-10-06,10,9675,47.3
13303,Washington County,2021-10-07,5,9680,47.4
13305,Wayne County,2020-12-15,1,1,0
13305,Wayne County,2020-12-16,1,2,0
13305,Wayne County,2020-12-17,4,6,0
13305,Wayne County,2020-12-18,7,13,0
13305,Wayne County,2020-12-19,1,14,0
13305,Wayne County,2020-12-21,2,16,0.1
13305,Wayne County,2020-12-22,8,24,0.1
13305,Wayne County,2020-12-23,67,91,0.3
13305,Wayne County,2020-12-24,24,115,0.4
13305,Wayne County,2020-12-28,38,153,0.5
13305,Wayne County,2020-12-29,21,174,0.6
13305,Wayne County,2020-12-30,21,195,0.7
13305,Wayne County,2020-12-31,10,205,0.7
13305,Wayne County,2021-01-01,4,209,0.7
13305,Wayne County,2021-01-03,60,269,0.9
13305,Wayne County,2021-01-04,38,307,1
13305,Wayne County,2021-01-05,20,327,1.1
13305,Wayne County,2021-01-06,34,361,1.2
13305,Wayne County,2021-01-07,27,388,1.3
13305,Wayne County,2021-01-08,29,417,1.4
13305,Wayne County,2021-01-09,3,420,1.4
13305,Wayne County,2021-01-10,3,423,1.4
13305,Wayne County,2021-01-11,76,499,1.7
13305,Wayne County,2021-01-12,29,528,1.8
13305,Wayne County,2021-01-13,77,605,2
13305,Wayne County,2021-01-14,71,676,2.3
13305,Wayne County,2021-01-15,31,707,2.4
13305,Wayne County,2021-01-16,59,766,2.6
13305,Wayne County,2021-01-17,76,842,2.8
13305,Wayne County,2021-01-18,117,959,3.2
13305,Wayne County,2021-01-19,61,1020,3.4
13305,Wayne County,2021-01-20,139,1159,3.9
13305,Wayne County,2021-01-21,73,1232,4.1
13305,Wayne County,2021-01-22,78,1310,4.4
13305,Wayne County,2021-01-23,39,1349,4.5
13305,Wayne County,2021-01-24,8,1357,4.6
13305,Wayne County,2021-01-25,160,1517,5.1
13305,Wayne County,2021-01-26,121,1638,5.5
13305,Wayne County,2021-01-27,132,1770,5.9
13305,Wayne County,2021-01-28,87,1857,6.2
13305,Wayne County,2021-01-29,37,1894,6.4
13305,Wayne County,2021-01-30,49,1943,6.5
13305,Wayne County,2021-01-31,24,1967,6.6
13305,Wayne County,2021-02-01,103,2070,6.9
13305,Wayne County,2021-02-02,178,2248,7.5
13305,Wayne County,2021-02-03,157,2405,8.1
13305,Wayne County,2021-02-04,144,2549,8.6
13305,Wayne County,2021-02-05,23,2572,8.6
13305,Wayne County,2021-02-06,33,2605,8.7
13305,Wayne County,2021-02-07,18,2623,8.8
13305,Wayne County,2021-02-08,109,2732,9.2
13305,Wayne County,2021-02-09,106,2838,9.5
13305,Wayne County,2021-02-10,89,2927,9.8
13305,Wayne County,2021-02-11,66,2993,10
13305,Wayne County,2021-02-12,46,3039,10.2
13305,Wayne County,2021-02-13,14,3053,10.2
13305,Wayne County,2021-02-14,6,3059,10.3
13305,Wayne County,2021-02-15,60,3119,10.5
13305,Wayne County,2021-02-16,79,3198,10.7
13305,Wayne County,2021-02-17,43,3241,10.9
13305,Wayne County,2021-02-18,37,3278,11
13305,Wayne County,2021-02-19,42,3320,11.1
13305,Wayne County,2021-02-20,30,3350,11.2
13305,Wayne County,2021-02-21,2,3352,11.3
13305,Wayne County,2021-02-22,55,3407,11.4
13305,Wayne County,2021-02-23,41,3448,11.6
13305,Wayne County,2021-02-24,34,3482,11.7
13305,Wayne County,2021-02-25,21,3503,11.8
13305,Wayne County,2021-02-26,34,3537,11.9
13305,Wayne County,2021-02-27,16,3553,11.9
13305,Wayne County,2021-02-28,10,3563,12
13305,Wayne County,2021-03-01,64,3627,12.2
13305,Wayne County,2021-03-02,35,3662,12.3
13305,Wayne County,2021-03-03,47,3709,12.5
13305,Wayne County,2021-03-04,52,3761,12.6
13305,Wayne County,2021-03-05,26,3787,12.7
13305,Wayne County,2021-03-06,10,3797,12.7
13305,Wayne County,2021-03-07,16,3813,12.8
13305,Wayne County,2021-03-08,71,3884,13
13305,Wayne County,2021-03-09,113,3997,13.4
13305,Wayne County,2021-03-10,161,4158,14
13305,Wayne County,2021-03-11,172,4330,14.5
13305,Wayne County,2021-03-12,60,4390,14.7
13305,Wayne County,2021-03-13,35,4425,14.9
13305,Wayne County,2021-03-14,28,4453,14.9
13305,Wayne County,2021-03-15,115,4568,15.3
13305,Wayne County,2021-03-16,99,4667,15.7
13305,Wayne County,2021-03-17,142,4809,16.1
13305,Wayne County,2021-03-18,103,4912,16.5
13305,Wayne County,2021-03-19,76,4988,16.7
13305,Wayne County,2021-03-20,19,5007,16.8
13305,Wayne County,2021-03-21,21,5028,16.9
13305,Wayne County,2021-03-22,85,5113,17.2
13305,Wayne County,2021-03-23,130,5243,17.6
13305,Wayne County,2021-03-24,116,5359,18
13305,Wayne County,2021-03-25,171,5530,18.6
13305,Wayne County,2021-03-26,68,5598,18.8
13305,Wayne County,2021-03-27,20,5618,18.9
13305,Wayne County,2021-03-28,17,5635,18.9
13305,Wayne County,2021-03-29,71,5706,19.2
13305,Wayne County,2021-03-30,81,5787,19.4
13305,Wayne County,2021-03-31,183,5970,20
13305,Wayne County,2021-04-01,139,6109,20.5
13305,Wayne County,2021-04-02,58,6167,20.7
13305,Wayne County,2021-04-03,14,6181,20.7
13305,Wayne County,2021-04-04,12,6193,20.8
13305,Wayne County,2021-04-05,54,6247,21
13305,Wayne County,2021-04-06,119,6366,21.4
13305,Wayne County,2021-04-07,87,6453,21.7
13305,Wayne County,2021-04-08,74,6527,21.9
13305,Wayne County,2021-04-09,72,6599,22.2
13305,Wayne County,2021-04-10,28,6627,22.2
13305,Wayne County,2021-04-11,12,6639,22.3
13305,Wayne County,2021-04-12,46,6685,22.4
13305,Wayne County,2021-04-13,52,6737,22.6
13305,Wayne County,2021-04-14,67,6804,22.8
13305,Wayne County,2021-04-15,45,6849,23
13305,Wayne County,2021-04-16,38,6887,23.1
13305,Wayne County,2021-04-17,12,6899,23.2
13305,Wayne County,2021-04-18,6,6905,23.2
13305,Wayne County,2021-04-19,24,6929,23.3
13305,Wayne County,2021-04-20,29,6958,23.4
13305,Wayne County,2021-04-21,47,7005,23.5
13305,Wayne County,2021-04-22,46,7051,23.7
13305,Wayne County,2021-04-23,51,7102,23.8
13305,Wayne County,2021-04-24,19,7121,23.9
13305,Wayne County,2021-04-25,9,7130,23.9
13305,Wayne County,2021-04-26,16,7146,24
13305,Wayne County,2021-04-27,30,7176,24.1
13305,Wayne County,2021-04-28,48,7224,24.3
13305,Wayne County,2021-04-29,29,7253,24.3
13305,Wayne County,2021-04-30,46,7299,24.5
13305,Wayne County,2021-05-01,11,7310,24.5
13305,Wayne County,2021-05-02,4,7314,24.6
13305,Wayne County,2021-05-03,27,7341,24.6
13305,Wayne County,2021-05-04,28,7369,24.7
13305,Wayne County,2021-05-05,25,7394,24.8
13305,Wayne County,2021-05-06,23,7417,24.9
13305,Wayne County,2021-05-07,25,7442,25
13305,Wayne County,2021-05-08,6,7448,25
13305,Wayne County,2021-05-09,7,7455,25
13305,Wayne County,2021-05-10,34,7489,25.1
13305,Wayne County,2021-05-11,29,7518,25.2
13305,Wayne County,2021-05-12,19,7537,25.3
13305,Wayne County,2021-05-13,30,7567,25.4
13305,Wayne County,2021-05-14,25,7592,25.5
13305,Wayne County,2021-05-15,26,7618,25.6
13305,Wayne County,2021-05-16,11,7629,25.6
13305,Wayne County,2021-05-17,40,7669,25.7
13305,Wayne County,2021-05-18,45,7714,25.9
13305,Wayne County,2021-05-19,43,7757,26
13305,Wayne County,2021-05-20,26,7783,26.1
13305,Wayne County,2021-05-21,32,7815,26.2
13305,Wayne County,2021-05-22,46,7861,26.4
13305,Wayne County,2021-05-23,7,7868,26.4
13305,Wayne County,2021-05-24,25,7893,26.5
13305,Wayne County,2021-05-25,27,7920,26.6
13305,Wayne County,2021-05-26,16,7936,26.6
13305,Wayne County,2021-05-27,21,7957,26.7
13305,Wayne County,2021-05-28,10,7967,26.7
13305,Wayne County,2021-05-29,4,7971,26.8
13305,Wayne County,2021-05-30,4,7975,26.8
13305,Wayne County,2021-05-31,1,7976,26.8
13305,Wayne County,2021-06-01,19,7995,26.8
13305,Wayne County,2021-06-02,15,8010,26.9
13305,Wayne County,2021-06-03,24,8034,27
13305,Wayne County,2021-06-04,20,8054,27
13305,Wayne County,2021-06-05,9,8063,27.1
13305,Wayne County,2021-06-06,3,8066,27.1
13305,Wayne County,2021-06-07,14,8080,27.1
13305,Wayne County,2021-06-08,10,8090,27.2
13305,Wayne County,2021-06-09,13,8103,27.2
13305,Wayne County,2021-06-10,12,8115,27.2
13305,Wayne County,2021-06-11,16,8131,27.3
13305,Wayne County,2021-06-12,9,8140,27.3
13305,Wayne County,2021-06-13,10,8150,27.4
13305,Wayne County,2021-06-14,9,8159,27.4
13305,Wayne County,2021-06-15,21,8180,27.5
13305,Wayne County,2021-06-16,9,8189,27.5
13305,Wayne County,2021-06-17,17,8206,27.5
13305,Wayne County,2021-06-18,10,8216,27.6
13305,Wayne County,2021-06-19,6,8222,27.6
13305,Wayne County,2021-06-20,3,8225,27.6
13305,Wayne County,2021-06-21,14,8239,27.7
13305,Wayne County,2021-06-22,17,8256,27.7
13305,Wayne County,2021-06-23,11,8267,27.8
13305,Wayne County,2021-06-24,13,8280,27.8
13305,Wayne County,2021-06-25,13,8293,27.8
13305,Wayne County,2021-06-26,4,8297,27.9
13305,Wayne County,2021-06-27,4,8301,27.9
13305,Wayne County,2021-06-28,4,8305,27.9
13305,Wayne County,2021-06-29,15,8320,27.9
13305,Wayne County,2021-06-30,9,8329,28
13305,Wayne County,2021-07-01,17,8346,28
13305,Wayne County,2021-07-02,10,8356,28.1
13305,Wayne County,2021-07-03,5,8361,28.1
13305,Wayne County,2021-07-04,2,8363,28.1
13305,Wayne County,2021-07-05,9,8372,28.1
13305,Wayne County,2021-07-06,13,8385,28.1
13305,Wayne County,2021-07-07,5,8390,28.2
13305,Wayne County,2021-07-08,17,8407,28.2
13305,Wayne County,2021-07-09,13,8420,28.3
13305,Wayne County,2021-07-10,9,8429,28.3
13305,Wayne County,2021-07-11,2,8431,28.3
13305,Wayne County,2021-07-12,13,8444,28.3
13305,Wayne County,2021-07-13,3,8447,28.4
13305,Wayne County,2021-07-14,8,8455,28.4
13305,Wayne County,2021-07-15,29,8484,28.5
13305,Wayne County,2021-07-16,18,8502,28.5
13305,Wayne County,2021-07-17,13,8515,28.6
13305,Wayne County,2021-07-18,5,8520,28.6
13305,Wayne County,2021-07-19,14,8534,28.6
13305,Wayne County,2021-07-20,38,8572,28.8
13305,Wayne County,2021-07-21,21,8593,28.8
13305,Wayne County,2021-07-22,40,8633,29
13305,Wayne County,2021-07-23,64,8697,29.2
13305,Wayne County,2021-07-24,22,8719,29.3
13305,Wayne County,2021-07-25,18,8737,29.3
13305,Wayne County,2021-07-26,35,8772,29.4
13305,Wayne County,2021-07-27,60,8832,29.6
13305,Wayne County,2021-07-28,31,8863,29.8
13305,Wayne County,2021-07-29,35,8898,29.9
13305,Wayne County,2021-07-30,55,8953,30.1
13305,Wayne County,2021-07-31,26,8979,30.1
13305,Wayne County,2021-08-01,30,9009,30.2
13305,Wayne County,2021-08-02,57,9066,30.4
13305,Wayne County,2021-08-03,63,9129,30.6
13305,Wayne County,2021-08-04,47,9176,30.8
13305,Wayne County,2021-08-05,55,9231,31
13305,Wayne County,2021-08-06,104,9335,31.3
13305,Wayne County,2021-08-07,34,9369,31.5
13305,Wayne County,2021-08-08,17,9386,31.5
13305,Wayne County,2021-08-09,54,9440,31.7
13305,Wayne County,2021-08-10,81,9521,32
13305,Wayne County,2021-08-11,71,9592,32.2
13305,Wayne County,2021-08-12,80,9672,32.5
13305,Wayne County,2021-08-13,84,9756,32.8
13305,Wayne County,2021-08-14,48,9804,32.9
13305,Wayne County,2021-08-15,26,9830,33
13305,Wayne County,2021-08-16,57,9887,33.2
13305,Wayne County,2021-08-17,84,9971,33.5
13305,Wayne County,2021-08-18,54,10025,33.7
13305,Wayne County,2021-08-19,71,10096,33.9
13305,Wayne County,2021-08-20,131,10227,34.3
13305,Wayne County,2021-08-21,30,10257,34.4
13305,Wayne County,2021-08-22,13,10270,34.5
13305,Wayne County,2021-08-23,28,10298,34.6
13305,Wayne County,2021-08-24,56,10354,34.8
13305,Wayne County,2021-08-25,43,10397,34.9
13305,Wayne County,2021-08-26,85,10482,35.2
13305,Wayne County,2021-08-27,76,10558,35.4
13305,Wayne County,2021-08-28,40,10598,35.6
13305,Wayne County,2021-08-29,16,10614,35.6
13305,Wayne County,2021-08-30,61,10675,35.8
13305,Wayne County,2021-08-31,75,10750,36.1
13305,Wayne County,2021-09-01,70,10820,36.3
13305,Wayne County,2021-09-02,99,10919,36.7
13305,Wayne County,2021-09-03,159,11078,37.2
13305,Wayne County,2021-09-04,29,11107,37.3
13305,Wayne County,2021-09-05,29,11136,37.4
13305,Wayne County,2021-09-06,22,11158,37.5
13305,Wayne County,2021-09-07,63,11221,37.7
13305,Wayne County,2021-09-08,63,11284,37.9
13305,Wayne County,2021-09-09,84,11368,38.2
13305,Wayne County,2021-09-10,77,11445,38.4
13305,Wayne County,2021-09-11,26,11471,38.5
13305,Wayne County,2021-09-12,18,11489,38.6
13305,Wayne County,2021-09-13,48,11537,38.7
13305,Wayne County,2021-09-14,51,11588,38.9
13305,Wayne County,2021-09-15,33,11621,39
13305,Wayne County,2021-09-16,38,11659,39.1
13305,Wayne County,2021-09-17,38,11697,39.3
13305,Wayne County,2021-09-18,22,11719,39.3
13305,Wayne County,2021-09-19,17,11736,39.4
13305,Wayne County,2021-09-20,47,11783,39.6
13305,Wayne County,2021-09-21,39,11822,39.7
13305,Wayne County,2021-09-22,20,11842,39.8
13305,Wayne County,2021-09-23,25,11867,39.8
13305,Wayne County,2021-09-24,19,11886,39.9
13305,Wayne County,2021-09-25,9,11895,39.9
13305,Wayne County,2021-09-26,4,11899,39.9
13305,Wayne County,2021-09-27,6,11905,40
13305,Wayne County,2021-09-28,11,11916,40
13305,Wayne County,2021-09-29,15,11931,40.1
13305,Wayne County,2021-09-30,18,11949,40.1
13305,Wayne County,2021-10-01,12,11961,40.2
13305,Wayne County,2021-10-02,7,11968,40.2
13305,Wayne County,2021-10-03,4,11972,40.2
13305,Wayne County,2021-10-04,1,11973,40.2
13305,Wayne County,2021-10-05,7,11980,40.2
13305,Wayne County,2021-10-06,8,11988,40.2
13305,Wayne County,2021-10-07,11,11999,40.3
13307,Webster County,2020-12-23,1,1,0
13307,Webster County,2020-12-24,2,3,0.1
13307,Webster County,2020-12-26,2,5,0.2
13307,Webster County,2020-12-28,4,9,0.3
13307,Webster County,2020-12-29,2,11,0.4
13307,Webster County,2020-12-31,2,13,0.5
13307,Webster County,2021-01-02,1,14,0.5
13307,Webster County,2021-01-03,2,16,0.6
13307,Webster County,2021-01-04,1,17,0.7
13307,Webster County,2021-01-05,6,23,0.9
13307,Webster County,2021-01-06,9,32,1.2
13307,Webster County,2021-01-07,1,33,1.3
13307,Webster County,2021-01-08,5,38,1.5
13307,Webster County,2021-01-09,1,39,1.5
13307,Webster County,2021-01-11,39,78,3
13307,Webster County,2021-01-12,5,83,3.2
13307,Webster County,2021-01-13,4,87,3.3
13307,Webster County,2021-01-14,73,160,6.1
13307,Webster County,2021-01-15,47,207,7.9
13307,Webster County,2021-01-16,1,208,8
13307,Webster County,2021-01-17,3,211,8.1
13307,Webster County,2021-01-18,9,220,8.4
13307,Webster County,2021-01-19,2,222,8.5
13307,Webster County,2021-01-20,3,225,8.6
13307,Webster County,2021-01-21,52,277,10.6
13307,Webster County,2021-01-22,12,289,11.1
13307,Webster County,2021-01-23,1,290,11.1
13307,Webster County,2021-01-25,11,301,11.5
13307,Webster County,2021-01-26,1,302,11.6
13307,Webster County,2021-01-27,6,308,11.8
13307,Webster County,2021-01-28,27,335,12.8
13307,Webster County,2021-01-29,3,338,13
13307,Webster County,2021-01-31,1,339,13
13307,Webster County,2021-02-01,8,347,13.3
13307,Webster County,2021-02-02,1,348,13.3
13307,Webster County,2021-02-03,5,353,13.5
13307,Webster County,2021-02-04,2,355,13.6
13307,Webster County,2021-02-05,3,358,13.7
13307,Webster County,2021-02-07,1,359,13.8
13307,Webster County,2021-02-08,2,361,13.8
13307,Webster County,2021-02-09,1,362,13.9
13307,Webster County,2021-02-11,6,368,14.1
13307,Webster County,2021-02-12,1,369,14.1
13307,Webster County,2021-02-13,1,370,14.2
13307,Webster County,2021-02-15,24,394,15.1
13307,Webster County,2021-02-16,5,399,15.3
13307,Webster County,2021-02-17,1,400,15.3
13307,Webster County,2021-02-18,2,402,15.4
13307,Webster County,2021-02-19,2,404,15.5
13307,Webster County,2021-02-22,1,405,15.5
13307,Webster County,2021-02-24,2,407,15.6
13307,Webster County,2021-02-25,5,412,15.8
13307,Webster County,2021-02-26,2,414,15.9
13307,Webster County,2021-02-27,1,415,15.9
13307,Webster County,2021-03-01,1,416,15.9
13307,Webster County,2021-03-02,3,419,16.1
13307,Webster County,2021-03-03,4,423,16.2
13307,Webster County,2021-03-04,33,456,17.5
13307,Webster County,2021-03-05,1,457,17.5
13307,Webster County,2021-03-07,1,458,17.5
13307,Webster County,2021-03-08,17,475,18.2
13307,Webster County,2021-03-09,2,477,18.3
13307,Webster County,2021-03-10,4,481,18.4
13307,Webster County,2021-03-11,41,522,20
13307,Webster County,2021-03-12,14,536,20.5
13307,Webster County,2021-03-14,1,537,20.6
13307,Webster County,2021-03-15,19,556,21.3
13307,Webster County,2021-03-16,7,563,21.6
13307,Webster County,2021-03-17,2,565,21.6
13307,Webster County,2021-03-18,4,569,21.8
13307,Webster County,2021-03-19,22,591,22.6
13307,Webster County,2021-03-22,6,597,22.9
13307,Webster County,2021-03-23,7,604,23.1
13307,Webster County,2021-03-24,3,607,23.3
13307,Webster County,2021-03-25,37,644,24.7
13307,Webster County,2021-03-26,18,662,25.4
13307,Webster County,2021-03-29,16,678,26
13307,Webster County,2021-03-30,6,684,26.2
13307,Webster County,2021-03-31,4,688,26.4
13307,Webster County,2021-04-01,17,705,27
13307,Webster County,2021-04-02,7,712,27.3
13307,Webster County,2021-04-03,1,713,27.3
13307,Webster County,2021-04-05,9,722,27.7
13307,Webster County,2021-04-06,10,732,28
13307,Webster County,2021-04-07,2,734,28.1
13307,Webster County,2021-04-08,21,755,28.9
13307,Webster County,2021-04-09,5,760,29.1
13307,Webster County,2021-04-10,1,761,29.2
13307,Webster County,2021-04-11,2,763,29.2
13307,Webster County,2021-04-12,17,780,29.9
13307,Webster County,2021-04-13,3,783,30
13307,Webster County,2021-04-14,4,787,30.2
13307,Webster County,2021-04-15,2,789,30.2
13307,Webster County,2021-04-16,10,799,30.6
13307,Webster County,2021-04-17,1,800,30.7
13307,Webster County,2021-04-19,5,805,30.8
13307,Webster County,2021-04-20,4,809,31
13307,Webster County,2021-04-21,1,810,31
13307,Webster County,2021-04-22,8,818,31.3
13307,Webster County,2021-04-23,5,823,31.5
13307,Webster County,2021-04-26,3,826,31.6
13307,Webster County,2021-04-27,2,828,31.7
13307,Webster County,2021-04-28,5,833,31.9
13307,Webster County,2021-04-29,10,843,32.3
13307,Webster County,2021-04-30,2,845,32.4
13307,Webster County,2021-05-01,2,847,32.5
13307,Webster County,2021-05-03,1,848,32.5
13307,Webster County,2021-05-04,2,850,32.6
13307,Webster County,2021-05-05,2,852,32.6
13307,Webster County,2021-05-06,4,856,32.8
13307,Webster County,2021-05-07,3,859,32.9
13307,Webster County,2021-05-10,2,861,33
13307,Webster County,2021-05-11,1,862,33
13307,Webster County,2021-05-12,2,864,33.1
13307,Webster County,2021-05-13,7,871,33.4
13307,Webster County,2021-05-14,6,877,33.6
13307,Webster County,2021-05-17,5,882,33.8
13307,Webster County,2021-05-18,2,884,33.9
13307,Webster County,2021-05-20,4,888,34
13307,Webster County,2021-05-21,6,894,34.3
13307,Webster County,2021-05-25,3,897,34.4
13307,Webster County,2021-05-27,3,900,34.5
13307,Webster County,2021-05-28,3,903,34.6
13307,Webster County,2021-05-30,3,906,34.7
13307,Webster County,2021-05-31,1,907,34.8
13307,Webster County,2021-06-01,1,908,34.8
13307,Webster County,2021-06-02,1,909,34.8
13307,Webster County,2021-06-05,1,910,34.9
13307,Webster County,2021-06-07,4,914,35
13307,Webster County,2021-06-09,2,916,35.1
13307,Webster County,2021-06-10,3,919,35.2
13307,Webster County,2021-06-11,4,923,35.4
13307,Webster County,2021-06-14,2,925,35.4
13307,Webster County,2021-06-15,2,927,35.5
13307,Webster County,2021-06-17,3,930,35.6
13307,Webster County,2021-06-18,1,931,35.7
13307,Webster County,2021-06-21,1,932,35.7
13307,Webster County,2021-06-22,1,933,35.7
13307,Webster County,2021-06-23,1,934,35.8
13307,Webster County,2021-06-25,1,935,35.8
13307,Webster County,2021-06-28,1,936,35.9
13307,Webster County,2021-06-29,2,938,35.9
13307,Webster County,2021-06-30,1,939,36
13307,Webster County,2021-07-01,2,941,36.1
13307,Webster County,2021-07-06,3,944,36.2
13307,Webster County,2021-07-07,5,949,36.4
13307,Webster County,2021-07-08,4,953,36.5
13307,Webster County,2021-07-09,3,956,36.6
13307,Webster County,2021-07-12,1,957,36.7
13307,Webster County,2021-07-13,1,958,36.7
13307,Webster County,2021-07-14,2,960,36.8
13307,Webster County,2021-07-15,4,964,36.9
13307,Webster County,2021-07-16,1,965,37
13307,Webster County,2021-07-19,3,968,37.1
13307,Webster County,2021-07-21,2,970,37.2
13307,Webster County,2021-07-22,4,974,37.3
13307,Webster County,2021-07-23,6,980,37.5
13307,Webster County,2021-07-24,1,981,37.6
13307,Webster County,2021-07-27,4,985,37.7
13307,Webster County,2021-07-28,4,989,37.9
13307,Webster County,2021-07-29,2,991,38
13307,Webster County,2021-07-30,7,998,38.2
13307,Webster County,2021-07-31,2,1000,38.3
13307,Webster County,2021-08-01,1,1001,38.4
13307,Webster County,2021-08-02,2,1003,38.4
13307,Webster County,2021-08-03,1,1004,38.5
13307,Webster County,2021-08-04,11,1015,38.9
13307,Webster County,2021-08-05,10,1025,39.3
13307,Webster County,2021-08-06,2,1027,39.3
13307,Webster County,2021-08-07,3,1030,39.5
13307,Webster County,2021-08-08,1,1031,39.5
13307,Webster County,2021-08-09,5,1036,39.7
13307,Webster County,2021-08-10,3,1039,39.8
13307,Webster County,2021-08-11,12,1051,40.3
13307,Webster County,2021-08-12,6,1057,40.5
13307,Webster County,2021-08-13,12,1069,41
13307,Webster County,2021-08-14,2,1071,41
13307,Webster County,2021-08-15,2,1073,41.1
13307,Webster County,2021-08-16,1,1074,41.1
13307,Webster County,2021-08-17,3,1077,41.3
13307,Webster County,2021-08-18,4,1081,41.4
13307,Webster County,2021-08-19,10,1091,41.8
13307,Webster County,2021-08-20,6,1097,42
13307,Webster County,2021-08-21,2,1099,42.1
13307,Webster County,2021-08-24,5,1104,42.3
13307,Webster County,2021-08-25,4,1108,42.5
13307,Webster County,2021-08-26,12,1120,42.9
13307,Webster County,2021-08-27,4,1124,43.1
13307,Webster County,2021-08-29,2,1126,43.1
13307,Webster County,2021-08-30,3,1129,43.3
13307,Webster County,2021-08-31,3,1132,43.4
13307,Webster County,2021-09-01,5,1137,43.6
13307,Webster County,2021-09-02,3,1140,43.7
13307,Webster County,2021-09-03,4,1144,43.8
13307,Webster County,2021-09-04,1,1145,43.9
13307,Webster County,2021-09-05,1,1146,43.9
13307,Webster County,2021-09-06,1,1147,43.9
13307,Webster County,2021-09-07,10,1157,44.3
13307,Webster County,2021-09-08,1,1158,44.4
13307,Webster County,2021-09-09,2,1160,44.4
13307,Webster County,2021-09-10,5,1165,44.6
13307,Webster County,2021-09-11,3,1168,44.8
13307,Webster County,2021-09-13,3,1171,44.9
13307,Webster County,2021-09-14,2,1173,44.9
13307,Webster County,2021-09-15,3,1176,45.1
13307,Webster County,2021-09-16,2,1178,45.1
13307,Webster County,2021-09-17,1,1179,45.2
13307,Webster County,2021-09-18,1,1180,45.2
13307,Webster County,2021-09-19,1,1181,45.2
13307,Webster County,2021-09-21,3,1184,45.4
13307,Webster County,2021-09-22,2,1186,45.4
13307,Webster County,2021-09-23,6,1192,45.7
13307,Webster County,2021-09-24,1,1193,45.7
13307,Webster County,2021-09-27,2,1195,45.8
13307,Webster County,2021-09-29,1,1196,45.8
13307,Webster County,2021-09-30,1,1197,45.9
13307,Webster County,2021-10-01,2,1199,45.9
13307,Webster County,2021-10-04,1,1200,46
13307,Webster County,2021-10-06,2,1202,46.1
13307,Webster County,2021-10-07,2,1204,46.1
13309,Wheeler County,2020-12-17,1,1,0
13309,Wheeler County,2020-12-18,3,4,0.1
13309,Wheeler County,2020-12-19,2,6,0.1
13309,Wheeler County,2020-12-21,2,8,0.1
13309,Wheeler County,2020-12-22,1,9,0.1
13309,Wheeler County,2020-12-23,2,11,0.1
13309,Wheeler County,2020-12-24,1,12,0.2
13309,Wheeler County,2020-12-28,6,18,0.2
13309,Wheeler County,2020-12-29,3,21,0.3
13309,Wheeler County,2020-12-30,17,38,0.5
13309,Wheeler County,2020-12-31,3,41,0.5
13309,Wheeler County,2021-01-01,1,42,0.5
13309,Wheeler County,2021-01-03,1,43,0.5
13309,Wheeler County,2021-01-04,4,47,0.6
13309,Wheeler County,2021-01-05,13,60,0.8
13309,Wheeler County,2021-01-06,7,67,0.8
13309,Wheeler County,2021-01-07,21,88,1.1
13309,Wheeler County,2021-01-08,3,91,1.1
13309,Wheeler County,2021-01-09,1,92,1.2
13309,Wheeler County,2021-01-11,92,184,2.3
13309,Wheeler County,2021-01-12,27,211,2.7
13309,Wheeler County,2021-01-13,50,261,3.3
13309,Wheeler County,2021-01-14,7,268,3.4
13309,Wheeler County,2021-01-15,43,311,3.9
13309,Wheeler County,2021-01-16,3,314,4
13309,Wheeler County,2021-01-17,1,315,4
13309,Wheeler County,2021-01-18,135,450,5.7
13309,Wheeler County,2021-01-19,16,466,5.9
13309,Wheeler County,2021-01-20,13,479,6
13309,Wheeler County,2021-01-21,5,484,6.1
13309,Wheeler County,2021-01-22,2,486,6.1
13309,Wheeler County,2021-01-23,1,487,6.1
13309,Wheeler County,2021-01-25,69,556,7
13309,Wheeler County,2021-01-26,22,578,7.3
13309,Wheeler County,2021-01-27,3,581,7.3
13309,Wheeler County,2021-01-28,7,588,7.4
13309,Wheeler County,2021-01-29,1,589,7.4
13309,Wheeler County,2021-02-01,28,617,7.8
13309,Wheeler County,2021-02-02,10,627,7.9
13309,Wheeler County,2021-02-03,6,633,8
13309,Wheeler County,2021-02-04,5,638,8
13309,Wheeler County,2021-02-05,3,641,8.1
13309,Wheeler County,2021-02-06,1,642,8.1
13309,Wheeler County,2021-02-08,22,664,8.4
13309,Wheeler County,2021-02-09,11,675,8.5
13309,Wheeler County,2021-02-10,9,684,8.6
13309,Wheeler County,2021-02-11,1,685,8.6
13309,Wheeler County,2021-02-12,1,686,8.7
13309,Wheeler County,2021-02-15,21,707,8.9
13309,Wheeler County,2021-02-16,12,719,9.1
13309,Wheeler County,2021-02-17,8,727,9.2
13309,Wheeler County,2021-02-18,1,728,9.2
13309,Wheeler County,2021-02-22,34,762,9.6
13309,Wheeler County,2021-02-23,7,769,9.7
13309,Wheeler County,2021-02-24,3,772,9.7
13309,Wheeler County,2021-02-27,1,773,9.8
13309,Wheeler County,2021-03-01,32,805,10.2
13309,Wheeler County,2021-03-02,1,806,10.2
13309,Wheeler County,2021-03-03,4,810,10.2
13309,Wheeler County,2021-03-04,4,814,10.3
13309,Wheeler County,2021-03-05,2,816,10.3
13309,Wheeler County,2021-03-08,19,835,10.5
13309,Wheeler County,2021-03-09,20,855,10.8
13309,Wheeler County,2021-03-10,14,869,11
13309,Wheeler County,2021-03-11,10,879,11.1
13309,Wheeler County,2021-03-12,34,913,11.5
13309,Wheeler County,2021-03-13,2,915,11.5
13309,Wheeler County,2021-03-15,14,929,11.7
13309,Wheeler County,2021-03-16,13,942,11.9
13309,Wheeler County,2021-03-17,13,955,12
13309,Wheeler County,2021-03-18,4,959,12.1
13309,Wheeler County,2021-03-19,2,961,12.1
13309,Wheeler County,2021-03-20,2,963,12.1
13309,Wheeler County,2021-03-21,1,964,12.2
13309,Wheeler County,2021-03-22,36,1000,12.6
13309,Wheeler County,2021-03-23,17,1017,12.8
13309,Wheeler County,2021-03-24,5,1022,12.9
13309,Wheeler County,2021-03-25,12,1034,13
13309,Wheeler County,2021-03-26,5,1039,13.1
13309,Wheeler County,2021-03-27,5,1044,13.2
13309,Wheeler County,2021-03-28,1,1045,13.2
13309,Wheeler County,2021-03-29,38,1083,13.7
13309,Wheeler County,2021-03-30,22,1105,13.9
13309,Wheeler County,2021-03-31,40,1145,14.4
13309,Wheeler County,2021-04-01,5,1150,14.5
13309,Wheeler County,2021-04-02,5,1155,14.6
13309,Wheeler County,2021-04-03,3,1158,14.6
13309,Wheeler County,2021-04-05,15,1173,14.8
13309,Wheeler County,2021-04-06,8,1181,14.9
13309,Wheeler County,2021-04-07,9,1190,15
13309,Wheeler County,2021-04-08,13,1203,15.2
13309,Wheeler County,2021-04-09,14,1217,15.4
13309,Wheeler County,2021-04-10,2,1219,15.4
13309,Wheeler County,2021-04-12,21,1240,15.6
13309,Wheeler County,2021-04-13,5,1245,15.7
13309,Wheeler County,2021-04-14,5,1250,15.8
13309,Wheeler County,2021-04-15,5,1255,15.8
13309,Wheeler County,2021-04-16,1,1256,15.8
13309,Wheeler County,2021-04-19,16,1272,16
13309,Wheeler County,2021-04-20,9,1281,16.2
13309,Wheeler County,2021-04-21,4,1285,16.2
13309,Wheeler County,2021-04-22,8,1293,16.3
13309,Wheeler County,2021-04-23,2,1295,16.3
13309,Wheeler County,2021-04-24,1,1296,16.3
13309,Wheeler County,2021-04-26,4,1300,16.4
13309,Wheeler County,2021-04-27,2,1302,16.4
13309,Wheeler County,2021-04-28,5,1307,16.5
13309,Wheeler County,2021-04-29,4,1311,16.5
13309,Wheeler County,2021-04-30,8,1319,16.6
13309,Wheeler County,2021-05-01,1,1320,16.6
13309,Wheeler County,2021-05-02,1,1321,16.7
13309,Wheeler County,2021-05-03,7,1328,16.8
13309,Wheeler County,2021-05-04,2,1330,16.8
13309,Wheeler County,2021-05-05,4,1334,16.8
13309,Wheeler County,2021-05-06,2,1336,16.9
13309,Wheeler County,2021-05-07,3,1339,16.9
13309,Wheeler County,2021-05-08,1,1340,16.9
13309,Wheeler County,2021-05-10,2,1342,16.9
13309,Wheeler County,2021-05-11,3,1345,17
13309,Wheeler County,2021-05-12,2,1347,17
13309,Wheeler County,2021-05-13,2,1349,17
13309,Wheeler County,2021-05-14,2,1351,17
13309,Wheeler County,2021-05-15,2,1353,17.1
13309,Wheeler County,2021-05-16,1,1354,17.1
13309,Wheeler County,2021-05-17,12,1366,17.2
13309,Wheeler County,2021-05-18,6,1372,17.3
13309,Wheeler County,2021-05-19,8,1380,17.4
13309,Wheeler County,2021-05-20,10,1390,17.5
13309,Wheeler County,2021-05-21,3,1393,17.6
13309,Wheeler County,2021-05-22,3,1396,17.6
13309,Wheeler County,2021-05-23,1,1397,17.6
13309,Wheeler County,2021-05-24,6,1403,17.7
13309,Wheeler County,2021-05-25,5,1408,17.8
13309,Wheeler County,2021-05-26,4,1412,17.8
13309,Wheeler County,2021-05-27,1,1413,17.8
13309,Wheeler County,2021-05-31,1,1414,17.8
13309,Wheeler County,2021-06-01,5,1419,17.9
13309,Wheeler County,2021-06-02,6,1425,18
13309,Wheeler County,2021-06-03,3,1428,18
13309,Wheeler County,2021-06-04,3,1431,18
13309,Wheeler County,2021-06-05,2,1433,18.1
13309,Wheeler County,2021-06-06,2,1435,18.1
13309,Wheeler County,2021-06-07,1,1436,18.1
13309,Wheeler County,2021-06-08,1,1437,18.1
13309,Wheeler County,2021-06-10,4,1441,18.2
13309,Wheeler County,2021-06-11,2,1443,18.2
13309,Wheeler County,2021-06-12,2,1445,18.2
13309,Wheeler County,2021-06-14,3,1448,18.3
13309,Wheeler County,2021-06-15,7,1455,18.4
13309,Wheeler County,2021-06-16,2,1457,18.4
13309,Wheeler County,2021-06-17,1,1458,18.4
13309,Wheeler County,2021-06-19,3,1461,18.4
13309,Wheeler County,2021-06-21,2,1463,18.5
13309,Wheeler County,2021-06-22,2,1465,18.5
13309,Wheeler County,2021-06-23,2,1467,18.5
13309,Wheeler County,2021-06-24,2,1469,18.5
13309,Wheeler County,2021-06-25,1,1470,18.5
13309,Wheeler County,2021-06-26,1,1471,18.6
13309,Wheeler County,2021-06-28,1,1472,18.6
13309,Wheeler County,2021-07-01,2,1474,18.6
13309,Wheeler County,2021-07-03,1,1475,18.6
13309,Wheeler County,2021-07-06,1,1476,18.6
13309,Wheeler County,2021-07-07,1,1477,18.6
13309,Wheeler County,2021-07-08,5,1482,18.7
13309,Wheeler County,2021-07-09,4,1486,18.7
13309,Wheeler County,2021-07-10,3,1489,18.8
13309,Wheeler County,2021-07-11,2,1491,18.8
13309,Wheeler County,2021-07-12,5,1496,18.9
13309,Wheeler County,2021-07-13,8,1504,19
13309,Wheeler County,2021-07-15,2,1506,19
13309,Wheeler County,2021-07-16,2,1508,19
13309,Wheeler County,2021-07-18,1,1509,19
13309,Wheeler County,2021-07-19,5,1514,19.1
13309,Wheeler County,2021-07-20,7,1521,19.2
13309,Wheeler County,2021-07-21,8,1529,19.3
13309,Wheeler County,2021-07-22,11,1540,19.4
13309,Wheeler County,2021-07-23,5,1545,19.5
13309,Wheeler County,2021-07-24,2,1547,19.5
13309,Wheeler County,2021-07-26,6,1553,19.6
13309,Wheeler County,2021-07-27,6,1559,19.7
13309,Wheeler County,2021-07-28,13,1572,19.8
13309,Wheeler County,2021-07-29,19,1591,20.1
13309,Wheeler County,2021-07-30,6,1597,20.1
13309,Wheeler County,2021-07-31,9,1606,20.3
13309,Wheeler County,2021-08-01,2,1608,20.3
13309,Wheeler County,2021-08-02,17,1625,20.5
13309,Wheeler County,2021-08-03,15,1640,20.7
13309,Wheeler County,2021-08-04,15,1655,20.9
13309,Wheeler County,2021-08-05,13,1668,21
13309,Wheeler County,2021-08-06,8,1676,21.1
13309,Wheeler County,2021-08-07,3,1679,21.2
13309,Wheeler County,2021-08-08,7,1686,21.3
13309,Wheeler County,2021-08-09,17,1703,21.5
13309,Wheeler County,2021-08-10,10,1713,21.6
13309,Wheeler County,2021-08-11,8,1721,21.7
13309,Wheeler County,2021-08-12,7,1728,21.8
13309,Wheeler County,2021-08-13,9,1737,21.9
13309,Wheeler County,2021-08-14,3,1740,21.9
13309,Wheeler County,2021-08-15,5,1745,22
13309,Wheeler County,2021-08-16,13,1758,22.2
13309,Wheeler County,2021-08-17,16,1774,22.4
13309,Wheeler County,2021-08-18,19,1793,22.6
13309,Wheeler County,2021-08-19,16,1809,22.8
13309,Wheeler County,2021-08-20,16,1825,23
13309,Wheeler County,2021-08-21,3,1828,23.1
13309,Wheeler County,2021-08-23,4,1832,23.1
13309,Wheeler County,2021-08-24,17,1849,23.3
13309,Wheeler County,2021-08-25,26,1875,23.7
13309,Wheeler County,2021-08-26,14,1889,23.8
13309,Wheeler County,2021-08-27,7,1896,23.9
13309,Wheeler County,2021-08-28,3,1899,24
13309,Wheeler County,2021-08-29,3,1902,24
13309,Wheeler County,2021-08-30,11,1913,24.1
13309,Wheeler County,2021-08-31,11,1924,24.3
13309,Wheeler County,2021-09-01,39,1963,24.8
13309,Wheeler County,2021-09-02,15,1978,24.9
13309,Wheeler County,2021-09-03,11,1989,25.1
13309,Wheeler County,2021-09-04,1,1990,25.1
13309,Wheeler County,2021-09-05,1,1991,25.1
13309,Wheeler County,2021-09-07,5,1996,25.2
13309,Wheeler County,2021-09-08,17,2013,25.4
13309,Wheeler County,2021-09-09,7,2020,25.5
13309,Wheeler County,2021-09-10,8,2028,25.6
13309,Wheeler County,2021-09-11,6,2034,25.7
13309,Wheeler County,2021-09-13,8,2042,25.8
13309,Wheeler County,2021-09-14,12,2054,25.9
13309,Wheeler County,2021-09-15,8,2062,26
13309,Wheeler County,2021-09-16,1,2063,26
13309,Wheeler County,2021-09-17,5,2068,26.1
13309,Wheeler County,2021-09-20,5,2073,26.1
13309,Wheeler County,2021-09-21,2,2075,26.2
13309,Wheeler County,2021-09-22,8,2083,26.3
13309,Wheeler County,2021-09-23,2,2085,26.3
13309,Wheeler County,2021-09-24,7,2092,26.4
13309,Wheeler County,2021-09-25,2,2094,26.4
13309,Wheeler County,2021-09-27,4,2098,26.5
13309,Wheeler County,2021-09-28,2,2100,26.5
13309,Wheeler County,2021-09-29,9,2109,26.6
13309,Wheeler County,2021-09-30,1,2110,26.6
13309,Wheeler County,2021-10-01,2,2112,26.6
13309,Wheeler County,2021-10-02,2,2114,26.7
13309,Wheeler County,2021-10-03,1,2115,26.7
13309,Wheeler County,2021-10-04,4,2119,26.7
13309,Wheeler County,2021-10-05,1,2120,26.7
13309,Wheeler County,2021-10-06,1,2121,26.8
13309,Wheeler County,2021-10-07,1,2122,26.8
13311,White County,2020-12-16,1,1,0
13311,White County,2020-12-17,1,2,0
13311,White County,2020-12-18,9,11,0
13311,White County,2020-12-19,9,20,0.1
13311,White County,2020-12-20,3,23,0.1
13311,White County,2020-12-21,16,39,0.1
13311,White County,2020-12-22,14,53,0.2
13311,White County,2020-12-23,26,79,0.3
13311,White County,2020-12-24,7,86,0.3
13311,White County,2020-12-26,2,88,0.3
13311,White County,2020-12-27,3,91,0.3
13311,White County,2020-12-28,25,116,0.4
13311,White County,2020-12-29,41,157,0.5
13311,White County,2020-12-30,36,193,0.7
13311,White County,2020-12-31,10,203,0.7
13311,White County,2021-01-01,6,209,0.7
13311,White County,2021-01-02,4,213,0.7
13311,White County,2021-01-03,3,216,0.7
13311,White County,2021-01-04,48,264,0.9
13311,White County,2021-01-05,31,295,1
13311,White County,2021-01-06,23,318,1.1
13311,White County,2021-01-07,23,341,1.2
13311,White County,2021-01-08,53,394,1.3
13311,White County,2021-01-09,2,396,1.3
13311,White County,2021-01-10,6,402,1.4
13311,White County,2021-01-11,71,473,1.6
13311,White County,2021-01-12,82,555,1.9
13311,White County,2021-01-13,232,787,2.7
13311,White County,2021-01-14,158,945,3.2
13311,White County,2021-01-15,89,1034,3.5
13311,White County,2021-01-16,29,1063,3.6
13311,White County,2021-01-17,23,1086,3.7
13311,White County,2021-01-18,147,1233,4.2
13311,White County,2021-01-19,147,1380,4.7
13311,White County,2021-01-20,193,1573,5.3
13311,White County,2021-01-21,173,1746,5.9
13311,White County,2021-01-22,100,1846,6.3
13311,White County,2021-01-23,15,1861,6.3
13311,White County,2021-01-24,20,1881,6.4
13311,White County,2021-01-25,111,1992,6.8
13311,White County,2021-01-26,109,2101,7.1
13311,White County,2021-01-27,186,2287,7.8
13311,White County,2021-01-28,77,2364,8
13311,White County,2021-01-29,53,2417,8.2
13311,White County,2021-01-30,22,2439,8.3
13311,White County,2021-01-31,2,2441,8.3
13311,White County,2021-02-01,80,2521,8.5
13311,White County,2021-02-02,72,2593,8.8
13311,White County,2021-02-03,89,2682,9.1
13311,White County,2021-02-04,94,2776,9.4
13311,White County,2021-02-05,49,2825,9.6
13311,White County,2021-02-06,12,2837,9.6
13311,White County,2021-02-07,1,2838,9.6
13311,White County,2021-02-08,64,2902,9.8
13311,White County,2021-02-09,76,2978,10.1
13311,White County,2021-02-10,63,3041,10.3
13311,White County,2021-02-11,69,3110,10.5
13311,White County,2021-02-12,17,3127,10.6
13311,White County,2021-02-13,9,3136,10.6
13311,White County,2021-02-14,1,3137,10.6
13311,White County,2021-02-15,32,3169,10.7
13311,White County,2021-02-16,34,3203,10.9
13311,White County,2021-02-17,26,3229,10.9
13311,White County,2021-02-18,15,3244,11
13311,White County,2021-02-19,13,3257,11
13311,White County,2021-02-20,7,3264,11.1
13311,White County,2021-02-21,1,3265,11.1
13311,White County,2021-02-22,55,3320,11.3
13311,White County,2021-02-23,521,3841,13
13311,White County,2021-02-24,97,3938,13.4
13311,White County,2021-02-25,40,3978,13.5
13311,White County,2021-02-26,89,4067,13.8
13311,White County,2021-02-27,32,4099,13.9
13311,White County,2021-02-28,22,4121,14
13311,White County,2021-03-01,105,4226,14.3
13311,White County,2021-03-02,108,4334,14.7
13311,White County,2021-03-03,138,4472,15.2
13311,White County,2021-03-04,79,4551,15.4
13311,White County,2021-03-05,71,4622,15.7
13311,White County,2021-03-06,13,4635,15.7
13311,White County,2021-03-07,19,4654,15.8
13311,White County,2021-03-08,75,4729,16
13311,White County,2021-03-09,92,4821,16.3
13311,White County,2021-03-10,116,4937,16.7
13311,White County,2021-03-11,271,5208,17.7
13311,White County,2021-03-12,105,5313,18
13311,White County,2021-03-13,20,5333,18.1
13311,White County,2021-03-14,15,5348,18.1
13311,White County,2021-03-15,138,5486,18.6
13311,White County,2021-03-16,92,5578,18.9
13311,White County,2021-03-17,123,5701,19.3
13311,White County,2021-03-18,126,5827,19.8
13311,White County,2021-03-19,125,5952,20.2
13311,White County,2021-03-20,16,5968,20.2
13311,White County,2021-03-21,18,5986,20.3
13311,White County,2021-03-22,98,6084,20.6
13311,White County,2021-03-23,94,6178,21
13311,White County,2021-03-24,222,6400,21.7
13311,White County,2021-03-25,153,6553,22.2
13311,White County,2021-03-26,117,6670,22.6
13311,White County,2021-03-27,95,6765,22.9
13311,White County,2021-03-28,16,6781,23
13311,White County,2021-03-29,87,6868,23.3
13311,White County,2021-03-30,129,6997,23.7
13311,White County,2021-03-31,129,7126,24.2
13311,White County,2021-04-01,93,7219,24.5
13311,White County,2021-04-02,77,7296,24.7
13311,White County,2021-04-03,8,7304,24.8
13311,White County,2021-04-04,13,7317,24.8
13311,White County,2021-04-05,82,7399,25.1
13311,White County,2021-04-06,83,7482,25.4
13311,White County,2021-04-07,90,7572,25.7
13311,White County,2021-04-08,105,7677,26
13311,White County,2021-04-09,75,7752,26.3
13311,White County,2021-04-10,18,7770,26.3
13311,White County,2021-04-11,16,7786,26.4
13311,White County,2021-04-12,46,7832,26.6
13311,White County,2021-04-13,42,7874,26.7
13311,White County,2021-04-14,37,7911,26.8
13311,White County,2021-04-15,50,7961,27
13311,White County,2021-04-16,53,8014,27.2
13311,White County,2021-04-17,28,8042,27.3
13311,White County,2021-04-18,3,8045,27.3
13311,White County,2021-04-19,24,8069,27.4
13311,White County,2021-04-20,28,8097,27.5
13311,White County,2021-04-21,27,8124,27.5
13311,White County,2021-04-22,34,8158,27.7
13311,White County,2021-04-23,37,8195,27.8
13311,White County,2021-04-24,21,8216,27.9
13311,White County,2021-04-25,3,8219,27.9
13311,White County,2021-04-26,19,8238,27.9
13311,White County,2021-04-27,51,8289,28.1
13311,White County,2021-04-28,24,8313,28.2
13311,White County,2021-04-29,36,8349,28.3
13311,White County,2021-04-30,43,8392,28.5
13311,White County,2021-05-01,14,8406,28.5
13311,White County,2021-05-02,2,8408,28.5
13311,White County,2021-05-03,12,8420,28.6
13311,White County,2021-05-04,27,8447,28.6
13311,White County,2021-05-05,32,8479,28.8
13311,White County,2021-05-06,31,8510,28.9
13311,White County,2021-05-07,32,8542,29
13311,White County,2021-05-08,9,8551,29
13311,White County,2021-05-09,5,8556,29
13311,White County,2021-05-10,20,8576,29.1
13311,White County,2021-05-11,34,8610,29.2
13311,White County,2021-05-12,34,8644,29.3
13311,White County,2021-05-13,17,8661,29.4
13311,White County,2021-05-14,52,8713,29.5
13311,White County,2021-05-15,22,8735,29.6
13311,White County,2021-05-16,17,8752,29.7
13311,White County,2021-05-17,28,8780,29.8
13311,White County,2021-05-18,46,8826,29.9
13311,White County,2021-05-19,24,8850,30
13311,White County,2021-05-20,32,8882,30.1
13311,White County,2021-05-21,27,8909,30.2
13311,White County,2021-05-22,33,8942,30.3
13311,White County,2021-05-23,11,8953,30.4
13311,White County,2021-05-24,15,8968,30.4
13311,White County,2021-05-25,29,8997,30.5
13311,White County,2021-05-26,16,9013,30.6
13311,White County,2021-05-27,26,9039,30.7
13311,White County,2021-05-28,29,9068,30.8
13311,White County,2021-05-29,15,9083,30.8
13311,White County,2021-05-30,7,9090,30.8
13311,White County,2021-05-31,3,9093,30.8
13311,White County,2021-06-01,11,9104,30.9
13311,White County,2021-06-02,15,9119,30.9
13311,White County,2021-06-03,24,9143,31
13311,White County,2021-06-04,13,9156,31
13311,White County,2021-06-05,10,9166,31.1
13311,White County,2021-06-06,4,9170,31.1
13311,White County,2021-06-07,8,9178,31.1
13311,White County,2021-06-08,19,9197,31.2
13311,White County,2021-06-09,18,9215,31.2
13311,White County,2021-06-10,20,9235,31.3
13311,White County,2021-06-11,12,9247,31.4
13311,White County,2021-06-12,11,9258,31.4
13311,White County,2021-06-13,1,9259,31.4
13311,White County,2021-06-14,16,9275,31.5
13311,White County,2021-06-15,20,9295,31.5
13311,White County,2021-06-16,15,9310,31.6
13311,White County,2021-06-17,8,9318,31.6
13311,White County,2021-06-18,5,9323,31.6
13311,White County,2021-06-19,7,9330,31.6
13311,White County,2021-06-20,3,9333,31.6
13311,White County,2021-06-21,12,9345,31.7
13311,White County,2021-06-22,19,9364,31.8
13311,White County,2021-06-23,15,9379,31.8
13311,White County,2021-06-24,9,9388,31.8
13311,White County,2021-06-25,17,9405,31.9
13311,White County,2021-06-27,5,9410,31.9
13311,White County,2021-06-28,9,9419,31.9
13311,White County,2021-06-29,13,9432,32
13311,White County,2021-06-30,10,9442,32
13311,White County,2021-07-01,6,9448,32
13311,White County,2021-07-02,10,9458,32.1
13311,White County,2021-07-03,2,9460,32.1
13311,White County,2021-07-05,5,9465,32.1
13311,White County,2021-07-06,5,9470,32.1
13311,White County,2021-07-07,5,9475,32.1
13311,White County,2021-07-08,8,9483,32.2
13311,White County,2021-07-09,21,9504,32.2
13311,White County,2021-07-10,9,9513,32.3
13311,White County,2021-07-11,5,9518,32.3
13311,White County,2021-07-12,10,9528,32.3
13311,White County,2021-07-13,9,9537,32.3
13311,White County,2021-07-14,8,9545,32.4
13311,White County,2021-07-15,8,9553,32.4
13311,White County,2021-07-16,17,9570,32.5
13311,White County,2021-07-17,5,9575,32.5
13311,White County,2021-07-18,7,9582,32.5
13311,White County,2021-07-19,17,9599,32.6
13311,White County,2021-07-20,17,9616,32.6
13311,White County,2021-07-21,16,9632,32.7
13311,White County,2021-07-22,17,9649,32.7
13311,White County,2021-07-23,31,9680,32.8
13311,White County,2021-07-24,11,9691,32.9
13311,White County,2021-07-25,12,9703,32.9
13311,White County,2021-07-26,15,9718,33
13311,White County,2021-07-27,24,9742,33
13311,White County,2021-07-28,27,9769,33.1
13311,White County,2021-07-29,30,9799,33.2
13311,White County,2021-07-30,33,9832,33.3
13311,White County,2021-07-31,17,9849,33.4
13311,White County,2021-08-01,11,9860,33.4
13311,White County,2021-08-02,31,9891,33.5
13311,White County,2021-08-03,39,9930,33.7
13311,White County,2021-08-04,50,9980,33.8
13311,White County,2021-08-05,51,10031,34
13311,White County,2021-08-06,56,10087,34.2
13311,White County,2021-08-07,25,10112,34.3
13311,White County,2021-08-08,17,10129,34.3
13311,White County,2021-08-09,35,10164,34.5
13311,White County,2021-08-10,38,10202,34.6
13311,White County,2021-08-11,35,10237,34.7
13311,White County,2021-08-12,40,10277,34.9
13311,White County,2021-08-13,59,10336,35.1
13311,White County,2021-08-14,33,10369,35.2
13311,White County,2021-08-15,17,10386,35.2
13311,White County,2021-08-16,39,10425,35.4
13311,White County,2021-08-17,45,10470,35.5
13311,White County,2021-08-18,39,10509,35.6
13311,White County,2021-08-19,37,10546,35.8
13311,White County,2021-08-20,45,10591,35.9
13311,White County,2021-08-21,29,10620,36
13311,White County,2021-08-22,17,10637,36.1
13311,White County,2021-08-23,42,10679,36.2
13311,White County,2021-08-24,35,10714,36.3
13311,White County,2021-08-25,54,10768,36.5
13311,White County,2021-08-26,58,10826,36.7
13311,White County,2021-08-27,87,10913,37
13311,White County,2021-08-28,40,10953,37.1
13311,White County,2021-08-29,19,10972,37.2
13311,White County,2021-08-30,64,11036,37.4
13311,White County,2021-08-31,53,11089,37.6
13311,White County,2021-09-01,61,11150,37.8
13311,White County,2021-09-02,43,11193,38
13311,White County,2021-09-03,57,11250,38.1
13311,White County,2021-09-04,17,11267,38.2
13311,White County,2021-09-05,17,11284,38.3
13311,White County,2021-09-06,11,11295,38.3
13311,White County,2021-09-07,30,11325,38.4
13311,White County,2021-09-08,49,11374,38.6
13311,White County,2021-09-09,52,11426,38.7
13311,White County,2021-09-10,50,11476,38.9
13311,White County,2021-09-11,22,11498,39
13311,White County,2021-09-12,15,11513,39
13311,White County,2021-09-13,37,11550,39.2
13311,White County,2021-09-14,22,11572,39.2
13311,White County,2021-09-15,25,11597,39.3
13311,White County,2021-09-16,12,11609,39.4
13311,White County,2021-09-17,19,11628,39.4
13311,White County,2021-09-18,11,11639,39.5
13311,White County,2021-09-19,6,11645,39.5
13311,White County,2021-09-20,15,11660,39.5
13311,White County,2021-09-21,23,11683,39.6
13311,White County,2021-09-22,19,11702,39.7
13311,White County,2021-09-23,18,11720,39.7
13311,White County,2021-09-24,20,11740,39.8
13311,White County,2021-09-25,14,11754,39.9
13311,White County,2021-09-26,5,11759,39.9
13311,White County,2021-09-27,8,11767,39.9
13311,White County,2021-09-28,11,11778,39.9
13311,White County,2021-09-29,13,11791,40
13311,White County,2021-09-30,8,11799,40
13311,White County,2021-10-01,3,11802,40
13311,White County,2021-10-02,3,11805,40
13311,White County,2021-10-03,2,11807,40
13311,White County,2021-10-04,5,11812,40.1
13311,White County,2021-10-05,4,11816,40.1
13311,White County,2021-10-06,12,11828,40.1
13311,White County,2021-10-07,4,11832,40.1
13313,Whitfield County,2020-12-16,1,1,0
13313,Whitfield County,2020-12-17,19,20,0
13313,Whitfield County,2020-12-18,111,131,0.1
13313,Whitfield County,2020-12-20,24,155,0.1
13313,Whitfield County,2020-12-21,161,316,0.3
13313,Whitfield County,2020-12-22,237,553,0.5
13313,Whitfield County,2020-12-23,89,642,0.6
13313,Whitfield County,2020-12-24,20,662,0.6
13313,Whitfield County,2020-12-25,1,663,0.6
13313,Whitfield County,2020-12-26,1,664,0.6
13313,Whitfield County,2020-12-27,3,667,0.6
13313,Whitfield County,2020-12-28,144,811,0.8
13313,Whitfield County,2020-12-29,83,894,0.9
13313,Whitfield County,2020-12-30,81,975,0.9
13313,Whitfield County,2020-12-31,61,1036,1
13313,Whitfield County,2021-01-01,13,1049,1
13313,Whitfield County,2021-01-02,1,1050,1
13313,Whitfield County,2021-01-03,18,1068,1
13313,Whitfield County,2021-01-04,134,1202,1.2
13313,Whitfield County,2021-01-05,438,1640,1.6
13313,Whitfield County,2021-01-06,498,2138,2.1
13313,Whitfield County,2021-01-07,591,2729,2.6
13313,Whitfield County,2021-01-08,219,2948,2.8
13313,Whitfield County,2021-01-09,5,2953,2.8
13313,Whitfield County,2021-01-10,6,2959,2.8
13313,Whitfield County,2021-01-11,507,3466,3.3
13313,Whitfield County,2021-01-12,709,4175,4
13313,Whitfield County,2021-01-13,581,4756,4.6
13313,Whitfield County,2021-01-14,598,5354,5.1
13313,Whitfield County,2021-01-15,400,5754,5.5
13313,Whitfield County,2021-01-16,32,5786,5.6
13313,Whitfield County,2021-01-17,16,5802,5.6
13313,Whitfield County,2021-01-18,940,6742,6.5
13313,Whitfield County,2021-01-19,443,7185,6.9
13313,Whitfield County,2021-01-20,740,7925,7.6
13313,Whitfield County,2021-01-21,241,8166,7.8
13313,Whitfield County,2021-01-22,129,8295,8
13313,Whitfield County,2021-01-23,24,8319,8
13313,Whitfield County,2021-01-24,9,8328,8
13313,Whitfield County,2021-01-25,168,8496,8.2
13313,Whitfield County,2021-01-26,346,8842,8.5
13313,Whitfield County,2021-01-27,220,9062,8.7
13313,Whitfield County,2021-01-28,174,9236,8.9
13313,Whitfield County,2021-01-29,177,9413,9
13313,Whitfield County,2021-01-30,15,9428,9
13313,Whitfield County,2021-01-31,9,9437,9.1
13313,Whitfield County,2021-02-01,140,9577,9.2
13313,Whitfield County,2021-02-02,261,9838,9.4
13313,Whitfield County,2021-02-03,1018,10856,10.4
13313,Whitfield County,2021-02-04,853,11709,11.2
13313,Whitfield County,2021-02-05,108,11817,11.3
13313,Whitfield County,2021-02-06,1,11818,11.3
13313,Whitfield County,2021-02-07,1,11819,11.3
13313,Whitfield County,2021-02-08,65,11884,11.4
13313,Whitfield County,2021-02-09,111,11995,11.5
13313,Whitfield County,2021-02-10,289,12284,11.8
13313,Whitfield County,2021-02-11,91,12375,11.9
13313,Whitfield County,2021-02-12,71,12446,11.9
13313,Whitfield County,2021-02-13,6,12452,11.9
13313,Whitfield County,2021-02-14,7,12459,12
13313,Whitfield County,2021-02-15,139,12598,12.1
13313,Whitfield County,2021-02-16,159,12757,12.2
13313,Whitfield County,2021-02-17,39,12796,12.3
13313,Whitfield County,2021-02-18,24,12820,12.3
13313,Whitfield County,2021-02-19,47,12867,12.3
13313,Whitfield County,2021-02-20,10,12877,12.4
13313,Whitfield County,2021-02-21,5,12882,12.4
13313,Whitfield County,2021-02-22,63,12945,12.4
13313,Whitfield County,2021-02-23,50,12995,12.5
13313,Whitfield County,2021-02-24,109,13104,12.6
13313,Whitfield County,2021-02-25,200,13304,12.8
13313,Whitfield County,2021-02-26,101,13405,12.9
13313,Whitfield County,2021-02-27,36,13441,12.9
13313,Whitfield County,2021-02-28,28,13469,12.9
13313,Whitfield County,2021-03-01,148,13617,13.1
13313,Whitfield County,2021-03-02,229,13846,13.3
13313,Whitfield County,2021-03-03,190,14036,13.5
13313,Whitfield County,2021-03-04,146,14182,13.6
13313,Whitfield County,2021-03-05,157,14339,13.8
13313,Whitfield County,2021-03-06,5,14344,13.8
13313,Whitfield County,2021-03-07,41,14385,13.8
13313,Whitfield County,2021-03-08,260,14645,14
13313,Whitfield County,2021-03-09,340,14985,14.4
13313,Whitfield County,2021-03-10,500,15485,14.9
13313,Whitfield County,2021-03-11,540,16025,15.4
13313,Whitfield County,2021-03-12,458,16483,15.8
13313,Whitfield County,2021-03-13,63,16546,15.9
13313,Whitfield County,2021-03-14,46,16592,15.9
13313,Whitfield County,2021-03-15,538,17130,16.4
13313,Whitfield County,2021-03-16,625,17755,17
13313,Whitfield County,2021-03-17,473,18228,17.5
13313,Whitfield County,2021-03-18,382,18610,17.9
13313,Whitfield County,2021-03-19,373,18983,18.2
13313,Whitfield County,2021-03-20,59,19042,18.3
13313,Whitfield County,2021-03-21,63,19105,18.3
13313,Whitfield County,2021-03-22,746,19851,19
13313,Whitfield County,2021-03-23,300,20151,19.3
13313,Whitfield County,2021-03-24,877,21028,20.2
13313,Whitfield County,2021-03-25,765,21793,20.9
13313,Whitfield County,2021-03-26,699,22492,21.6
13313,Whitfield County,2021-03-27,95,22587,21.7
13313,Whitfield County,2021-03-28,124,22711,21.8
13313,Whitfield County,2021-03-29,565,23276,22.3
13313,Whitfield County,2021-03-30,734,24010,23
13313,Whitfield County,2021-03-31,669,24679,23.7
13313,Whitfield County,2021-04-01,605,25284,24.3
13313,Whitfield County,2021-04-02,589,25873,24.8
13313,Whitfield County,2021-04-03,154,26027,25
13313,Whitfield County,2021-04-04,100,26127,25.1
13313,Whitfield County,2021-04-05,407,26534,25.5
13313,Whitfield County,2021-04-06,485,27019,25.9
13313,Whitfield County,2021-04-07,414,27433,26.3
13313,Whitfield County,2021-04-08,392,27825,26.7
13313,Whitfield County,2021-04-09,391,28216,27.1
13313,Whitfield County,2021-04-10,137,28353,27.2
13313,Whitfield County,2021-04-11,83,28436,27.3
13313,Whitfield County,2021-04-12,269,28705,27.5
13313,Whitfield County,2021-04-13,231,28936,27.8
13313,Whitfield County,2021-04-14,326,29262,28.1
13313,Whitfield County,2021-04-15,306,29568,28.4
13313,Whitfield County,2021-04-16,334,29902,28.7
13313,Whitfield County,2021-04-17,477,30379,29.1
13313,Whitfield County,2021-04-18,35,30414,29.2
13313,Whitfield County,2021-04-19,184,30598,29.4
13313,Whitfield County,2021-04-20,163,30761,29.5
13313,Whitfield County,2021-04-21,355,31116,29.9
13313,Whitfield County,2021-04-22,175,31291,30
13313,Whitfield County,2021-04-23,177,31468,30.2
13313,Whitfield County,2021-04-24,53,31521,30.2
13313,Whitfield County,2021-04-25,24,31545,30.3
13313,Whitfield County,2021-04-26,119,31664,30.4
13313,Whitfield County,2021-04-27,143,31807,30.5
13313,Whitfield County,2021-04-28,154,31961,30.7
13313,Whitfield County,2021-04-29,110,32071,30.8
13313,Whitfield County,2021-04-30,201,32272,31
13313,Whitfield County,2021-05-01,120,32392,31.1
13313,Whitfield County,2021-05-02,28,32420,31.1
13313,Whitfield County,2021-05-03,101,32521,31.2
13313,Whitfield County,2021-05-04,319,32840,31.5
13313,Whitfield County,2021-05-05,199,33039,31.7
13313,Whitfield County,2021-05-06,173,33212,31.9
13313,Whitfield County,2021-05-07,133,33345,32
13313,Whitfield County,2021-05-08,55,33400,32
13313,Whitfield County,2021-05-09,14,33414,32.1
13313,Whitfield County,2021-05-10,52,33466,32.1
13313,Whitfield County,2021-05-11,198,33664,32.3
13313,Whitfield County,2021-05-12,86,33750,32.4
13313,Whitfield County,2021-05-13,110,33860,32.5
13313,Whitfield County,2021-05-14,156,34016,32.6
13313,Whitfield County,2021-05-15,84,34100,32.7
13313,Whitfield County,2021-05-16,60,34160,32.8
13313,Whitfield County,2021-05-17,134,34294,32.9
13313,Whitfield County,2021-05-18,146,34440,33
13313,Whitfield County,2021-05-19,150,34590,33.2
13313,Whitfield County,2021-05-20,144,34734,33.3
13313,Whitfield County,2021-05-21,128,34862,33.4
13313,Whitfield County,2021-05-22,85,34947,33.5
13313,Whitfield County,2021-05-23,31,34978,33.6
13313,Whitfield County,2021-05-24,111,35089,33.7
13313,Whitfield County,2021-05-25,208,35297,33.9
13313,Whitfield County,2021-05-26,74,35371,33.9
13313,Whitfield County,2021-05-27,104,35475,34
13313,Whitfield County,2021-05-28,78,35553,34.1
13313,Whitfield County,2021-05-29,51,35604,34.2
13313,Whitfield County,2021-05-30,36,35640,34.2
13313,Whitfield County,2021-05-31,8,35648,34.2
13313,Whitfield County,2021-06-01,164,35812,34.4
13313,Whitfield County,2021-06-02,88,35900,34.4
13313,Whitfield County,2021-06-03,75,35975,34.5
13313,Whitfield County,2021-06-04,83,36058,34.6
13313,Whitfield County,2021-06-05,38,36096,34.6
13313,Whitfield County,2021-06-06,25,36121,34.7
13313,Whitfield County,2021-06-07,71,36192,34.7
13313,Whitfield County,2021-06-08,89,36281,34.8
13313,Whitfield County,2021-06-09,75,36356,34.9
13313,Whitfield County,2021-06-10,69,36425,34.9
13313,Whitfield County,2021-06-11,84,36509,35
13313,Whitfield County,2021-06-12,60,36569,35.1
13313,Whitfield County,2021-06-13,12,36581,35.1
13313,Whitfield County,2021-06-14,90,36671,35.2
13313,Whitfield County,2021-06-15,52,36723,35.2
13313,Whitfield County,2021-06-16,67,36790,35.3
13313,Whitfield County,2021-06-17,63,36853,35.4
13313,Whitfield County,2021-06-18,78,36931,35.4
13313,Whitfield County,2021-06-19,24,36955,35.5
13313,Whitfield County,2021-06-20,17,36972,35.5
13313,Whitfield County,2021-06-21,50,37022,35.5
13313,Whitfield County,2021-06-22,67,37089,35.6
13313,Whitfield County,2021-06-23,60,37149,35.6
13313,Whitfield County,2021-06-24,54,37203,35.7
13313,Whitfield County,2021-06-25,73,37276,35.8
13313,Whitfield County,2021-06-26,53,37329,35.8
13313,Whitfield County,2021-06-27,11,37340,35.8
13313,Whitfield County,2021-06-28,35,37375,35.9
13313,Whitfield County,2021-06-29,39,37414,35.9
13313,Whitfield County,2021-06-30,50,37464,35.9
13313,Whitfield County,2021-07-01,43,37507,36
13313,Whitfield County,2021-07-02,67,37574,36
13313,Whitfield County,2021-07-03,37,37611,36.1
13313,Whitfield County,2021-07-04,5,37616,36.1
13313,Whitfield County,2021-07-05,38,37654,36.1
13313,Whitfield County,2021-07-06,56,37710,36.2
13313,Whitfield County,2021-07-07,63,37773,36.2
13313,Whitfield County,2021-07-08,57,37830,36.3
13313,Whitfield County,2021-07-09,60,37890,36.3
13313,Whitfield County,2021-07-10,35,37925,36.4
13313,Whitfield County,2021-07-11,26,37951,36.4
13313,Whitfield County,2021-07-12,49,38000,36.5
13313,Whitfield County,2021-07-13,46,38046,36.5
13313,Whitfield County,2021-07-14,54,38100,36.6
13313,Whitfield County,2021-07-15,52,38152,36.6
13313,Whitfield County,2021-07-16,57,38209,36.7
13313,Whitfield County,2021-07-17,42,38251,36.7
13313,Whitfield County,2021-07-18,33,38284,36.7
13313,Whitfield County,2021-07-19,56,38340,36.8
13313,Whitfield County,2021-07-20,73,38413,36.9
13313,Whitfield County,2021-07-21,86,38499,36.9
13313,Whitfield County,2021-07-22,113,38612,37
13313,Whitfield County,2021-07-23,127,38739,37.2
13313,Whitfield County,2021-07-24,79,38818,37.2
13313,Whitfield County,2021-07-25,30,38848,37.3
13313,Whitfield County,2021-07-26,110,38958,37.4
13313,Whitfield County,2021-07-27,106,39064,37.5
13313,Whitfield County,2021-07-28,162,39226,37.6
13313,Whitfield County,2021-07-29,197,39423,37.8
13313,Whitfield County,2021-07-30,167,39590,38
13313,Whitfield County,2021-07-31,131,39721,38.1
13313,Whitfield County,2021-08-01,57,39778,38.2
13313,Whitfield County,2021-08-02,145,39923,38.3
13313,Whitfield County,2021-08-03,167,40090,38.5
13313,Whitfield County,2021-08-04,243,40333,38.7
13313,Whitfield County,2021-08-05,161,40494,38.8
13313,Whitfield County,2021-08-06,132,40626,39
13313,Whitfield County,2021-08-07,147,40773,39.1
13313,Whitfield County,2021-08-08,75,40848,39.2
13313,Whitfield County,2021-08-09,164,41012,39.3
13313,Whitfield County,2021-08-10,180,41192,39.5
13313,Whitfield County,2021-08-11,143,41335,39.7
13313,Whitfield County,2021-08-12,183,41518,39.8
13313,Whitfield County,2021-08-13,223,41741,40
13313,Whitfield County,2021-08-14,161,41902,40.2
13313,Whitfield County,2021-08-15,79,41981,40.3
13313,Whitfield County,2021-08-16,175,42156,40.4
13313,Whitfield County,2021-08-17,255,42411,40.7
13313,Whitfield County,2021-08-18,211,42622,40.9
13313,Whitfield County,2021-08-19,364,42986,41.2
13313,Whitfield County,2021-08-20,279,43265,41.5
13313,Whitfield County,2021-08-21,132,43397,41.6
13313,Whitfield County,2021-08-22,91,43488,41.7
13313,Whitfield County,2021-08-23,137,43625,41.9
13313,Whitfield County,2021-08-24,154,43779,42
13313,Whitfield County,2021-08-25,155,43934,42.1
13313,Whitfield County,2021-08-26,157,44091,42.3
13313,Whitfield County,2021-08-27,196,44287,42.5
13313,Whitfield County,2021-08-28,130,44417,42.6
13313,Whitfield County,2021-08-29,69,44486,42.7
13313,Whitfield County,2021-08-30,110,44596,42.8
13313,Whitfield County,2021-08-31,141,44737,42.9
13313,Whitfield County,2021-09-01,154,44891,43.1
13313,Whitfield County,2021-09-02,137,45028,43.2
13313,Whitfield County,2021-09-03,173,45201,43.4
13313,Whitfield County,2021-09-04,124,45325,43.5
13313,Whitfield County,2021-09-05,48,45373,43.5
13313,Whitfield County,2021-09-06,19,45392,43.5
13313,Whitfield County,2021-09-07,134,45526,43.7
13313,Whitfield County,2021-09-08,132,45658,43.8
13313,Whitfield County,2021-09-09,144,45802,43.9
13313,Whitfield County,2021-09-10,158,45960,44.1
13313,Whitfield County,2021-09-11,107,46067,44.2
13313,Whitfield County,2021-09-12,60,46127,44.3
13313,Whitfield County,2021-09-13,86,46213,44.3
13313,Whitfield County,2021-09-14,133,46346,44.5
13313,Whitfield County,2021-09-15,119,46465,44.6
13313,Whitfield County,2021-09-16,78,46543,44.7
13313,Whitfield County,2021-09-17,102,46645,44.7
13313,Whitfield County,2021-09-18,58,46703,44.8
13313,Whitfield County,2021-09-19,29,46732,44.8
13313,Whitfield County,2021-09-20,64,46796,44.9
13313,Whitfield County,2021-09-21,67,46863,45
13313,Whitfield County,2021-09-22,66,46929,45
13313,Whitfield County,2021-09-23,56,46985,45.1
13313,Whitfield County,2021-09-24,58,47043,45.1
13313,Whitfield County,2021-09-25,36,47079,45.2
13313,Whitfield County,2021-09-26,25,47104,45.2
13313,Whitfield County,2021-09-27,57,47161,45.2
13313,Whitfield County,2021-09-28,47,47208,45.3
13313,Whitfield County,2021-09-29,44,47252,45.3
13313,Whitfield County,2021-09-30,53,47305,45.4
13313,Whitfield County,2021-10-01,52,47357,45.4
13313,Whitfield County,2021-10-02,26,47383,45.5
13313,Whitfield County,2021-10-03,11,47394,45.5
13313,Whitfield County,2021-10-04,13,47407,45.5
13313,Whitfield County,2021-10-05,12,47419,45.5
13313,Whitfield County,2021-10-06,30,47449,45.5
13313,Whitfield County,2021-10-07,12,47461,45.5
13315,Wilcox County,2020-12-16,1,1,0
13315,Wilcox County,2020-12-21,1,2,0
13315,Wilcox County,2020-12-22,1,3,0
13315,Wilcox County,2020-12-23,5,8,0.1
13315,Wilcox County,2020-12-24,4,12,0.1
13315,Wilcox County,2020-12-26,1,13,0.1
13315,Wilcox County,2020-12-28,6,19,0.2
13315,Wilcox County,2020-12-29,6,25,0.3
13315,Wilcox County,2020-12-30,8,33,0.4
13315,Wilcox County,2020-12-31,5,38,0.4
13315,Wilcox County,2021-01-03,1,39,0.4
13315,Wilcox County,2021-01-04,12,51,0.6
13315,Wilcox County,2021-01-05,44,95,1.1
13315,Wilcox County,2021-01-06,23,118,1.3
13315,Wilcox County,2021-01-07,33,151,1.7
13315,Wilcox County,2021-01-08,11,162,1.8
13315,Wilcox County,2021-01-09,2,164,1.9
13315,Wilcox County,2021-01-11,28,192,2.2
13315,Wilcox County,2021-01-12,46,238,2.7
13315,Wilcox County,2021-01-13,40,278,3.2
13315,Wilcox County,2021-01-14,98,376,4.3
13315,Wilcox County,2021-01-15,28,404,4.6
13315,Wilcox County,2021-01-16,3,407,4.6
13315,Wilcox County,2021-01-18,13,420,4.8
13315,Wilcox County,2021-01-19,32,452,5.1
13315,Wilcox County,2021-01-20,52,504,5.7
13315,Wilcox County,2021-01-21,122,626,7.1
13315,Wilcox County,2021-01-22,3,629,7.1
13315,Wilcox County,2021-01-25,6,635,7.2
13315,Wilcox County,2021-01-26,8,643,7.3
13315,Wilcox County,2021-01-27,8,651,7.4
13315,Wilcox County,2021-01-28,125,776,8.8
13315,Wilcox County,2021-01-29,2,778,8.8
13315,Wilcox County,2021-01-30,4,782,8.9
13315,Wilcox County,2021-01-31,1,783,8.9
13315,Wilcox County,2021-02-01,3,786,8.9
13315,Wilcox County,2021-02-02,1,787,8.9
13315,Wilcox County,2021-02-03,17,804,9.1
13315,Wilcox County,2021-02-04,79,883,10
13315,Wilcox County,2021-02-05,1,884,10
13315,Wilcox County,2021-02-07,1,885,10
13315,Wilcox County,2021-02-08,3,888,10.1
13315,Wilcox County,2021-02-09,11,899,10.2
13315,Wilcox County,2021-02-10,5,904,10.2
13315,Wilcox County,2021-02-11,16,920,10.4
13315,Wilcox County,2021-02-12,10,930,10.5
13315,Wilcox County,2021-02-13,2,932,10.6
13315,Wilcox County,2021-02-14,2,934,10.6
13315,Wilcox County,2021-02-15,4,938,10.6
13315,Wilcox County,2021-02-16,6,944,10.7
13315,Wilcox County,2021-02-17,23,967,11
13315,Wilcox County,2021-02-18,14,981,11.1
13315,Wilcox County,2021-02-19,5,986,11.2
13315,Wilcox County,2021-02-20,3,989,11.2
13315,Wilcox County,2021-02-22,6,995,11.3
13315,Wilcox County,2021-02-23,2,997,11.3
13315,Wilcox County,2021-02-24,3,1000,11.3
13315,Wilcox County,2021-02-25,26,1026,11.6
13315,Wilcox County,2021-02-26,1,1027,11.6
13315,Wilcox County,2021-03-01,6,1033,11.7
13315,Wilcox County,2021-03-02,4,1037,11.8
13315,Wilcox County,2021-03-04,83,1120,12.7
13315,Wilcox County,2021-03-05,6,1126,12.8
13315,Wilcox County,2021-03-07,1,1127,12.8
13315,Wilcox County,2021-03-08,63,1190,13.5
13315,Wilcox County,2021-03-09,9,1199,13.6
13315,Wilcox County,2021-03-10,21,1220,13.8
13315,Wilcox County,2021-03-11,36,1256,14.2
13315,Wilcox County,2021-03-12,17,1273,14.4
13315,Wilcox County,2021-03-13,2,1275,14.4
13315,Wilcox County,2021-03-14,5,1280,14.5
13315,Wilcox County,2021-03-15,21,1301,14.7
13315,Wilcox County,2021-03-16,24,1325,15
13315,Wilcox County,2021-03-17,57,1382,15.7
13315,Wilcox County,2021-03-18,82,1464,16.6
13315,Wilcox County,2021-03-19,17,1481,16.8
13315,Wilcox County,2021-03-20,3,1484,16.8
13315,Wilcox County,2021-03-21,2,1486,16.8
13315,Wilcox County,2021-03-22,12,1498,17
13315,Wilcox County,2021-03-23,38,1536,17.4
13315,Wilcox County,2021-03-24,77,1613,18.3
13315,Wilcox County,2021-03-25,31,1644,18.6
13315,Wilcox County,2021-03-26,27,1671,18.9
13315,Wilcox County,2021-03-27,1,1672,18.9
13315,Wilcox County,2021-03-29,19,1691,19.2
13315,Wilcox County,2021-03-30,22,1713,19.4
13315,Wilcox County,2021-03-31,70,1783,20.2
13315,Wilcox County,2021-04-01,27,1810,20.5
13315,Wilcox County,2021-04-02,17,1827,20.7
13315,Wilcox County,2021-04-03,3,1830,20.7
13315,Wilcox County,2021-04-04,2,1832,20.8
13315,Wilcox County,2021-04-05,18,1850,21
13315,Wilcox County,2021-04-06,17,1867,21.2
13315,Wilcox County,2021-04-07,42,1909,21.6
13315,Wilcox County,2021-04-08,53,1962,22.2
13315,Wilcox County,2021-04-09,6,1968,22.3
13315,Wilcox County,2021-04-10,5,1973,22.4
13315,Wilcox County,2021-04-12,7,1980,22.4
13315,Wilcox County,2021-04-13,5,1985,22.5
13315,Wilcox County,2021-04-14,32,2017,22.9
13315,Wilcox County,2021-04-15,12,2029,23
13315,Wilcox County,2021-04-16,3,2032,23
13315,Wilcox County,2021-04-17,5,2037,23.1
13315,Wilcox County,2021-04-19,7,2044,23.2
13315,Wilcox County,2021-04-20,10,2054,23.3
13315,Wilcox County,2021-04-21,30,2084,23.6
13315,Wilcox County,2021-04-22,15,2099,23.8
13315,Wilcox County,2021-04-23,10,2109,23.9
13315,Wilcox County,2021-04-24,2,2111,23.9
13315,Wilcox County,2021-04-25,2,2113,23.9
13315,Wilcox County,2021-04-26,10,2123,24.1
13315,Wilcox County,2021-04-27,2,2125,24.1
13315,Wilcox County,2021-04-28,16,2141,24.3
13315,Wilcox County,2021-04-29,15,2156,24.4
13315,Wilcox County,2021-04-30,9,2165,24.5
13315,Wilcox County,2021-05-01,1,2166,24.5
13315,Wilcox County,2021-05-02,2,2168,24.6
13315,Wilcox County,2021-05-03,7,2175,24.6
13315,Wilcox County,2021-05-04,11,2186,24.8
13315,Wilcox County,2021-05-05,22,2208,25
13315,Wilcox County,2021-05-06,6,2214,25.1
13315,Wilcox County,2021-05-07,11,2225,25.2
13315,Wilcox County,2021-05-08,3,2228,25.2
13315,Wilcox County,2021-05-10,1,2229,25.3
13315,Wilcox County,2021-05-11,4,2233,25.3
13315,Wilcox County,2021-05-12,17,2250,25.5
13315,Wilcox County,2021-05-13,5,2255,25.6
13315,Wilcox County,2021-05-14,10,2265,25.7
13315,Wilcox County,2021-05-15,4,2269,25.7
13315,Wilcox County,2021-05-16,1,2270,25.7
13315,Wilcox County,2021-05-17,11,2281,25.8
13315,Wilcox County,2021-05-18,8,2289,25.9
13315,Wilcox County,2021-05-19,17,2306,26.1
13315,Wilcox County,2021-05-20,3,2309,26.2
13315,Wilcox County,2021-05-21,8,2317,26.3
13315,Wilcox County,2021-05-22,4,2321,26.3
13315,Wilcox County,2021-05-23,1,2322,26.3
13315,Wilcox County,2021-05-24,4,2326,26.4
13315,Wilcox County,2021-05-25,4,2330,26.4
13315,Wilcox County,2021-05-26,16,2346,26.6
13315,Wilcox County,2021-05-27,3,2349,26.6
13315,Wilcox County,2021-05-28,1,2350,26.6
13315,Wilcox County,2021-05-29,2,2352,26.7
13315,Wilcox County,2021-05-30,3,2355,26.7
13315,Wilcox County,2021-05-31,2,2357,26.7
13315,Wilcox County,2021-06-01,8,2365,26.8
13315,Wilcox County,2021-06-02,9,2374,26.9
13315,Wilcox County,2021-06-03,6,2380,27
13315,Wilcox County,2021-06-04,7,2387,27.1
13315,Wilcox County,2021-06-05,1,2388,27.1
13315,Wilcox County,2021-06-06,3,2391,27.1
13315,Wilcox County,2021-06-07,2,2393,27.1
13315,Wilcox County,2021-06-08,4,2397,27.2
13315,Wilcox County,2021-06-09,9,2406,27.3
13315,Wilcox County,2021-06-10,1,2407,27.3
13315,Wilcox County,2021-06-11,2,2409,27.3
13315,Wilcox County,2021-06-12,1,2410,27.3
13315,Wilcox County,2021-06-14,2,2412,27.3
13315,Wilcox County,2021-06-15,3,2415,27.4
13315,Wilcox County,2021-06-16,8,2423,27.5
13315,Wilcox County,2021-06-17,1,2424,27.5
13315,Wilcox County,2021-06-18,4,2428,27.5
13315,Wilcox County,2021-06-19,1,2429,27.5
13315,Wilcox County,2021-06-21,2,2431,27.5
13315,Wilcox County,2021-06-22,2,2433,27.6
13315,Wilcox County,2021-06-23,15,2448,27.7
13315,Wilcox County,2021-06-24,4,2452,27.8
13315,Wilcox County,2021-06-25,5,2457,27.8
13315,Wilcox County,2021-06-27,2,2459,27.9
13315,Wilcox County,2021-06-28,4,2463,27.9
13315,Wilcox County,2021-06-29,1,2464,27.9
13315,Wilcox County,2021-06-30,7,2471,28
13315,Wilcox County,2021-07-01,4,2475,28
13315,Wilcox County,2021-07-02,2,2477,28.1
13315,Wilcox County,2021-07-03,1,2478,28.1
13315,Wilcox County,2021-07-06,5,2483,28.1
13315,Wilcox County,2021-07-07,5,2488,28.2
13315,Wilcox County,2021-07-09,4,2492,28.2
13315,Wilcox County,2021-07-10,2,2494,28.3
13315,Wilcox County,2021-07-11,1,2495,28.3
13315,Wilcox County,2021-07-12,3,2498,28.3
13315,Wilcox County,2021-07-13,3,2501,28.3
13315,Wilcox County,2021-07-14,5,2506,28.4
13315,Wilcox County,2021-07-15,4,2510,28.4
13315,Wilcox County,2021-07-16,2,2512,28.5
13315,Wilcox County,2021-07-17,2,2514,28.5
13315,Wilcox County,2021-07-19,12,2526,28.6
13315,Wilcox County,2021-07-20,8,2534,28.7
13315,Wilcox County,2021-07-21,11,2545,28.8
13315,Wilcox County,2021-07-22,9,2554,28.9
13315,Wilcox County,2021-07-23,11,2565,29.1
13315,Wilcox County,2021-07-24,4,2569,29.1
13315,Wilcox County,2021-07-25,1,2570,29.1
13315,Wilcox County,2021-07-26,8,2578,29.2
13315,Wilcox County,2021-07-27,10,2588,29.3
13315,Wilcox County,2021-07-28,56,2644,30
13315,Wilcox County,2021-07-29,5,2649,30
13315,Wilcox County,2021-07-30,16,2665,30.2
13315,Wilcox County,2021-07-31,3,2668,30.2
13315,Wilcox County,2021-08-02,10,2678,30.3
13315,Wilcox County,2021-08-03,9,2687,30.5
13315,Wilcox County,2021-08-04,35,2722,30.8
13315,Wilcox County,2021-08-05,8,2730,30.9
13315,Wilcox County,2021-08-06,29,2759,31.3
13315,Wilcox County,2021-08-07,7,2766,31.3
13315,Wilcox County,2021-08-08,5,2771,31.4
13315,Wilcox County,2021-08-09,20,2791,31.6
13315,Wilcox County,2021-08-10,15,2806,31.8
13315,Wilcox County,2021-08-11,41,2847,32.3
13315,Wilcox County,2021-08-12,15,2862,32.4
13315,Wilcox County,2021-08-13,12,2874,32.6
13315,Wilcox County,2021-08-14,7,2881,32.6
13315,Wilcox County,2021-08-15,2,2883,32.7
13315,Wilcox County,2021-08-16,15,2898,32.8
13315,Wilcox County,2021-08-17,10,2908,33
13315,Wilcox County,2021-08-18,37,2945,33.4
13315,Wilcox County,2021-08-19,21,2966,33.6
13315,Wilcox County,2021-08-20,21,2987,33.9
13315,Wilcox County,2021-08-21,4,2991,33.9
13315,Wilcox County,2021-08-22,6,2997,34
13315,Wilcox County,2021-08-23,14,3011,34.1
13315,Wilcox County,2021-08-24,21,3032,34.4
13315,Wilcox County,2021-08-25,30,3062,34.7
13315,Wilcox County,2021-08-26,16,3078,34.9
13315,Wilcox County,2021-08-27,15,3093,35.1
13315,Wilcox County,2021-08-28,3,3096,35.1
13315,Wilcox County,2021-08-29,5,3101,35.1
13315,Wilcox County,2021-08-30,20,3121,35.4
13315,Wilcox County,2021-08-31,7,3128,35.4
13315,Wilcox County,2021-09-01,20,3148,35.7
13315,Wilcox County,2021-09-02,23,3171,35.9
13315,Wilcox County,2021-09-03,10,3181,36
13315,Wilcox County,2021-09-04,5,3186,36.1
13315,Wilcox County,2021-09-05,2,3188,36.1
13315,Wilcox County,2021-09-07,6,3194,36.2
13315,Wilcox County,2021-09-08,15,3209,36.4
13315,Wilcox County,2021-09-09,11,3220,36.5
13315,Wilcox County,2021-09-10,11,3231,36.6
13315,Wilcox County,2021-09-11,3,3234,36.7
13315,Wilcox County,2021-09-12,1,3235,36.7
13315,Wilcox County,2021-09-13,11,3246,36.8
13315,Wilcox County,2021-09-14,4,3250,36.8
13315,Wilcox County,2021-09-15,14,3264,37
13315,Wilcox County,2021-09-16,3,3267,37
13315,Wilcox County,2021-09-17,10,3277,37.1
13315,Wilcox County,2021-09-18,3,3280,37.2
13315,Wilcox County,2021-09-19,1,3281,37.2
13315,Wilcox County,2021-09-20,11,3292,37.3
13315,Wilcox County,2021-09-21,6,3298,37.4
13315,Wilcox County,2021-09-22,9,3307,37.5
13315,Wilcox County,2021-09-23,6,3313,37.5
13315,Wilcox County,2021-09-24,2,3315,37.6
13315,Wilcox County,2021-09-25,1,3316,37.6
13315,Wilcox County,2021-09-26,1,3317,37.6
13315,Wilcox County,2021-09-28,1,3318,37.6
13315,Wilcox County,2021-09-29,4,3322,37.6
13315,Wilcox County,2021-09-30,4,3326,37.7
13315,Wilcox County,2021-10-01,5,3331,37.7
13315,Wilcox County,2021-10-02,2,3333,37.8
13315,Wilcox County,2021-10-04,2,3335,37.8
13315,Wilcox County,2021-10-05,4,3339,37.8
13315,Wilcox County,2021-10-06,4,3343,37.9
13315,Wilcox County,2021-10-07,4,3347,37.9
13317,Wilkes County,2020-12-15,1,1,0
13317,Wilkes County,2020-12-17,1,2,0
13317,Wilkes County,2020-12-18,2,4,0
13317,Wilkes County,2020-12-19,1,5,0.1
13317,Wilkes County,2020-12-20,1,6,0.1
13317,Wilkes County,2020-12-22,37,43,0.4
13317,Wilkes County,2020-12-23,8,51,0.5
13317,Wilkes County,2020-12-24,1,52,0.5
13317,Wilkes County,2020-12-26,1,53,0.5
13317,Wilkes County,2020-12-28,11,64,0.7
13317,Wilkes County,2020-12-29,9,73,0.7
13317,Wilkes County,2020-12-30,5,78,0.8
13317,Wilkes County,2020-12-31,4,82,0.8
13317,Wilkes County,2021-01-04,14,96,1
13317,Wilkes County,2021-01-05,11,107,1.1
13317,Wilkes County,2021-01-06,18,125,1.3
13317,Wilkes County,2021-01-07,12,137,1.4
13317,Wilkes County,2021-01-08,11,148,1.5
13317,Wilkes County,2021-01-09,2,150,1.5
13317,Wilkes County,2021-01-10,4,154,1.6
13317,Wilkes County,2021-01-11,16,170,1.7
13317,Wilkes County,2021-01-12,57,227,2.3
13317,Wilkes County,2021-01-13,53,280,2.8
13317,Wilkes County,2021-01-14,50,330,3.4
13317,Wilkes County,2021-01-15,34,364,3.7
13317,Wilkes County,2021-01-16,6,370,3.8
13317,Wilkes County,2021-01-18,10,380,3.9
13317,Wilkes County,2021-01-19,105,485,4.9
13317,Wilkes County,2021-01-20,25,510,5.2
13317,Wilkes County,2021-01-21,56,566,5.7
13317,Wilkes County,2021-01-22,32,598,6.1
13317,Wilkes County,2021-01-23,2,600,6.1
13317,Wilkes County,2021-01-24,18,618,6.3
13317,Wilkes County,2021-01-25,14,632,6.4
13317,Wilkes County,2021-01-26,11,643,6.5
13317,Wilkes County,2021-01-27,13,656,6.7
13317,Wilkes County,2021-01-28,111,767,7.8
13317,Wilkes County,2021-01-29,8,775,7.9
13317,Wilkes County,2021-01-30,2,777,7.9
13317,Wilkes County,2021-01-31,4,781,7.9
13317,Wilkes County,2021-02-01,10,791,8
13317,Wilkes County,2021-02-02,10,801,8.1
13317,Wilkes County,2021-02-03,7,808,8.2
13317,Wilkes County,2021-02-04,119,927,9.4
13317,Wilkes County,2021-02-05,15,942,9.6
13317,Wilkes County,2021-02-06,1,943,9.6
13317,Wilkes County,2021-02-08,4,947,9.6
13317,Wilkes County,2021-02-09,107,1054,10.7
13317,Wilkes County,2021-02-10,7,1061,10.8
13317,Wilkes County,2021-02-11,14,1075,10.9
13317,Wilkes County,2021-02-12,16,1091,11.1
13317,Wilkes County,2021-02-13,16,1107,11.2
13317,Wilkes County,2021-02-14,1,1108,11.3
13317,Wilkes County,2021-02-15,5,1113,11.3
13317,Wilkes County,2021-02-16,10,1123,11.4
13317,Wilkes County,2021-02-17,22,1145,11.6
13317,Wilkes County,2021-02-18,80,1225,12.4
13317,Wilkes County,2021-02-19,15,1240,12.6
13317,Wilkes County,2021-02-20,2,1242,12.6
13317,Wilkes County,2021-02-22,1,1243,12.6
13317,Wilkes County,2021-02-23,73,1316,13.4
13317,Wilkes County,2021-02-24,8,1324,13.4
13317,Wilkes County,2021-02-25,56,1380,14
13317,Wilkes County,2021-02-26,9,1389,14.1
13317,Wilkes County,2021-02-27,1,1390,14.1
13317,Wilkes County,2021-02-28,1,1391,14.1
13317,Wilkes County,2021-03-01,9,1400,14.2
13317,Wilkes County,2021-03-02,11,1411,14.3
13317,Wilkes County,2021-03-03,21,1432,14.5
13317,Wilkes County,2021-03-04,21,1453,14.8
13317,Wilkes County,2021-03-05,8,1461,14.8
13317,Wilkes County,2021-03-06,1,1462,14.9
13317,Wilkes County,2021-03-07,2,1464,14.9
13317,Wilkes County,2021-03-08,15,1479,15
13317,Wilkes County,2021-03-09,44,1523,15.5
13317,Wilkes County,2021-03-10,21,1544,15.7
13317,Wilkes County,2021-03-11,95,1639,16.6
13317,Wilkes County,2021-03-12,25,1664,16.9
13317,Wilkes County,2021-03-13,14,1678,17
13317,Wilkes County,2021-03-14,3,1681,17.1
13317,Wilkes County,2021-03-15,8,1689,17.2
13317,Wilkes County,2021-03-16,24,1713,17.4
13317,Wilkes County,2021-03-17,81,1794,18.2
13317,Wilkes County,2021-03-18,106,1900,19.3
13317,Wilkes County,2021-03-19,114,2014,20.5
13317,Wilkes County,2021-03-20,6,2020,20.5
13317,Wilkes County,2021-03-21,3,2023,20.6
13317,Wilkes County,2021-03-22,39,2062,20.9
13317,Wilkes County,2021-03-23,42,2104,21.4
13317,Wilkes County,2021-03-24,24,2128,21.6
13317,Wilkes County,2021-03-25,107,2235,22.7
13317,Wilkes County,2021-03-26,100,2335,23.7
13317,Wilkes County,2021-03-27,10,2345,23.8
13317,Wilkes County,2021-03-28,2,2347,23.8
13317,Wilkes County,2021-03-29,12,2359,24
13317,Wilkes County,2021-03-30,88,2447,24.9
13317,Wilkes County,2021-03-31,47,2494,25.3
13317,Wilkes County,2021-04-01,96,2590,26.3
13317,Wilkes County,2021-04-02,24,2614,26.6
13317,Wilkes County,2021-04-03,6,2620,26.6
13317,Wilkes County,2021-04-04,5,2625,26.7
13317,Wilkes County,2021-04-05,26,2651,26.9
13317,Wilkes County,2021-04-06,88,2739,27.8
13317,Wilkes County,2021-04-07,20,2759,28
13317,Wilkes County,2021-04-08,74,2833,28.8
13317,Wilkes County,2021-04-09,19,2852,29
13317,Wilkes County,2021-04-10,15,2867,29.1
13317,Wilkes County,2021-04-11,2,2869,29.1
13317,Wilkes County,2021-04-12,6,2875,29.2
13317,Wilkes County,2021-04-13,21,2896,29.4
13317,Wilkes County,2021-04-14,33,2929,29.8
13317,Wilkes County,2021-04-15,29,2958,30
13317,Wilkes County,2021-04-16,18,2976,30.2
13317,Wilkes County,2021-04-17,17,2993,30.4
13317,Wilkes County,2021-04-18,3,2996,30.4
13317,Wilkes County,2021-04-19,6,3002,30.5
13317,Wilkes County,2021-04-20,17,3019,30.7
13317,Wilkes County,2021-04-21,48,3067,31.2
13317,Wilkes County,2021-04-22,29,3096,31.5
13317,Wilkes County,2021-04-23,16,3112,31.6
13317,Wilkes County,2021-04-24,4,3116,31.7
13317,Wilkes County,2021-04-26,14,3130,31.8
13317,Wilkes County,2021-04-27,15,3145,31.9
13317,Wilkes County,2021-04-28,19,3164,32.1
13317,Wilkes County,2021-04-29,22,3186,32.4
13317,Wilkes County,2021-04-30,11,3197,32.5
13317,Wilkes County,2021-05-01,1,3198,32.5
13317,Wilkes County,2021-05-02,3,3201,32.5
13317,Wilkes County,2021-05-03,4,3205,32.6
13317,Wilkes County,2021-05-04,13,3218,32.7
13317,Wilkes County,2021-05-05,9,3227,32.8
13317,Wilkes County,2021-05-06,39,3266,33.2
13317,Wilkes County,2021-05-07,16,3282,33.3
13317,Wilkes County,2021-05-08,6,3288,33.4
13317,Wilkes County,2021-05-09,3,3291,33.4
13317,Wilkes County,2021-05-10,11,3302,33.5
13317,Wilkes County,2021-05-11,5,3307,33.6
13317,Wilkes County,2021-05-12,5,3312,33.6
13317,Wilkes County,2021-05-13,49,3361,34.1
13317,Wilkes County,2021-05-14,29,3390,34.4
13317,Wilkes County,2021-05-15,4,3394,34.5
13317,Wilkes County,2021-05-16,6,3400,34.5
13317,Wilkes County,2021-05-17,13,3413,34.7
13317,Wilkes County,2021-05-18,13,3426,34.8
13317,Wilkes County,2021-05-19,13,3439,34.9
13317,Wilkes County,2021-05-20,26,3465,35.2
13317,Wilkes County,2021-05-21,17,3482,35.4
13317,Wilkes County,2021-05-22,5,3487,35.4
13317,Wilkes County,2021-05-23,2,3489,35.4
13317,Wilkes County,2021-05-24,17,3506,35.6
13317,Wilkes County,2021-05-25,4,3510,35.7
13317,Wilkes County,2021-05-26,15,3525,35.8
13317,Wilkes County,2021-05-27,14,3539,36
13317,Wilkes County,2021-05-28,4,3543,36
13317,Wilkes County,2021-05-29,1,3544,36
13317,Wilkes County,2021-06-01,5,3549,36.1
13317,Wilkes County,2021-06-02,10,3559,36.2
13317,Wilkes County,2021-06-03,4,3563,36.2
13317,Wilkes County,2021-06-04,11,3574,36.3
13317,Wilkes County,2021-06-05,6,3580,36.4
13317,Wilkes County,2021-06-06,1,3581,36.4
13317,Wilkes County,2021-06-07,3,3584,36.4
13317,Wilkes County,2021-06-08,4,3588,36.4
13317,Wilkes County,2021-06-09,9,3597,36.5
13317,Wilkes County,2021-06-10,11,3608,36.7
13317,Wilkes County,2021-06-11,15,3623,36.8
13317,Wilkes County,2021-06-12,4,3627,36.8
13317,Wilkes County,2021-06-14,11,3638,37
13317,Wilkes County,2021-06-15,5,3643,37
13317,Wilkes County,2021-06-16,24,3667,37.3
13317,Wilkes County,2021-06-17,10,3677,37.4
13317,Wilkes County,2021-06-18,3,3680,37.4
13317,Wilkes County,2021-06-19,2,3682,37.4
13317,Wilkes County,2021-06-20,2,3684,37.4
13317,Wilkes County,2021-06-21,7,3691,37.5
13317,Wilkes County,2021-06-22,2,3693,37.5
13317,Wilkes County,2021-06-23,2,3695,37.5
13317,Wilkes County,2021-06-24,8,3703,37.6
13317,Wilkes County,2021-06-25,4,3707,37.7
13317,Wilkes County,2021-06-26,4,3711,37.7
13317,Wilkes County,2021-06-27,1,3712,37.7
13317,Wilkes County,2021-06-28,3,3715,37.7
13317,Wilkes County,2021-06-29,2,3717,37.8
13317,Wilkes County,2021-06-30,1,3718,37.8
13317,Wilkes County,2021-07-01,9,3727,37.9
13317,Wilkes County,2021-07-02,5,3732,37.9
13317,Wilkes County,2021-07-03,7,3739,38
13317,Wilkes County,2021-07-05,8,3747,38.1
13317,Wilkes County,2021-07-06,8,3755,38.1
13317,Wilkes County,2021-07-07,3,3758,38.2
13317,Wilkes County,2021-07-08,12,3770,38.3
13317,Wilkes County,2021-07-09,7,3777,38.4
13317,Wilkes County,2021-07-10,7,3784,38.4
13317,Wilkes County,2021-07-12,4,3788,38.5
13317,Wilkes County,2021-07-13,3,3791,38.5
13317,Wilkes County,2021-07-14,3,3794,38.5
13317,Wilkes County,2021-07-15,12,3806,38.7
13317,Wilkes County,2021-07-16,9,3815,38.8
13317,Wilkes County,2021-07-17,4,3819,38.8
13317,Wilkes County,2021-07-18,1,3820,38.8
13317,Wilkes County,2021-07-19,7,3827,38.9
13317,Wilkes County,2021-07-20,3,3830,38.9
13317,Wilkes County,2021-07-21,13,3843,39
13317,Wilkes County,2021-07-22,18,3861,39.2
13317,Wilkes County,2021-07-23,14,3875,39.4
13317,Wilkes County,2021-07-24,34,3909,39.7
13317,Wilkes County,2021-07-25,1,3910,39.7
13317,Wilkes County,2021-07-26,10,3920,39.8
13317,Wilkes County,2021-07-27,16,3936,40
13317,Wilkes County,2021-07-28,14,3950,40.1
13317,Wilkes County,2021-07-29,29,3979,40.4
13317,Wilkes County,2021-07-30,19,3998,40.6
13317,Wilkes County,2021-07-31,9,4007,40.7
13317,Wilkes County,2021-08-01,1,4008,40.7
13317,Wilkes County,2021-08-02,14,4022,40.9
13317,Wilkes County,2021-08-03,14,4036,41
13317,Wilkes County,2021-08-04,5,4041,41.1
13317,Wilkes County,2021-08-05,18,4059,41.2
13317,Wilkes County,2021-08-06,15,4074,41.4
13317,Wilkes County,2021-08-07,9,4083,41.5
13317,Wilkes County,2021-08-08,6,4089,41.5
13317,Wilkes County,2021-08-09,7,4096,41.6
13317,Wilkes County,2021-08-10,9,4105,41.7
13317,Wilkes County,2021-08-11,8,4113,41.8
13317,Wilkes County,2021-08-12,37,4150,42.2
13317,Wilkes County,2021-08-13,16,4166,42.3
13317,Wilkes County,2021-08-14,23,4189,42.6
13317,Wilkes County,2021-08-15,2,4191,42.6
13317,Wilkes County,2021-08-16,12,4203,42.7
13317,Wilkes County,2021-08-17,10,4213,42.8
13317,Wilkes County,2021-08-18,23,4236,43
13317,Wilkes County,2021-08-19,30,4266,43.3
13317,Wilkes County,2021-08-20,26,4292,43.6
13317,Wilkes County,2021-08-21,16,4308,43.8
13317,Wilkes County,2021-08-22,5,4313,43.8
13317,Wilkes County,2021-08-23,11,4324,43.9
13317,Wilkes County,2021-08-24,12,4336,44
13317,Wilkes County,2021-08-25,16,4352,44.2
13317,Wilkes County,2021-08-26,33,4385,44.5
13317,Wilkes County,2021-08-27,18,4403,44.7
13317,Wilkes County,2021-08-28,11,4414,44.8
13317,Wilkes County,2021-08-29,4,4418,44.9
13317,Wilkes County,2021-08-30,24,4442,45.1
13317,Wilkes County,2021-08-31,17,4459,45.3
13317,Wilkes County,2021-09-01,9,4468,45.4
13317,Wilkes County,2021-09-02,32,4500,45.7
13317,Wilkes County,2021-09-03,20,4520,45.9
13317,Wilkes County,2021-09-04,11,4531,46
13317,Wilkes County,2021-09-05,3,4534,46.1
13317,Wilkes County,2021-09-06,3,4537,46.1
13317,Wilkes County,2021-09-07,11,4548,46.2
13317,Wilkes County,2021-09-08,13,4561,46.3
13317,Wilkes County,2021-09-09,20,4581,46.5
13317,Wilkes County,2021-09-10,13,4594,46.7
13317,Wilkes County,2021-09-11,13,4607,46.8
13317,Wilkes County,2021-09-12,1,4608,46.8
13317,Wilkes County,2021-09-13,12,4620,46.9
13317,Wilkes County,2021-09-14,9,4629,47
13317,Wilkes County,2021-09-15,4,4633,47.1
13317,Wilkes County,2021-09-16,24,4657,47.3
13317,Wilkes County,2021-09-17,15,4672,47.5
13317,Wilkes County,2021-09-18,10,4682,47.6
13317,Wilkes County,2021-09-19,2,4684,47.6
13317,Wilkes County,2021-09-20,5,4689,47.6
13317,Wilkes County,2021-09-21,6,4695,47.7
13317,Wilkes County,2021-09-22,8,4703,47.8
13317,Wilkes County,2021-09-23,18,4721,48
13317,Wilkes County,2021-09-24,8,4729,48
13317,Wilkes County,2021-09-25,3,4732,48.1
13317,Wilkes County,2021-09-26,1,4733,48.1
13317,Wilkes County,2021-09-27,4,4737,48.1
13317,Wilkes County,2021-09-28,2,4739,48.1
13317,Wilkes County,2021-09-29,3,4742,48.2
13317,Wilkes County,2021-10-01,6,4748,48.2
13317,Wilkes County,2021-10-02,2,4750,48.3
13317,Wilkes County,2021-10-04,2,4752,48.3
13317,Wilkes County,2021-10-05,1,4753,48.3
13317,Wilkes County,2021-10-06,3,4756,48.3
13317,Wilkes County,2021-10-07,7,4763,48.4
13319,Wilkinson County,2020-12-17,1,1,0
13319,Wilkinson County,2020-12-18,1,2,0
13319,Wilkinson County,2020-12-22,4,6,0.1
13319,Wilkinson County,2020-12-23,1,7,0.1
13319,Wilkinson County,2020-12-24,2,9,0.1
13319,Wilkinson County,2020-12-26,7,16,0.2
13319,Wilkinson County,2020-12-27,3,19,0.2
13319,Wilkinson County,2020-12-28,45,64,0.7
13319,Wilkinson County,2020-12-29,7,71,0.8
13319,Wilkinson County,2020-12-30,17,88,1
13319,Wilkinson County,2020-12-31,12,100,1.1
13319,Wilkinson County,2021-01-04,26,126,1.4
13319,Wilkinson County,2021-01-05,7,133,1.5
13319,Wilkinson County,2021-01-06,19,152,1.7
13319,Wilkinson County,2021-01-07,19,171,1.9
13319,Wilkinson County,2021-01-08,13,184,2
13319,Wilkinson County,2021-01-09,1,185,2.1
13319,Wilkinson County,2021-01-10,2,187,2.1
13319,Wilkinson County,2021-01-11,36,223,2.5
13319,Wilkinson County,2021-01-12,14,237,2.6
13319,Wilkinson County,2021-01-13,63,300,3.3
13319,Wilkinson County,2021-01-14,103,403,4.5
13319,Wilkinson County,2021-01-15,63,466,5.2
13319,Wilkinson County,2021-01-16,11,477,5.3
13319,Wilkinson County,2021-01-17,2,479,5.3
13319,Wilkinson County,2021-01-18,52,531,5.9
13319,Wilkinson County,2021-01-19,20,551,6.1
13319,Wilkinson County,2021-01-20,99,650,7.2
13319,Wilkinson County,2021-01-21,109,759,8.4
13319,Wilkinson County,2021-01-22,46,805,8.9
13319,Wilkinson County,2021-01-23,2,807,9
13319,Wilkinson County,2021-01-24,2,809,9
13319,Wilkinson County,2021-01-25,65,874,9.7
13319,Wilkinson County,2021-01-26,8,882,9.8
13319,Wilkinson County,2021-01-27,35,917,10.2
13319,Wilkinson County,2021-01-28,35,952,10.6
13319,Wilkinson County,2021-01-29,29,981,10.9
13319,Wilkinson County,2021-01-31,2,983,10.9
13319,Wilkinson County,2021-02-01,25,1008,11.2
13319,Wilkinson County,2021-02-02,42,1050,11.7
13319,Wilkinson County,2021-02-03,33,1083,12
13319,Wilkinson County,2021-02-04,37,1120,12.4
13319,Wilkinson County,2021-02-05,25,1145,12.7
13319,Wilkinson County,2021-02-06,6,1151,12.8
13319,Wilkinson County,2021-02-08,29,1180,13.1
13319,Wilkinson County,2021-02-09,8,1188,13.2
13319,Wilkinson County,2021-02-10,15,1203,13.4
13319,Wilkinson County,2021-02-11,29,1232,13.7
13319,Wilkinson County,2021-02-12,12,1244,13.8
13319,Wilkinson County,2021-02-13,5,1249,13.9
13319,Wilkinson County,2021-02-15,24,1273,14.1
13319,Wilkinson County,2021-02-16,10,1283,14.2
13319,Wilkinson County,2021-02-17,36,1319,14.6
13319,Wilkinson County,2021-02-18,16,1335,14.8
13319,Wilkinson County,2021-02-19,6,1341,14.9
13319,Wilkinson County,2021-02-20,3,1344,14.9
13319,Wilkinson County,2021-02-21,1,1345,14.9
13319,Wilkinson County,2021-02-22,6,1351,15
13319,Wilkinson County,2021-02-23,19,1370,15.2
13319,Wilkinson County,2021-02-24,9,1379,15.3
13319,Wilkinson County,2021-02-25,30,1409,15.6
13319,Wilkinson County,2021-02-26,20,1429,15.9
13319,Wilkinson County,2021-02-27,7,1436,15.9
13319,Wilkinson County,2021-02-28,3,1439,16
13319,Wilkinson County,2021-03-01,45,1484,16.5
13319,Wilkinson County,2021-03-02,35,1519,16.9
13319,Wilkinson County,2021-03-03,27,1546,17.2
13319,Wilkinson County,2021-03-04,94,1640,18.2
13319,Wilkinson County,2021-03-05,35,1675,18.6
13319,Wilkinson County,2021-03-07,1,1676,18.6
13319,Wilkinson County,2021-03-08,79,1755,19.5
13319,Wilkinson County,2021-03-09,14,1769,19.6
13319,Wilkinson County,2021-03-10,49,1818,20.2
13319,Wilkinson County,2021-03-11,54,1872,20.8
13319,Wilkinson County,2021-03-12,37,1909,21.2
13319,Wilkinson County,2021-03-13,14,1923,21.3
13319,Wilkinson County,2021-03-15,80,2003,22.2
13319,Wilkinson County,2021-03-16,23,2026,22.5
13319,Wilkinson County,2021-03-17,107,2133,23.7
13319,Wilkinson County,2021-03-18,29,2162,24
13319,Wilkinson County,2021-03-19,132,2294,25.5
13319,Wilkinson County,2021-03-20,3,2297,25.5
13319,Wilkinson County,2021-03-21,2,2299,25.5
13319,Wilkinson County,2021-03-22,85,2384,26.5
13319,Wilkinson County,2021-03-23,18,2402,26.7
13319,Wilkinson County,2021-03-24,67,2469,27.4
13319,Wilkinson County,2021-03-25,63,2532,28.1
13319,Wilkinson County,2021-03-26,57,2589,28.7
13319,Wilkinson County,2021-03-27,19,2608,28.9
13319,Wilkinson County,2021-03-28,3,2611,29
13319,Wilkinson County,2021-03-29,52,2663,29.6
13319,Wilkinson County,2021-03-30,47,2710,30.1
13319,Wilkinson County,2021-03-31,25,2735,30.4
13319,Wilkinson County,2021-04-01,95,2830,31.4
13319,Wilkinson County,2021-04-02,31,2861,31.8
13319,Wilkinson County,2021-04-03,7,2868,31.8
13319,Wilkinson County,2021-04-04,2,2870,31.9
13319,Wilkinson County,2021-04-05,23,2893,32.1
13319,Wilkinson County,2021-04-06,45,2938,32.6
13319,Wilkinson County,2021-04-07,16,2954,32.8
13319,Wilkinson County,2021-04-08,47,3001,33.3
13319,Wilkinson County,2021-04-09,28,3029,33.6
13319,Wilkinson County,2021-04-10,8,3037,33.7
13319,Wilkinson County,2021-04-11,3,3040,33.7
13319,Wilkinson County,2021-04-12,11,3051,33.9
13319,Wilkinson County,2021-04-13,14,3065,34
13319,Wilkinson County,2021-04-14,27,3092,34.3
13319,Wilkinson County,2021-04-15,10,3102,34.4
13319,Wilkinson County,2021-04-16,11,3113,34.6
13319,Wilkinson County,2021-04-17,2,3115,34.6
13319,Wilkinson County,2021-04-18,1,3116,34.6
13319,Wilkinson County,2021-04-19,34,3150,35
13319,Wilkinson County,2021-04-20,9,3159,35.1
13319,Wilkinson County,2021-04-21,18,3177,35.3
13319,Wilkinson County,2021-04-22,28,3205,35.6
13319,Wilkinson County,2021-04-23,14,3219,35.7
13319,Wilkinson County,2021-04-24,3,3222,35.8
13319,Wilkinson County,2021-04-25,1,3223,35.8
13319,Wilkinson County,2021-04-26,8,3231,35.9
13319,Wilkinson County,2021-04-27,17,3248,36
13319,Wilkinson County,2021-04-28,4,3252,36.1
13319,Wilkinson County,2021-04-29,15,3267,36.3
13319,Wilkinson County,2021-04-30,27,3294,36.6
13319,Wilkinson County,2021-05-01,3,3297,36.6
13319,Wilkinson County,2021-05-02,2,3299,36.6
13319,Wilkinson County,2021-05-03,6,3305,36.7
13319,Wilkinson County,2021-05-04,5,3310,36.7
13319,Wilkinson County,2021-05-05,20,3330,37
13319,Wilkinson County,2021-05-06,18,3348,37.2
13319,Wilkinson County,2021-05-07,7,3355,37.2
13319,Wilkinson County,2021-05-08,2,3357,37.3
13319,Wilkinson County,2021-05-09,2,3359,37.3
13319,Wilkinson County,2021-05-10,3,3362,37.3
13319,Wilkinson County,2021-05-11,7,3369,37.4
13319,Wilkinson County,2021-05-12,15,3384,37.6
13319,Wilkinson County,2021-05-13,8,3392,37.6
13319,Wilkinson County,2021-05-14,7,3399,37.7
13319,Wilkinson County,2021-05-15,2,3401,37.7
13319,Wilkinson County,2021-05-16,8,3409,37.8
13319,Wilkinson County,2021-05-17,12,3421,38
13319,Wilkinson County,2021-05-18,9,3430,38.1
13319,Wilkinson County,2021-05-19,10,3440,38.2
13319,Wilkinson County,2021-05-20,26,3466,38.5
13319,Wilkinson County,2021-05-21,9,3475,38.6
13319,Wilkinson County,2021-05-22,5,3480,38.6
13319,Wilkinson County,2021-05-23,3,3483,38.7
13319,Wilkinson County,2021-05-24,3,3486,38.7
13319,Wilkinson County,2021-05-25,16,3502,38.9
13319,Wilkinson County,2021-05-26,8,3510,39
13319,Wilkinson County,2021-05-27,11,3521,39.1
13319,Wilkinson County,2021-05-28,7,3528,39.2
13319,Wilkinson County,2021-05-29,7,3535,39.2
13319,Wilkinson County,2021-05-31,3,3538,39.3
13319,Wilkinson County,2021-06-01,7,3545,39.3
13319,Wilkinson County,2021-06-02,32,3577,39.7
13319,Wilkinson County,2021-06-03,11,3588,39.8
13319,Wilkinson County,2021-06-04,5,3593,39.9
13319,Wilkinson County,2021-06-05,2,3595,39.9
13319,Wilkinson County,2021-06-06,4,3599,39.9
13319,Wilkinson County,2021-06-07,6,3605,40
13319,Wilkinson County,2021-06-08,8,3613,40.1
13319,Wilkinson County,2021-06-09,6,3619,40.2
13319,Wilkinson County,2021-06-10,11,3630,40.3
13319,Wilkinson County,2021-06-11,4,3634,40.3
13319,Wilkinson County,2021-06-12,3,3637,40.4
13319,Wilkinson County,2021-06-15,1,3638,40.4
13319,Wilkinson County,2021-06-16,5,3643,40.4
13319,Wilkinson County,2021-06-17,8,3651,40.5
13319,Wilkinson County,2021-06-18,7,3658,40.6
13319,Wilkinson County,2021-06-19,3,3661,40.6
13319,Wilkinson County,2021-06-20,1,3662,40.6
13319,Wilkinson County,2021-06-21,1,3663,40.7
13319,Wilkinson County,2021-06-22,3,3666,40.7
13319,Wilkinson County,2021-06-23,8,3674,40.8
13319,Wilkinson County,2021-06-24,8,3682,40.9
13319,Wilkinson County,2021-06-25,5,3687,40.9
13319,Wilkinson County,2021-06-26,1,3688,40.9
13319,Wilkinson County,2021-06-27,1,3689,40.9
13319,Wilkinson County,2021-06-28,3,3692,41
13319,Wilkinson County,2021-06-29,2,3694,41
13319,Wilkinson County,2021-06-30,8,3702,41.1
13319,Wilkinson County,2021-07-01,11,3713,41.2
13319,Wilkinson County,2021-07-02,4,3717,41.3
13319,Wilkinson County,2021-07-03,2,3719,41.3
13319,Wilkinson County,2021-07-05,5,3724,41.3
13319,Wilkinson County,2021-07-06,1,3725,41.3
13319,Wilkinson County,2021-07-07,1,3726,41.4
13319,Wilkinson County,2021-07-08,9,3735,41.5
13319,Wilkinson County,2021-07-09,3,3738,41.5
13319,Wilkinson County,2021-07-10,4,3742,41.5
13319,Wilkinson County,2021-07-11,2,3744,41.6
13319,Wilkinson County,2021-07-12,2,3746,41.6
13319,Wilkinson County,2021-07-13,9,3755,41.7
13319,Wilkinson County,2021-07-14,5,3760,41.7
13319,Wilkinson County,2021-07-15,4,3764,41.8
13319,Wilkinson County,2021-07-16,4,3768,41.8
13319,Wilkinson County,2021-07-17,3,3771,41.9
13319,Wilkinson County,2021-07-19,8,3779,41.9
13319,Wilkinson County,2021-07-20,2,3781,42
13319,Wilkinson County,2021-07-21,17,3798,42.2
13319,Wilkinson County,2021-07-22,22,3820,42.4
13319,Wilkinson County,2021-07-23,9,3829,42.5
13319,Wilkinson County,2021-07-24,14,3843,42.7
13319,Wilkinson County,2021-07-25,5,3848,42.7
13319,Wilkinson County,2021-07-26,18,3866,42.9
13319,Wilkinson County,2021-07-27,16,3882,43.1
13319,Wilkinson County,2021-07-28,17,3899,43.3
13319,Wilkinson County,2021-07-29,47,3946,43.8
13319,Wilkinson County,2021-07-30,21,3967,44
13319,Wilkinson County,2021-07-31,19,3986,44.2
13319,Wilkinson County,2021-08-01,6,3992,44.3
13319,Wilkinson County,2021-08-02,18,4010,44.5
13319,Wilkinson County,2021-08-03,23,4033,44.8
13319,Wilkinson County,2021-08-04,16,4049,44.9
13319,Wilkinson County,2021-08-05,28,4077,45.2
13319,Wilkinson County,2021-08-06,16,4093,45.4
13319,Wilkinson County,2021-08-07,2,4095,45.4
13319,Wilkinson County,2021-08-08,7,4102,45.5
13319,Wilkinson County,2021-08-09,16,4118,45.7
13319,Wilkinson County,2021-08-10,22,4140,45.9
13319,Wilkinson County,2021-08-11,20,4160,46.2
13319,Wilkinson County,2021-08-12,24,4184,46.4
13319,Wilkinson County,2021-08-13,24,4208,46.7
13319,Wilkinson County,2021-08-14,6,4214,46.8
13319,Wilkinson County,2021-08-15,4,4218,46.8
13319,Wilkinson County,2021-08-16,23,4241,47.1
13319,Wilkinson County,2021-08-17,20,4261,47.3
13319,Wilkinson County,2021-08-18,35,4296,47.7
13319,Wilkinson County,2021-08-19,62,4358,48.4
13319,Wilkinson County,2021-08-20,22,4380,48.6
13319,Wilkinson County,2021-08-21,7,4387,48.7
13319,Wilkinson County,2021-08-22,5,4392,48.7
13319,Wilkinson County,2021-08-23,14,4406,48.9
13319,Wilkinson County,2021-08-24,26,4432,49.2
13319,Wilkinson County,2021-08-25,13,4445,49.3
13319,Wilkinson County,2021-08-26,31,4476,49.7
13319,Wilkinson County,2021-08-27,14,4490,49.8
13319,Wilkinson County,2021-08-28,11,4501,50
13319,Wilkinson County,2021-08-29,3,4504,50
13319,Wilkinson County,2021-08-30,14,4518,50.1
13319,Wilkinson County,2021-08-31,12,4530,50.3
13319,Wilkinson County,2021-09-01,19,4549,50.5
13319,Wilkinson County,2021-09-02,46,4595,51
13319,Wilkinson County,2021-09-03,20,4615,51.2
13319,Wilkinson County,2021-09-04,10,4625,51.3
13319,Wilkinson County,2021-09-05,3,4628,51.4
13319,Wilkinson County,2021-09-06,4,4632,51.4
13319,Wilkinson County,2021-09-07,8,4640,51.5
13319,Wilkinson County,2021-09-08,16,4656,51.7
13319,Wilkinson County,2021-09-09,28,4684,52
13319,Wilkinson County,2021-09-10,14,4698,52.1
13319,Wilkinson County,2021-09-11,4,4702,52.2
13319,Wilkinson County,2021-09-12,3,4705,52.2
13319,Wilkinson County,2021-09-13,10,4715,52.3
13319,Wilkinson County,2021-09-14,13,4728,52.5
13319,Wilkinson County,2021-09-15,19,4747,52.7
13319,Wilkinson County,2021-09-16,17,4764,52.9
13319,Wilkinson County,2021-09-17,4,4768,52.9
13319,Wilkinson County,2021-09-18,1,4769,52.9
13319,Wilkinson County,2021-09-19,1,4770,52.9
13319,Wilkinson County,2021-09-20,4,4774,53
13319,Wilkinson County,2021-09-21,9,4783,53.1
13319,Wilkinson County,2021-09-22,7,4790,53.2
13319,Wilkinson County,2021-09-23,10,4800,53.3
13319,Wilkinson County,2021-09-24,9,4809,53.4
13319,Wilkinson County,2021-09-27,1,4810,53.4
13319,Wilkinson County,2021-09-28,8,4818,53.5
13319,Wilkinson County,2021-09-29,20,4838,53.7
13319,Wilkinson County,2021-09-30,7,4845,53.8
13319,Wilkinson County,2021-10-01,6,4851,53.8
13319,Wilkinson County,2021-10-03,1,4852,53.9
13319,Wilkinson County,2021-10-04,3,4855,53.9
13319,Wilkinson County,2021-10-05,2,4857,53.9
13319,Wilkinson County,2021-10-06,2,4859,53.9
13319,Wilkinson County,2021-10-07,6,4865,54
13321,Worth County,2020-12-17,10,10,0
13321,Worth County,2020-12-18,26,36,0.2
13321,Worth County,2020-12-19,7,43,0.2
13321,Worth County,2020-12-20,2,45,0.2
13321,Worth County,2020-12-21,9,54,0.3
13321,Worth County,2020-12-22,13,67,0.3
13321,Worth County,2020-12-23,47,114,0.6
13321,Worth County,2020-12-24,7,121,0.6
13321,Worth County,2020-12-26,1,122,0.6
13321,Worth County,2020-12-27,2,124,0.6
13321,Worth County,2020-12-28,21,145,0.7
13321,Worth County,2020-12-29,29,174,0.8
13321,Worth County,2020-12-30,33,207,1
13321,Worth County,2020-12-31,19,226,1.1
13321,Worth County,2021-01-01,1,227,1.1
13321,Worth County,2021-01-02,2,229,1.1
13321,Worth County,2021-01-03,1,230,1.1
13321,Worth County,2021-01-04,17,247,1.2
13321,Worth County,2021-01-05,36,283,1.4
13321,Worth County,2021-01-06,36,319,1.6
13321,Worth County,2021-01-07,21,340,1.7
13321,Worth County,2021-01-08,38,378,1.8
13321,Worth County,2021-01-09,45,423,2.1
13321,Worth County,2021-01-11,150,573,2.8
13321,Worth County,2021-01-12,107,680,3.3
13321,Worth County,2021-01-13,145,825,4
13321,Worth County,2021-01-14,169,994,4.9
13321,Worth County,2021-01-15,109,1103,5.4
13321,Worth County,2021-01-16,30,1133,5.5
13321,Worth County,2021-01-17,5,1138,5.6
13321,Worth County,2021-01-18,179,1317,6.4
13321,Worth County,2021-01-19,211,1528,7.5
13321,Worth County,2021-01-20,145,1673,8.2
13321,Worth County,2021-01-21,203,1876,9.2
13321,Worth County,2021-01-22,79,1955,9.5
13321,Worth County,2021-01-23,48,2003,9.8
13321,Worth County,2021-01-25,145,2148,10.5
13321,Worth County,2021-01-26,148,2296,11.2
13321,Worth County,2021-01-27,81,2377,11.6
13321,Worth County,2021-01-28,125,2502,12.2
13321,Worth County,2021-01-29,31,2533,12.4
13321,Worth County,2021-01-30,12,2545,12.4
13321,Worth County,2021-01-31,4,2549,12.4
13321,Worth County,2021-02-01,68,2617,12.8
13321,Worth County,2021-02-02,75,2692,13.1
13321,Worth County,2021-02-03,59,2751,13.4
13321,Worth County,2021-02-04,107,2858,13.9
13321,Worth County,2021-02-05,19,2877,14
13321,Worth County,2021-02-06,39,2916,14.2
13321,Worth County,2021-02-07,1,2917,14.2
13321,Worth County,2021-02-08,44,2961,14.4
13321,Worth County,2021-02-09,54,3015,14.7
13321,Worth County,2021-02-10,35,3050,14.9
13321,Worth County,2021-02-11,46,3096,15.1
13321,Worth County,2021-02-12,23,3119,15.2
13321,Worth County,2021-02-13,5,3124,15.2
13321,Worth County,2021-02-14,6,3130,15.3
13321,Worth County,2021-02-15,32,3162,15.4
13321,Worth County,2021-02-16,41,3203,15.6
13321,Worth County,2021-02-17,43,3246,15.8
13321,Worth County,2021-02-18,36,3282,16
13321,Worth County,2021-02-19,22,3304,16.1
13321,Worth County,2021-02-20,12,3316,16.2
13321,Worth County,2021-02-21,2,3318,16.2
13321,Worth County,2021-02-22,15,3333,16.3
13321,Worth County,2021-02-23,28,3361,16.4
13321,Worth County,2021-02-24,33,3394,16.6
13321,Worth County,2021-02-25,41,3435,16.8
13321,Worth County,2021-02-26,26,3461,16.9
13321,Worth County,2021-02-27,5,3466,16.9
13321,Worth County,2021-02-28,2,3468,16.9
13321,Worth County,2021-03-01,52,3520,17.2
13321,Worth County,2021-03-02,56,3576,17.4
13321,Worth County,2021-03-03,41,3617,17.6
13321,Worth County,2021-03-04,26,3643,17.8
13321,Worth County,2021-03-05,23,3666,17.9
13321,Worth County,2021-03-06,3,3669,17.9
13321,Worth County,2021-03-07,2,3671,17.9
13321,Worth County,2021-03-08,30,3701,18.1
13321,Worth County,2021-03-09,64,3765,18.4
13321,Worth County,2021-03-10,54,3819,18.6
13321,Worth County,2021-03-11,35,3854,18.8
13321,Worth County,2021-03-12,138,3992,19.5
13321,Worth County,2021-03-13,20,4012,19.6
13321,Worth County,2021-03-14,12,4024,19.6
13321,Worth County,2021-03-15,41,4065,19.8
13321,Worth County,2021-03-16,127,4192,20.5
13321,Worth County,2021-03-17,85,4277,20.9
13321,Worth County,2021-03-18,36,4313,21
13321,Worth County,2021-03-19,37,4350,21.2
13321,Worth County,2021-03-20,24,4374,21.3
13321,Worth County,2021-03-21,7,4381,21.4
13321,Worth County,2021-03-22,39,4420,21.6
13321,Worth County,2021-03-23,103,4523,22.1
13321,Worth County,2021-03-24,64,4587,22.4
13321,Worth County,2021-03-25,52,4639,22.6
13321,Worth County,2021-03-26,65,4704,23
13321,Worth County,2021-03-27,9,4713,23
13321,Worth County,2021-03-28,9,4722,23
13321,Worth County,2021-03-29,33,4755,23.2
13321,Worth County,2021-03-30,118,4873,23.8
13321,Worth County,2021-03-31,82,4955,24.2
13321,Worth County,2021-04-01,55,5010,24.4
13321,Worth County,2021-04-02,68,5078,24.8
13321,Worth County,2021-04-03,25,5103,24.9
13321,Worth County,2021-04-04,3,5106,24.9
13321,Worth County,2021-04-05,44,5150,25.1
13321,Worth County,2021-04-06,69,5219,25.5
13321,Worth County,2021-04-07,49,5268,25.7
13321,Worth County,2021-04-08,56,5324,26
13321,Worth County,2021-04-09,39,5363,26.2
13321,Worth County,2021-04-10,10,5373,26.2
13321,Worth County,2021-04-11,12,5385,26.3
13321,Worth County,2021-04-12,38,5423,26.5
13321,Worth County,2021-04-13,74,5497,26.8
13321,Worth County,2021-04-14,19,5516,26.9
13321,Worth County,2021-04-15,18,5534,27
13321,Worth County,2021-04-16,25,5559,27.1
13321,Worth County,2021-04-17,9,5568,27.2
13321,Worth County,2021-04-19,17,5585,27.3
13321,Worth County,2021-04-20,58,5643,27.5
13321,Worth County,2021-04-21,29,5672,27.7
13321,Worth County,2021-04-22,26,5698,27.8
13321,Worth County,2021-04-23,25,5723,27.9
13321,Worth County,2021-04-24,1,5724,27.9
13321,Worth County,2021-04-25,5,5729,28
13321,Worth County,2021-04-26,10,5739,28
13321,Worth County,2021-04-27,61,5800,28.3
13321,Worth County,2021-04-28,26,5826,28.4
13321,Worth County,2021-04-29,27,5853,28.6
13321,Worth County,2021-04-30,14,5867,28.6
13321,Worth County,2021-05-01,8,5875,28.7
13321,Worth County,2021-05-02,14,5889,28.7
13321,Worth County,2021-05-03,12,5901,28.8
13321,Worth County,2021-05-04,24,5925,28.9
13321,Worth County,2021-05-05,15,5940,29
13321,Worth County,2021-05-06,23,5963,29.1
13321,Worth County,2021-05-07,10,5973,29.1
13321,Worth County,2021-05-08,8,5981,29.2
13321,Worth County,2021-05-09,2,5983,29.2
13321,Worth County,2021-05-10,7,5990,29.2
13321,Worth County,2021-05-11,24,6014,29.3
13321,Worth County,2021-05-12,14,6028,29.4
13321,Worth County,2021-05-13,14,6042,29.5
13321,Worth County,2021-05-14,20,6062,29.6
13321,Worth County,2021-05-15,9,6071,29.6
13321,Worth County,2021-05-16,6,6077,29.7
13321,Worth County,2021-05-17,11,6088,29.7
13321,Worth County,2021-05-18,30,6118,29.9
13321,Worth County,2021-05-19,32,6150,30
13321,Worth County,2021-05-20,20,6170,30.1
13321,Worth County,2021-05-21,13,6183,30.2
13321,Worth County,2021-05-22,18,6201,30.3
13321,Worth County,2021-05-23,4,6205,30.3
13321,Worth County,2021-05-24,21,6226,30.4
13321,Worth County,2021-05-25,22,6248,30.5
13321,Worth County,2021-05-26,10,6258,30.5
13321,Worth County,2021-05-27,14,6272,30.6
13321,Worth County,2021-05-28,20,6292,30.7
13321,Worth County,2021-05-29,1,6293,30.7
13321,Worth County,2021-05-30,1,6294,30.7
13321,Worth County,2021-05-31,4,6298,30.7
13321,Worth County,2021-06-01,23,6321,30.8
13321,Worth County,2021-06-02,14,6335,30.9
13321,Worth County,2021-06-03,18,6353,31
13321,Worth County,2021-06-04,9,6362,31
13321,Worth County,2021-06-05,11,6373,31.1
13321,Worth County,2021-06-06,9,6382,31.1
13321,Worth County,2021-06-07,7,6389,31.2
13321,Worth County,2021-06-08,13,6402,31.2
13321,Worth County,2021-06-09,9,6411,31.3
13321,Worth County,2021-06-10,25,6436,31.4
13321,Worth County,2021-06-11,9,6445,31.4
13321,Worth County,2021-06-12,4,6449,31.5
13321,Worth County,2021-06-14,12,6461,31.5
13321,Worth County,2021-06-15,29,6490,31.7
13321,Worth County,2021-06-16,7,6497,31.7
13321,Worth County,2021-06-17,16,6513,31.8
13321,Worth County,2021-06-18,8,6521,31.8
13321,Worth County,2021-06-19,5,6526,31.8
13321,Worth County,2021-06-20,3,6529,31.9
13321,Worth County,2021-06-21,5,6534,31.9
13321,Worth County,2021-06-22,12,6546,31.9
13321,Worth County,2021-06-23,15,6561,32
13321,Worth County,2021-06-24,19,6580,32.1
13321,Worth County,2021-06-25,7,6587,32.1
13321,Worth County,2021-06-26,9,6596,32.2
13321,Worth County,2021-06-28,6,6602,32.2
13321,Worth County,2021-06-29,19,6621,32.3
13321,Worth County,2021-06-30,9,6630,32.4
13321,Worth County,2021-07-01,17,6647,32.4
13321,Worth County,2021-07-02,13,6660,32.5
13321,Worth County,2021-07-03,1,6661,32.5
13321,Worth County,2021-07-04,1,6662,32.5
13321,Worth County,2021-07-05,4,6666,32.5
13321,Worth County,2021-07-06,13,6679,32.6
13321,Worth County,2021-07-07,7,6686,32.6
13321,Worth County,2021-07-08,5,6691,32.6
13321,Worth County,2021-07-09,9,6700,32.7
13321,Worth County,2021-07-10,4,6704,32.7
13321,Worth County,2021-07-12,19,6723,32.8
13321,Worth County,2021-07-13,11,6734,32.9
13321,Worth County,2021-07-14,13,6747,32.9
13321,Worth County,2021-07-15,15,6762,33
13321,Worth County,2021-07-16,13,6775,33.1
13321,Worth County,2021-07-17,6,6781,33.1
13321,Worth County,2021-07-18,2,6783,33.1
13321,Worth County,2021-07-19,11,6794,33.2
13321,Worth County,2021-07-20,24,6818,33.3
13321,Worth County,2021-07-21,17,6835,33.4
13321,Worth County,2021-07-22,24,6859,33.5
13321,Worth County,2021-07-23,21,6880,33.6
13321,Worth County,2021-07-24,13,6893,33.6
13321,Worth County,2021-07-25,7,6900,33.7
13321,Worth County,2021-07-26,15,6915,33.7
13321,Worth County,2021-07-27,48,6963,34
13321,Worth County,2021-07-28,41,7004,34.2
13321,Worth County,2021-07-29,68,7072,34.5
13321,Worth County,2021-07-30,41,7113,34.7
13321,Worth County,2021-07-31,11,7124,34.8
13321,Worth County,2021-08-01,6,7130,34.8
13321,Worth County,2021-08-02,19,7149,34.9
13321,Worth County,2021-08-03,66,7215,35.2
13321,Worth County,2021-08-04,32,7247,35.4
13321,Worth County,2021-08-05,71,7318,35.7
13321,Worth County,2021-08-06,49,7367,35.9
13321,Worth County,2021-08-07,30,7397,36.1
13321,Worth County,2021-08-08,18,7415,36.2
13321,Worth County,2021-08-09,30,7445,36.3
13321,Worth County,2021-08-10,73,7518,36.7
13321,Worth County,2021-08-11,52,7570,36.9
13321,Worth County,2021-08-12,63,7633,37.2
13321,Worth County,2021-08-13,39,7672,37.4
13321,Worth County,2021-08-14,25,7697,37.6
13321,Worth County,2021-08-15,22,7719,37.7
13321,Worth County,2021-08-16,29,7748,37.8
13321,Worth County,2021-08-17,66,7814,38.1
13321,Worth County,2021-08-18,46,7860,38.4
13321,Worth County,2021-08-19,63,7923,38.7
13321,Worth County,2021-08-20,45,7968,38.9
13321,Worth County,2021-08-21,18,7986,39
13321,Worth County,2021-08-22,9,7995,39
13321,Worth County,2021-08-23,28,8023,39.1
13321,Worth County,2021-08-24,70,8093,39.5
13321,Worth County,2021-08-25,29,8122,39.6
13321,Worth County,2021-08-26,54,8176,39.9
13321,Worth County,2021-08-27,29,8205,40
13321,Worth County,2021-08-28,16,8221,40.1
13321,Worth County,2021-08-29,11,8232,40.2
13321,Worth County,2021-08-30,19,8251,40.3
13321,Worth County,2021-08-31,57,8308,40.5
13321,Worth County,2021-09-01,37,8345,40.7
13321,Worth County,2021-09-02,36,8381,40.9
13321,Worth County,2021-09-03,49,8430,41.1
13321,Worth County,2021-09-04,20,8450,41.2
13321,Worth County,2021-09-05,9,8459,41.3
13321,Worth County,2021-09-06,11,8470,41.3
13321,Worth County,2021-09-07,22,8492,41.4
13321,Worth County,2021-09-08,19,8511,41.5
13321,Worth County,2021-09-09,30,8541,41.7
13321,Worth County,2021-09-10,35,8576,41.8
13321,Worth County,2021-09-11,17,8593,41.9
13321,Worth County,2021-09-12,10,8603,42
13321,Worth County,2021-09-13,16,8619,42.1
13321,Worth County,2021-09-14,22,8641,42.2
13321,Worth County,2021-09-15,16,8657,42.2
13321,Worth County,2021-09-16,17,8674,42.3
13321,Worth County,2021-09-17,20,8694,42.4
13321,Worth County,2021-09-18,10,8704,42.5
13321,Worth County,2021-09-19,3,8707,42.5
13321,Worth County,2021-09-20,7,8714,42.5
13321,Worth County,2021-09-21,19,8733,42.6
13321,Worth County,2021-09-22,8,8741,42.7
13321,Worth County,2021-09-23,18,8759,42.7
13321,Worth County,2021-09-24,17,8776,42.8
13321,Worth County,2021-09-25,7,8783,42.9
13321,Worth County,2021-09-26,4,8787,42.9
13321,Worth County,2021-09-27,3,8790,42.9
13321,Worth County,2021-09-28,15,8805,43
13321,Worth County,2021-09-29,11,8816,43
13321,Worth County,2021-09-30,8,8824,43.1
13321,Worth County,2021-10-01,5,8829,43.1
13321,Worth County,2021-10-02,5,8834,43.1
13321,Worth County,2021-10-04,7,8841,43.1
13321,Worth County,2021-10-05,6,8847,43.2
13321,Worth County,2021-10-06,9,8856,43.2
13321,Worth County,2021-10-07,13,8869,43.3
99999,Unknown,2020-12-12,2,2,0
99999,Unknown,2020-12-13,2,4,0
99999,Unknown,2020-12-14,2,6,0
99999,Unknown,2020-12-15,4,10,0
99999,Unknown,2020-12-16,40,50,0
99999,Unknown,2020-12-17,200,250,0
99999,Unknown,2020-12-18,442,692,0
99999,Unknown,2020-12-19,195,887,0
99999,Unknown,2020-12-20,160,1047,0
99999,Unknown,2020-12-21,317,1364,0
99999,Unknown,2020-12-22,749,2113,0
99999,Unknown,2020-12-23,951,3064,0
99999,Unknown,2020-12-24,239,3303,0
99999,Unknown,2020-12-25,10,3313,0
99999,Unknown,2020-12-26,99,3412,0
99999,Unknown,2020-12-27,82,3494,0
99999,Unknown,2020-12-28,671,4165,0
99999,Unknown,2020-12-29,770,4935,0
99999,Unknown,2020-12-30,970,5905,0.1
99999,Unknown,2020-12-31,436,6341,0.1
99999,Unknown,2021-01-01,163,6504,0.1
99999,Unknown,2021-01-02,90,6594,0.1
99999,Unknown,2021-01-03,65,6659,0.1
99999,Unknown,2021-01-04,637,7296,0.1
99999,Unknown,2021-01-05,898,8194,0.1
99999,Unknown,2021-01-06,793,8987,0.1
99999,Unknown,2021-01-07,832,9819,0.1
99999,Unknown,2021-01-08,990,10809,0.1
99999,Unknown,2021-01-09,485,11294,0.1
99999,Unknown,2021-01-10,95,11389,0.1
99999,Unknown,2021-01-11,1074,12463,0.1
99999,Unknown,2021-01-12,1253,13716,0.1
99999,Unknown,2021-01-13,1656,15372,0.1
99999,Unknown,2021-01-14,2041,17413,0.2
99999,Unknown,2021-01-15,1877,19290,0.2
99999,Unknown,2021-01-16,1287,20577,0.2
99999,Unknown,2021-01-17,505,21082,0.2
99999,Unknown,2021-01-18,1729,22811,0.2
99999,Unknown,2021-01-19,2149,24960,0.2
99999,Unknown,2021-01-20,2065,27025,0.3
99999,Unknown,2021-01-21,2430,29455,0.3
99999,Unknown,2021-01-22,2192,31647,0.3
99999,Unknown,2021-01-23,489,32136,0.3
99999,Unknown,2021-01-24,198,32334,0.3
99999,Unknown,2021-01-25,1024,33358,0.3
99999,Unknown,2021-01-26,1261,34619,0.3
99999,Unknown,2021-01-27,1218,35837,0.3
99999,Unknown,2021-01-28,3003,38840,0.4
99999,Unknown,2021-01-29,1994,40834,0.4
99999,Unknown,2021-01-30,407,41241,0.4
99999,Unknown,2021-01-31,91,41332,0.4
99999,Unknown,2021-02-01,901,42233,0.4
99999,Unknown,2021-02-02,905,43138,0.4
99999,Unknown,2021-02-03,950,44088,0.4
99999,Unknown,2021-02-04,1294,45382,0.4
99999,Unknown,2021-02-05,1394,46776,0.4
99999,Unknown,2021-02-06,334,47110,0.5
99999,Unknown,2021-02-07,163,47273,0.5
99999,Unknown,2021-02-08,695,47968,0.5
99999,Unknown,2021-02-09,835,48803,0.5
99999,Unknown,2021-02-10,761,49564,0.5
99999,Unknown,2021-02-11,1035,50599,0.5
99999,Unknown,2021-02-12,1192,51791,0.5
99999,Unknown,2021-02-13,693,52484,0.5
99999,Unknown,2021-02-14,288,52772,0.5
99999,Unknown,2021-02-15,923,53695,0.5
99999,Unknown,2021-02-16,1124,54819,0.5
99999,Unknown,2021-02-17,1079,55898,0.5
99999,Unknown,2021-02-18,1334,57232,0.6
99999,Unknown,2021-02-19,1003,58235,0.6
99999,Unknown,2021-02-20,483,58718,0.6
99999,Unknown,2021-02-21,190,58908,0.6
99999,Unknown,2021-02-22,554,59462,0.6
99999,Unknown,2021-02-23,951,60413,0.6
99999,Unknown,2021-02-24,997,61410,0.6
99999,Unknown,2021-02-25,1039,62449,0.6
99999,Unknown,2021-02-26,1213,63662,0.6
99999,Unknown,2021-02-27,567,64229,0.6
99999,Unknown,2021-02-28,294,64523,0.6
99999,Unknown,2021-03-01,1119,65642,0.6
99999,Unknown,2021-03-02,1343,66985,0.6
99999,Unknown,2021-03-03,1503,68488,0.7
99999,Unknown,2021-03-04,1378,69866,0.7
99999,Unknown,2021-03-05,1693,71559,0.7
99999,Unknown,2021-03-06,584,72143,0.7
99999,Unknown,2021-03-07,365,72508,0.7
99999,Unknown,2021-03-08,1740,74248,0.7
99999,Unknown,2021-03-09,2454,76702,0.7
99999,Unknown,2021-03-10,2296,78998,0.8
99999,Unknown,2021-03-11,2381,81379,0.8
99999,Unknown,2021-03-12,2523,83902,0.8
99999,Unknown,2021-03-13,1002,84904,0.8
99999,Unknown,2021-03-14,472,85376,0.8
99999,Unknown,2021-03-15,2294,87670,0.8
99999,Unknown,2021-03-16,2857,90527,0.9
99999,Unknown,2021-03-17,2525,93052,0.9
99999,Unknown,2021-03-18,2445,95497,0.9
99999,Unknown,2021-03-19,3132,98629,0.9
99999,Unknown,2021-03-20,1271,99900,1
99999,Unknown,2021-03-21,832,100732,1
99999,Unknown,2021-03-22,2654,103386,1
99999,Unknown,2021-03-23,3058,106444,1
99999,Unknown,2021-03-24,3266,109710,1.1
99999,Unknown,2021-03-25,3702,113412,1.1
99999,Unknown,2021-03-26,3680,117092,1.1
99999,Unknown,2021-03-27,2157,119249,1.1
99999,Unknown,2021-03-28,1009,120258,1.2
99999,Unknown,2021-03-29,3004,123262,1.2
99999,Unknown,2021-03-30,4256,127518,1.2
99999,Unknown,2021-03-31,4650,132168,1.3
99999,Unknown,2021-04-01,4416,136584,1.3
99999,Unknown,2021-04-02,4041,140625,1.4
99999,Unknown,2021-04-03,1517,142142,1.4
99999,Unknown,2021-04-04,796,142938,1.4
99999,Unknown,2021-04-05,2980,145918,1.4
99999,Unknown,2021-04-06,3324,149242,1.4
99999,Unknown,2021-04-07,3779,153021,1.5
99999,Unknown,2021-04-08,3226,156247,1.5
99999,Unknown,2021-04-09,3303,159550,1.5
99999,Unknown,2021-04-10,1888,161438,1.6
99999,Unknown,2021-04-11,821,162259,1.6
99999,Unknown,2021-04-12,2220,164479,1.6
99999,Unknown,2021-04-13,2631,167110,1.6
99999,Unknown,2021-04-14,2250,169360,1.6
99999,Unknown,2021-04-15,2295,171655,1.6
99999,Unknown,2021-04-16,2598,174253,1.7
99999,Unknown,2021-04-17,1234,175487,1.7
99999,Unknown,2021-04-18,832,176319,1.7
99999,Unknown,2021-04-19,1907,178226,1.7
99999,Unknown,2021-04-20,2378,180604,1.7
99999,Unknown,2021-04-21,2122,182726,1.8
99999,Unknown,2021-04-22,2069,184795,1.8
99999,Unknown,2021-04-23,2184,186979,1.8
99999,Unknown,2021-04-24,1514,188493,1.8
99999,Unknown,2021-04-25,967,189460,1.8
99999,Unknown,2021-04-26,1673,191133,1.8
99999,Unknown,2021-04-27,2014,193147,1.9
99999,Unknown,2021-04-28,2316,195463,1.9
99999,Unknown,2021-04-29,2115,197578,1.9
99999,Unknown,2021-04-30,2860,200438,1.9
99999,Unknown,2021-05-01,1660,202098,1.9
99999,Unknown,2021-05-02,1102,203200,2
99999,Unknown,2021-05-03,1512,204712,2
99999,Unknown,2021-05-04,1947,206659,2
99999,Unknown,2021-05-05,1876,208535,2
99999,Unknown,2021-05-06,1815,210350,2
99999,Unknown,2021-05-07,2217,212567,2
99999,Unknown,2021-05-08,1591,214158,2.1
99999,Unknown,2021-05-09,801,214959,2.1
99999,Unknown,2021-05-10,1201,216160,2.1
99999,Unknown,2021-05-11,1845,218005,2.1
99999,Unknown,2021-05-12,2300,220305,2.1
99999,Unknown,2021-05-13,1947,222252,2.1
99999,Unknown,2021-05-14,2570,224822,2.2
99999,Unknown,2021-05-15,2300,227122,2.2
99999,Unknown,2021-05-16,1656,228778,2.2
99999,Unknown,2021-05-17,2336,231114,2.2
99999,Unknown,2021-05-18,2413,233527,2.2
99999,Unknown,2021-05-19,2256,235783,2.3
99999,Unknown,2021-05-20,2222,238005,2.3
99999,Unknown,2021-05-21,2138,240143,2.3
99999,Unknown,2021-05-22,2171,242314,2.3
99999,Unknown,2021-05-23,1217,243531,2.3
99999,Unknown,2021-05-24,1816,245347,2.4
99999,Unknown,2021-05-25,1687,247034,2.4
99999,Unknown,2021-05-26,1710,248744,2.4
99999,Unknown,2021-05-27,1620,250364,2.4
99999,Unknown,2021-05-28,1630,251994,2.4
99999,Unknown,2021-05-29,1218,253212,2.4
99999,Unknown,2021-05-30,959,254171,2.4
99999,Unknown,2021-05-31,303,254474,2.4
99999,Unknown,2021-06-01,1714,256188,2.5
99999,Unknown,2021-06-02,1590,257778,2.5
99999,Unknown,2021-06-03,1377,259155,2.5
99999,Unknown,2021-06-04,1747,260902,2.5
99999,Unknown,2021-06-05,1381,262283,2.5
99999,Unknown,2021-06-06,1000,263283,2.5
99999,Unknown,2021-06-07,1361,264644,2.5
99999,Unknown,2021-06-08,1400,266044,2.6
99999,Unknown,2021-06-09,1312,267356,2.6
99999,Unknown,2021-06-10,1400,268756,2.6
99999,Unknown,2021-06-11,1383,270139,2.6
99999,Unknown,2021-06-12,1321,271460,2.6
99999,Unknown,2021-06-13,622,272082,2.6
99999,Unknown,2021-06-14,1209,273291,2.6
99999,Unknown,2021-06-15,1220,274511,2.6
99999,Unknown,2021-06-16,1171,275682,2.6
99999,Unknown,2021-06-17,1342,277024,2.7
99999,Unknown,2021-06-18,1285,278309,2.7
99999,Unknown,2021-06-19,1029,279338,2.7
99999,Unknown,2021-06-20,633,279971,2.7
99999,Unknown,2021-06-21,1182,281153,2.7
99999,Unknown,2021-06-22,1211,282364,2.7
99999,Unknown,2021-06-23,1251,283615,2.7
99999,Unknown,2021-06-24,1074,284689,2.7
99999,Unknown,2021-06-25,1179,285868,2.7
99999,Unknown,2021-06-26,1046,286914,2.8
99999,Unknown,2021-06-27,840,287754,2.8
99999,Unknown,2021-06-28,1111,288865,2.8
99999,Unknown,2021-06-29,1007,289872,2.8
99999,Unknown,2021-06-30,1049,290921,2.8
99999,Unknown,2021-07-01,983,291904,2.8
99999,Unknown,2021-07-02,1161,293065,2.8
99999,Unknown,2021-07-03,975,294040,2.8
99999,Unknown,2021-07-04,121,294161,2.8
99999,Unknown,2021-07-05,1187,295348,2.8
99999,Unknown,2021-07-06,1032,296380,2.8
99999,Unknown,2021-07-07,1146,297526,2.9
99999,Unknown,2021-07-08,1002,298528,2.9
99999,Unknown,2021-07-09,1274,299802,2.9
99999,Unknown,2021-07-10,1170,300972,2.9
99999,Unknown,2021-07-11,825,301797,2.9
99999,Unknown,2021-07-12,1176,302973,2.9
99999,Unknown,2021-07-13,1102,304075,2.9
99999,Unknown,2021-07-14,1024,305099,2.9
99999,Unknown,2021-07-15,1199,306298,2.9
99999,Unknown,2021-07-16,1252,307550,3
99999,Unknown,2021-07-17,1137,308687,3
99999,Unknown,2021-07-18,844,309531,3
99999,Unknown,2021-07-19,1407,310938,3
99999,Unknown,2021-07-20,1453,312391,3
99999,Unknown,2021-07-21,1710,314101,3
99999,Unknown,2021-07-22,1550,315651,3
99999,Unknown,2021-07-23,1889,317540,3.1
99999,Unknown,2021-07-24,1783,319323,3.1
99999,Unknown,2021-07-25,1163,320486,3.1
99999,Unknown,2021-07-26,1856,322342,3.1
99999,Unknown,2021-07-27,2030,324372,3.1
99999,Unknown,2021-07-28,2108,326480,3.1
99999,Unknown,2021-07-29,2044,328524,3.2
99999,Unknown,2021-07-30,2491,331015,3.2
99999,Unknown,2021-07-31,2021,333036,3.2
99999,Unknown,2021-08-01,1410,334446,3.2
99999,Unknown,2021-08-02,2206,336652,3.2
99999,Unknown,2021-08-03,2282,338934,3.3
99999,Unknown,2021-08-04,2251,341185,3.3
99999,Unknown,2021-08-05,2151,343336,3.3
99999,Unknown,2021-08-06,2607,345943,3.3
99999,Unknown,2021-08-07,2096,348039,3.3
99999,Unknown,2021-08-08,1525,349564,3.4
99999,Unknown,2021-08-09,2051,351615,3.4
99999,Unknown,2021-08-10,2432,354047,3.4
99999,Unknown,2021-08-11,2153,356200,3.4
99999,Unknown,2021-08-12,2103,358303,3.4
99999,Unknown,2021-08-13,2640,360943,3.5
99999,Unknown,2021-08-14,2150,363093,3.5
99999,Unknown,2021-08-15,1403,364496,3.5
99999,Unknown,2021-08-16,2215,366711,3.5
99999,Unknown,2021-08-17,2508,369219,3.5
99999,Unknown,2021-08-18,2304,371523,3.6
99999,Unknown,2021-08-19,1973,373496,3.6
99999,Unknown,2021-08-20,2514,376010,3.6
99999,Unknown,2021-08-21,1902,377912,3.6
99999,Unknown,2021-08-22,1324,379236,3.6
99999,Unknown,2021-08-23,1925,381161,3.7
99999,Unknown,2021-08-24,1966,383127,3.7
99999,Unknown,2021-08-25,2153,385280,3.7
99999,Unknown,2021-08-26,2077,387357,3.7
99999,Unknown,2021-08-27,2423,389780,3.7
99999,Unknown,2021-08-28,1866,391646,3.8
99999,Unknown,2021-08-29,1266,392912,3.8
99999,Unknown,2021-08-30,2013,394925,3.8
99999,Unknown,2021-08-31,2042,396967,3.8
99999,Unknown,2021-09-01,1996,398963,3.8
99999,Unknown,2021-09-02,1894,400857,3.9
99999,Unknown,2021-09-03,2288,403145,3.9
99999,Unknown,2021-09-04,1720,404865,3.9
99999,Unknown,2021-09-05,1311,406176,3.9
99999,Unknown,2021-09-06,418,406594,3.9
99999,Unknown,2021-09-07,1785,408379,3.9
99999,Unknown,2021-09-08,1950,410329,3.9
99999,Unknown,2021-09-09,2139,412468,4
99999,Unknown,2021-09-10,2202,414670,4
99999,Unknown,2021-09-11,1568,416238,4
99999,Unknown,2021-09-12,1136,417374,4
99999,Unknown,2021-09-13,1585,418959,4
99999,Unknown,2021-09-14,1583,420542,4
99999,Unknown,2021-09-15,1428,421970,4.1
99999,Unknown,2021-09-16,1453,423423,4.1
99999,Unknown,2021-09-17,1682,425105,4.1
99999,Unknown,2021-09-18,1484,426589,4.1
99999,Unknown,2021-09-19,819,427408,4.1
99999,Unknown,2021-09-20,1418,428826,4.1
99999,Unknown,2021-09-21,1273,430099,4.1
99999,Unknown,2021-09-22,1232,431331,4.1
99999,Unknown,2021-09-23,1385,432716,4.2
99999,Unknown,2021-09-24,2754,435470,4.2
99999,Unknown,2021-09-25,1693,437163,4.2
99999,Unknown,2021-09-26,1240,438403,4.2
99999,Unknown,2021-09-27,2444,440847,4.2
99999,Unknown,2021-09-28,2710,443557,4.3
99999,Unknown,2021-09-29,2505,446062,4.3
99999,Unknown,2021-09-30,2542,448604,4.3
99999,Unknown,2021-10-01,2998,451602,4.3
99999,Unknown,2021-10-02,1822,453424,4.4
99999,Unknown,2021-10-03,1069,454493,4.4
99999,Unknown,2021-10-04,1565,456058,4.4
99999,Unknown,2021-10-05,1378,457436,4.4
99999,Unknown,2021-10-06,1915,459351,4.4
99999,Unknown,2021-10-07,837,460188,4.4